Sample_ID	Total	Oxidoreductases (1.-.-.-)	Oxidoreductases :: Acting on the CH-OH group of donors (1.1.-.-)	Oxidoreductases :: Acting on the CH-OH group of donors :: With NAD(+) or NADP(+) as acceptor (1.1.1.-)	Alcohol dehydrogenase (1.1.1.1)	L-xylulose reductase (1.1.1.10)	3-oxoacyl-[acyl-carrier-protein] reductase (1.1.1.100)	L-threonine 3-dehydrogenase (1.1.1.103)	All-trans-retinol dehydrogenase (NAD(+)) (1.1.1.105)	Pyridoxal 4-dehydrogenase (1.1.1.107)	Carnitine 3-dehydrogenase (1.1.1.108)	D-arabinitol 4-dehydrogenase (1.1.1.11)	D-arabinose 1-dehydrogenase (NAD(+)) (1.1.1.116)	Galactose 1-dehydrogenase (NADP(+)) (1.1.1.120)	D-threo-aldose 1-dehydrogenase (1.1.1.122)	Sorbose 5-dehydrogenase (NADP(+)) (1.1.1.123)	2-deoxy-D-gluconate 3-dehydrogenase (1.1.1.125)	2-dehydro-3-deoxy-D-gluconate 5-dehydrogenase (1.1.1.127)	3-dehydro-L-gulonate 2-dehydrogenase (1.1.1.130)	GDP-mannose 6-dehydrogenase (1.1.1.132)	dTDP-4-dehydrorhamnose reductase (1.1.1.133)	UDP-N-acetylglucosamine 6-dehydrogenase (1.1.1.136)	Ribitol-5-phosphate 2-dehydrogenase (1.1.1.137)	L-iditol 2-dehydrogenase (1.1.1.14)	Sorbitol-6-phosphate 2-dehydrogenase (1.1.1.140)	15-hydroxyprostaglandin dehydrogenase (NAD(+)) (1.1.1.141)	3-beta-hydroxy-Delta(5)-steroid dehydrogenase (1.1.1.145)	20-alpha-hydroxysteroid dehydrogenase (1.1.1.149)	D-iditol 2-dehydrogenase (1.1.1.15)	Ureidoglycolate dehydrogenase (1.1.1.154)	3-hydroxybutyryl-CoA dehydrogenase (1.1.1.157)	7-alpha-hydroxysteroid dehydrogenase (1.1.1.159)	Erythrulose reductase (1.1.1.162)	Cyclopentanol dehydrogenase (1.1.1.163)	2-dehydropantoate 2-reductase (1.1.1.169)	Mannitol-1-phosphate 5-dehydrogenase (1.1.1.17)	(decarboxylating) (1.1.1.170)	D-xylose 1-dehydrogenase (1.1.1.175)	3-hydroxy-2-methylbutyryl-CoA dehydrogenase (1.1.1.178)	D-xylose 1-dehydrogenase (NADP(+)) (1.1.1.179)	Inositol 2-dehydrogenase (1.1.1.18)	Carbonyl reductase (NADPH) (1.1.1.184)	GDP-4-dehydro-D-rhamnose reductase (1.1.1.187)	5-amino-6-(5-phosphoribosylamino)uracil reductase (1.1.1.193)	Cinnamyl-alcohol dehydrogenase (1.1.1.195)	Alcohol dehydrogenase (NADP(+)) (1.1.1.2)	Glucuronolactone reductase (1.1.1.20)	"1,3-propanediol dehydrogenase (1.1.1.202)"	IMP dehydrogenase (1.1.1.205)	(+)-neomenthol dehydrogenase (1.1.1.208)	Aldehyde reductase (1.1.1.21)	Gluconate 2-dehydrogenase (1.1.1.215)	Morphine 6-dehydrogenase (1.1.1.218)	Dihydrokaempferol 4-reductase (1.1.1.219)	UDP-glucose 6-dehydrogenase (1.1.1.22)	Histidinol dehydrogenase (1.1.1.23)	Tropinone reductase II (1.1.1.236)	Quinate dehydrogenase (1.1.1.24)	Carveol dehydrogenase (1.1.1.243)	Methanol dehydrogenase (1.1.1.244)	Shikimate dehydrogenase (1.1.1.25)	D-arabinitol 2-dehydrogenase (1.1.1.250)	Galactitol-1-phosphate 5-dehydrogenase (1.1.1.251)	Mannitol dehydrogenase (1.1.1.255)	Glyoxylate reductase (1.1.1.26)	sn-glycerol-1-phosphate dehydrogenase (1.1.1.261)	4-hydroxythreonine-4-phosphate dehydrogenase (1.1.1.262)	L-idonate 5-dehydrogenase (NAD(P)(+)) (1.1.1.264)	1-deoxy-D-xylulose-5-phosphate reductoisomerase (1.1.1.267)	2-(S)-hydroxypropyl-CoM dehydrogenase (1.1.1.269)	L-lactate dehydrogenase (1.1.1.27)	GDP-L-fucose synthase (1.1.1.271)	D-2-hydroxyacid dehydrogenase (NADP(+)) (1.1.1.272)	"2,5-didehydrogluconate reductase (2-dehydro-D-gluconate-forming) (1.1.1.274)"	(+)-trans-carveol dehydrogenase (1.1.1.275)	Serine 3-dehydrogenase (1.1.1.276)	D-lactate dehydrogenase (1.1.1.28)	Quinate/shikimate dehydrogenase (1.1.1.282)	Methylglyoxal reductase (NADPH) (1.1.1.283)	S-(hydroxymethyl)glutathione dehydrogenase (1.1.1.284)	Glycerate dehydrogenase (1.1.1.29)	4-phosphoerythronate dehydrogenase (1.1.1.290)	"1,5-anhydro-D-fructose reductase (1,5-anhydro-D-mannitol-forming) (1.1.1.292)"	3-hydroxypropionate dehydrogenase (NADP(+)) (1.1.1.298)	Homoserine dehydrogenase (1.1.1.3)	3-hydroxybutyrate dehydrogenase (1.1.1.30)	D-arabitol-phosphate dehydrogenase (1.1.1.301)	Diacetyl reductase ((R)-acetoin forming) (1.1.1.303)	Diacetyl reductase ((S)-acetoin forming) (1.1.1.304)	S-(hydroxymethyl)mycothiol dehydrogenase (1.1.1.306)	3-hydroxyisobutyrate dehydrogenase (1.1.1.31)	2-hydroxy-4-carboxymuconate semialdehyde hemiacetal dehydrogenase (1.1.1.312)	Very-long-chain 3-oxoacyl-CoA reductase (1.1.1.330)	L-2-hydroxycarboxylate dehydrogenase (NAD(+)) (1.1.1.337)	(2R)-3-sulfolactate dehydrogenase (NADP(+)) (1.1.1.338)	Hydroxymethylglutaryl-CoA reductase (NADPH) (1.1.1.34)	3-hydroxyacyl-CoA dehydrogenase (1.1.1.35)	"Phosphogluconate dehydrogenase (NAD(P)(+)-dependent, decarboxylating) (1.1.1.351)"	Acetoacetyl-CoA reductase (1.1.1.36)	Malate dehydrogenase (1.1.1.37)	Malate dehydrogenase (oxaloacetate-decarboxylating) (1.1.1.38)	Malate dehydrogenase (decarboxylating) (1.1.1.39)	"(R,R)-butanediol dehydrogenase (1.1.1.4)"	Malate dehydrogenase (oxaloacetate-decarboxylating) (NADP(+)) (1.1.1.40)	Isocitrate dehydrogenase (NAD(+)) (1.1.1.41)	Isocitrate dehydrogenase (NADP(+)) (1.1.1.42)	"Phosphogluconate dehydrogenase (NADP(+)-dependent, decarboxylating) (1.1.1.44)"	L-arabinose 1-dehydrogenase (1.1.1.46)	Glucose 1-dehydrogenase (NAD(P)(+)) (1.1.1.47)	D-galactose 1-dehydrogenase (1.1.1.48)	Glucose-6-phosphate dehydrogenase (NADP(+)) (1.1.1.49)	Transferred entry: 1.1.1.303 and 1.1.1.304 (1.1.1.5)	3-alpha-hydroxysteroid 3-dehydrogenase (Si-specific) (1.1.1.50)	3(or 17)-beta-hydroxysteroid dehydrogenase (1.1.1.51)	3-alpha-(or 20-beta)-hydroxysteroid dehydrogenase (1.1.1.53)	Ribitol 2-dehydrogenase (1.1.1.56)	Fructuronate reductase (1.1.1.57)	Tagaturonate reductase (1.1.1.58)	Glycerol dehydrogenase (1.1.1.6)	2-hydroxy-3-oxopropionate reductase (1.1.1.60)	4-hydroxybutyrate dehydrogenase (1.1.1.61)	17-beta-estradiol 17-dehydrogenase (1.1.1.62)	Pyridoxine 4-dehydrogenase (1.1.1.65)	Mannitol 2-dehydrogenase (1.1.1.67)	Gluconate 5-dehydrogenase (1.1.1.69)	"(S,S)-butanediol dehydrogenase (1.1.1.76)"	Lactaldehyde reductase (1.1.1.77)	Glyoxylate reductase (NADP(+)) (1.1.1.79)	Glycerol-3-phosphate dehydrogenase (NAD(+)) (1.1.1.8)	Hydroxypyruvate reductase (1.1.1.81)	D-malate dehydrogenase (decarboxylating) (1.1.1.83)	3-isopropylmalate dehydrogenase (1.1.1.85)	Ketol-acid reductoisomerase (1.1.1.86)	Hydroxymethylglutaryl-CoA reductase (1.1.1.88)	D-xylulose reductase (1.1.1.9)	Aryl-alcohol dehydrogenase (1.1.1.90)	Aryl-alcohol dehydrogenase (NADP(+)) (1.1.1.91)	Tartrate dehydrogenase (1.1.1.93)	Glycerol-3-phosphate dehydrogenase (NAD(P)(+)) (1.1.1.94)	Phosphoglycerate dehydrogenase (1.1.1.95)	(-)-trans-carveol dehydrogenase (1.1.1.n4)	Oxidoreductases :: Acting on the CH-OH group of donors :: With a cytochrome as acceptor (1.1.2.-)	L-lactate dehydrogenase (cytochrome) (1.1.2.3)	D-lactate dehydrogenase (cytochrome) (1.1.2.4)	D-lactate dehydrogenase (cytochrome c-553) (1.1.2.5)	Methanol dehydrogenase (cytochrome c) (1.1.2.7)	Alcohol dehydrogenase (cytochrome c) (1.1.2.8)	Pyranose oxidase (1.1.3.10)	Alcohol oxidase (1.1.3.13)	(S)-2-hydroxy-acid oxidase (1.1.3.15)	Choline oxidase (1.1.3.17)	Long-chain-alcohol oxidase (1.1.3.20)	Glycerol-3-phosphate oxidase (1.1.3.21)	"D-arabinono-1,4-lactone oxidase (1.1.3.37)"	Vanillyl-alcohol oxidase (1.1.3.38)	Glucose oxidase (1.1.3.4)	Alditol oxidase (1.1.3.41)	Paromamine 6'-oxidase (1.1.3.43)	Cholesterol oxidase (1.1.3.6)	Aryl-alcohol oxidase (1.1.3.7)	L-gulonolactone oxidase (1.1.3.8)	Galactose oxidase (1.1.3.9)	Oxidoreductases :: Acting on the CH-OH group of donors :: With a quinone or similar compound as acceptor (1.1.5.-)	"Quinoprotein glucose dehydrogenase (PQQ, quinone) (1.1.5.2)"	Glycerol-3-phosphate dehydrogenase (1.1.5.3)	Malate dehydrogenase (quinone) (1.1.5.4)	Quinate dehydrogenase (quinone) (1.1.5.8)	Alcohol dehydrogenase (azurin) (1.1.9.1)	Glucose-6-phosphate dehydrogenase (coenzyme-F420) (1.1.98.2)	Oxidoreductases :: Acting on the CH-OH group of donors :: With other acceptors (1.1.99.-)	Choline dehydrogenase (1.1.99.1)	Transferred entry: 1.1.5.9 (1.1.99.10)	Glucoside 3-dehydrogenase (1.1.99.13)	Glycolate dehydrogenase (1.1.99.14)	Transferred entry: 1.1.5.2 (1.1.99.17)	Cellobiose dehydrogenase (acceptor) (1.1.99.18)	L-2-hydroxyglutarate dehydrogenase (1.1.99.2)	D-sorbitol dehydrogenase (acceptor) (1.1.99.21)	Glycerol dehydrogenase (acceptor) (1.1.99.22)	Hydroxyacid-oxoacid transhydrogenase (1.1.99.24)	Transferred entry: 1.1.5.8 (1.1.99.25)	Glucose-fructose oxidoreductase (1.1.99.28)	Gluconate 2-dehydrogenase (acceptor) (1.1.99.3)	(S)-mandelate dehydrogenase (1.1.99.31)	L-sorbose 1-dehydrogenase (1.1.99.32)	Formate dehydrogenase (acceptor) (1.1.99.33)	Soluble quinoprotein glucose dehydrogenase (1.1.99.35)	Dehydrogluconate dehydrogenase (1.1.99.4)	Transferred entry: 1.1.5.3 (1.1.99.5)	Transferred entry: 1.1.2.7 and 1.1.2.8 (1.1.99.8)	Oxidoreductases :: Acting on diphenols and related substances as donors :: With a cytochrome as acceptor (1.10.2.-)	Quinol--cytochrome-c reductase (1.10.2.2)	Oxidoreductases :: Acting on diphenols and related substances as donors :: With oxygen as acceptor (1.10.3.-)	Ubiquinol oxidase (H(+)-transporting) (1.10.3.10)	Laccase (1.10.3.2)	L-ascorbate oxidase (1.10.3.3)	Photosystem II (1.10.3.9)	Plastoquinol--plastocyanin reductase (1.10.9.1)	Transferred entry: 1.10.9.1 (1.10.99.1)	Ribosyldihydronicotinamide dehydrogenase (quinone) (1.10.99.2)	Oxidoreductases :: Acting on a peroxide as acceptor (1.11.-.-)	Oxidoreductases :: Acting on a peroxide as acceptor :: Peroxidases (1.11.1.-)	NADH peroxidase (1.11.1.1)	Chloride peroxidase (1.11.1.10)	Manganese peroxidase (1.11.1.13)	Peroxiredoxin (1.11.1.15)	Catalase peroxidase (1.11.1.21)	Cytochrome-c peroxidase (1.11.1.5)	Catalase (1.11.1.6)	Peroxidase (1.11.1.7)	Glutathione peroxidase (1.11.1.9)	Oxidoreductases :: Acting on hydrogen as donor (1.12.-.-)	Hydrogen dehydrogenase (1.12.1.2)	Hydrogen dehydrogenase (NADP(+)) (1.12.1.3)	Cytochrome-c3 hydrogenase (1.12.2.1)	Hydrogen:quinone oxidoreductase (1.12.5.1)	Ferredoxin hydrogenase (1.12.7.2)	Coenzyme F420 hydrogenase (1.12.98.1)	Hydrogenase (acceptor) (1.12.99.6)	Oxidoreductases :: Acting on single donors with incorporation of molecular oxygen (1.13.-.-)	Oxidoreductases :: Acting on single donors with incorporation of molecular oxygen :: With incorporation of two atoms of oxygen (1.13.11.-)	"Catechol 1,2-dioxygenase (1.13.11.1)"	"Tryptophan 2,3-dioxygenase (1.13.11.11)"	"3,4-dihydroxyphenylacetate 2,3-dioxygenase (1.13.11.15)"	"3-carboxyethylcatechol 2,3-dioxygenase (1.13.11.16)"	"Catechol 2,3-dioxygenase (1.13.11.2)"	Cysteine dioxygenase (1.13.11.20)	"Quercetin 2,3-dioxygenase (1.13.11.24)"	4-hydroxyphenylpyruvate dioxygenase (1.13.11.27)	"Protocatechuate 3,4-dioxygenase (1.13.11.3)"	Transferred entry: 1.13.12.16 (1.13.11.32)	Arachidonate 15-lipoxygenase (1.13.11.33)	"Hydroxyquinol 1,2-dioxygenase (1.13.11.37)"	"Biphenyl-2,3-diol 1,2-dioxygenase (1.13.11.39)"	"Gentisate 1,2-dioxygenase (1.13.11.4)"	"2,4'-dihydroxyacetophenone dioxygenase (1.13.11.41)"	Deleted entry (1.13.11.42)	Chlorite O(2)-lyase (1.13.11.49)	"Homogentisate 1,2-dioxygenase (1.13.11.5)"	9-cis-epoxycarotenoid dioxygenase (1.13.11.51)	Acireductone dioxygenase (Fe(2+)-requiring) (1.13.11.54)	"3-hydroxyanthranilate 3,4-dioxygenase (1.13.11.6)"	"Protocatechuate 4,5-dioxygenase (1.13.11.8)"	Oxidoreductases :: Acting on single donors with incorporation of molecular oxygen :: With incorporation of one atom of oxygen (1.13.12.-)	Nitronate monooxygenase (1.13.12.16)	Lysine 2-monooxygenase (1.13.12.2)	Tryptophan 2-monooxygenase (1.13.12.3)	Lactate 2-monooxygenase (1.13.12.4)	Inositol oxygenase (1.13.99.1)	"Oxidoreductases :: Acting on paired donors, with incorporation or reduction of molecular oxygen (1.14.-.-)"	"Oxidoreductases :: Acting on paired donors, with incorporation or reduction of molecular oxygen :: With 2-oxoglutarate as one donor, and incorporation of one atom each of oxygen into both donors (1.14.11.-)"	Gamma-butyrobetaine dioxygenase (1.14.11.1)	Peptide-aspartate beta-dioxygenase (1.14.11.16)	Taurine dioxygenase (1.14.11.17)	Phytanoyl-CoA dioxygenase (1.14.11.18)	Procollagen-proline dioxygenase (1.14.11.2)	Flavanone 3-dioxygenase (1.14.11.9)	"Oxidoreductases :: Acting on paired donors, with incorporation or reduction of molecular oxygen :: With NADH or NADPH as one donor, and incorporation of two atoms of oxygen into one donor (1.14.12.-)"	"Anthranilate 1,2-dioxygenase (deaminating, decarboxylating) (1.14.12.1)"	"Benzoate 1,2-dioxygenase (1.14.12.10)"	Toluene dioxygenase (1.14.12.11)	"Naphthalene 1,2-dioxygenase (1.14.12.12)"	"2-halobenzoate 1,2-dioxygenase (1.14.12.13)"	"Terephthalate 1,2-dioxygenase (1.14.12.15)"	Nitric oxide dioxygenase (1.14.12.17)	"Biphenyl 2,3-dioxygenase (1.14.12.18)"	3-phenylpropanoate dioxygenase (1.14.12.19)	Pheophorbide a oxygenase (1.14.12.20)	"Benzoyl-CoA 2,3-dioxygenase (1.14.12.21)"	"Phthalate 4,5-dioxygenase (1.14.12.7)"	"Oxidoreductases :: Acting on paired donors, with incorporation or reduction of molecular oxygen :: With NADH or NADPH as one donor, and incorporation of one atom of oxygen (1.14.13.-)"	Salicylate 1-monooxygenase (1.14.13.1)	"Limonene 1,2-monooxygenase (1.14.13.107)"	FAD-dependent urate hydroxylase (1.14.13.113)	6-hydroxynicotinate 3-monooxygenase (1.14.13.114)	Benzoate 4-monooxygenase (1.14.13.12)	3-(3-hydroxy-phenyl)propanoic acid hydroxylase (1.14.13.127)	Dimethyl-sulfide monooxygenase (1.14.13.131)	"Phenylacetyl-CoA 1,2-epoxidase (1.14.13.149)"	Linalool 8-monooxygenase (1.14.13.151)	Cyclopentanone monooxygenase (1.14.13.16)	4-hydroxybenzoate 3-monooxygenase (1.14.13.2)	"2,4-dichlorophenol 6-monooxygenase (1.14.13.20)"	Cyclohexanone monooxygenase (1.14.13.22)	3-hydroxybenzoate 6-monooxygenase (1.14.13.24)	Methane monooxygenase (soluble) (1.14.13.25)	2-nitrophenol 2-monooxygenase (1.14.13.31)	4-hydroxybenzoate 3-monooxygenase (NAD(P)H) (1.14.13.33)	Nitric-oxide synthase (NADPH dependent) (1.14.13.39)	Anthraniloyl-CoA monooxygenase (1.14.13.40)	(S)-limonene 6-monooxygenase (1.14.13.48)	Pentachlorophenol monooxygenase (1.14.13.50)	L-lysine N(6)-monooxygenase (NADPH) (1.14.13.59)	Phenol 2-monooxygenase (1.14.13.7)	Sterol 14-alpha-demethylase (1.14.13.70)	Methylsterol monooxygenase (1.14.13.72)	Flavin-containing monooxygenase (1.14.13.8)	Magnesium-protoporphyrin IX monomethyl ester (oxidative) cyclase (1.14.13.81)	Vanillate monooxygenase (1.14.13.82)	Precorrin-3B synthase (1.14.13.83)	4-hydroxyacetophenone monooxygenase (1.14.13.84)	Kynurenine 3-monooxygenase (1.14.13.9)	Zeaxanthin epoxidase (1.14.13.90)	Phenylacetone monooxygenase (1.14.13.92)	(+)-abscisic acid 8'-hydroxylase (1.14.13.93)	"Oxidoreductases :: Acting on paired donors, with incorporation or reduction of molecular oxygen :: With reduced flavin or flavoprotein as one donor, and incorporation of one atom of oxygen (1.14.14.-)"	Unspecific monooxygenase (1.14.14.1)	Nitrilotriacetate monooxygenase (1.14.14.10)	Alkanal monooxygenase (FMN-linked) (1.14.14.3)	Alkanesulfonate monooxygenase (1.14.14.5)	Tryptophan 7-halogenase (1.14.14.7)	4-hydroxyphenylacetate 3-monooxygenase (1.14.14.9)	Camphor 5-monooxygenase (1.14.15.1)	Alkane 1-monooxygenase (1.14.15.3)	Choline monooxygenase (1.14.15.7)	Phenylalanine 4-monooxygenase (1.14.16.1)	Tyrosine 3-monooxygenase (1.14.16.2)	Tryptophan 5-monooxygenase (1.14.16.4)	Tyrosinase (1.14.18.1)	"Oxidoreductases :: Acting on paired donors, with incorporation or reduction of molecular oxygen :: With oxidation of a pair of donors resulting in the reduction of molecular oxygen to two molecules of water (1.14.19.-)"	Stearoyl-CoA 9-desaturase (1.14.19.1)	Acyl-[acyl-carrier-protein] desaturase (1.14.19.2)	Linoleoyl-CoA desaturase (1.14.19.3)	Lathosterol oxidase (1.14.21.6)	"Oxidoreductases :: Acting on paired donors, with incorporation or reduction of molecular oxygen :: Miscellaneous (requires further characterization) (1.14.99.-)"	Prostaglandin-endoperoxide synthase (1.14.99.1)	Transferred entry: 1.14.13.151 (1.14.99.28)	Deoxyhypusine monooxygenase (1.14.99.29)	Heme oxygenase (biliverdin-producing) (1.14.99.3)	Delta(12)-fatty acid dehydrogenase (1.14.99.33)	"Beta-carotene 15,15'-monooxygenase (1.14.99.36)"	"5,6-dimethylbenzimidazole synthase (1.14.99.40)"	Pyrimidine monooxygenase (1.14.99.46)	Transferred entry: 1.14.19.1 (1.14.99.5)	Transferred entry: 1.14.19.2 (1.14.99.6)	Steroid 17-alpha-monooxygenase (1.14.99.9)	Superoxide dismutase (1.15.1.1)	Oxidoreductases :: Oxidizing metal ions (1.16.-.-)	Oxidoreductases :: Oxidizing metal ions :: With NAD(+) or NADP(+) as acceptor (1.16.1.-)	Mercury(II) reductase (1.16.1.1)	Aquacobalamin reductase (1.16.1.3)	Ferroxidase (1.16.3.1)	"Cob(II)yrinic acid a,c-diamide reductase (1.16.8.1)"	Oxidoreductases :: Acting on CH or CH(2) groups (1.17.-.-)	Oxidoreductases :: Acting on CH or CH(2) groups :: With NAD(+) or NADP(+) as acceptor (1.17.1.-)	CDP-4-dehydro-6-deoxyglucose reductase (1.17.1.1)	4-hydroxy-3-methylbut-2-enyl diphosphate reductase (1.17.1.2)	Xanthine dehydrogenase (1.17.1.4)	4-hydroxy-tetrahydrodipicolinate reductase (1.17.1.8)	Xanthine oxidase (1.17.3.2)	Oxidoreductases :: Acting on CH or CH(2) groups :: With a disulfide as acceptor (1.17.4.-)	Ribonucleoside-diphosphate reductase (1.17.4.1)	Ribonucleoside-triphosphate reductase (1.17.4.2)	(E)-4-hydroxy-3-methylbut-2-enyl-diphosphate synthase (1.17.7.1)	4-methylphenol dehydrogenase (hydroxylating) (1.17.99.1)	Oxidoreductases :: Acting on iron-sulfur proteins as donors (1.18.-.-)	Oxidoreductases :: Acting on iron-sulfur proteins as donors :: With NAD(+) or NADP(+) as acceptor (1.18.1.-)	Rubredoxin--NAD(+) reductase (1.18.1.1)	Ferredoxin--NADP(+) reductase (1.18.1.2)	Ferredoxin--NAD(+) reductase (1.18.1.3)	Adrenodoxin-NADP(+) reductase (1.18.1.6)	Nitrogenase (1.18.6.1)	Oxidoreductases :: Acting on reduced flavodoxin as donor (1.19.-.-)	Oxidoreductases :: Acting on the aldehyde or oxo group of donors (1.2.-.-)	Oxidoreductases :: Acting on the aldehyde or oxo group of donors :: With NAD(+) or NADP(+) as acceptor (1.2.1.-)	Transferred entry: 1.1.1.284 and 4.4.1.22 (1.2.1.1)	Acetaldehyde dehydrogenase (acetylating) (1.2.1.10)	Aspartate-semialdehyde dehydrogenase (1.2.1.11)	Glyceraldehyde-3-phosphate dehydrogenase (phosphorylating) (1.2.1.12)	Glyceraldehyde-3-phosphate dehydrogenase (NADP(+)) (phosphorylating) (1.2.1.13)	Succinate-semialdehyde dehydrogenase (NAD(P)(+)) (1.2.1.16)	Malonate-semialdehyde dehydrogenase (acetylating) (1.2.1.18)	Aminobutyraldehyde dehydrogenase (1.2.1.19)	Formate dehydrogenase (1.2.1.2)	Glutarate-semialdehyde dehydrogenase (1.2.1.20)	Glycolaldehyde dehydrogenase (1.2.1.21)	Lactaldehyde dehydrogenase (1.2.1.22)	Succinate-semialdehyde dehydrogenase (NAD(+)) (1.2.1.24)	"2,5-dioxovalerate dehydrogenase (1.2.1.26)"	Methylmalonate-semialdehyde dehydrogenase (CoA acylating) (1.2.1.27)	Benzaldehyde dehydrogenase (NAD(+)) (1.2.1.28)	Aldehyde dehydrogenase (NAD(+)) (1.2.1.3)	L-aminoadipate-semialdehyde dehydrogenase (1.2.1.31)	Retinal dehydrogenase (1.2.1.36)	N-acetyl-gamma-glutamyl-phosphate reductase (1.2.1.38)	Phenylacetaldehyde dehydrogenase (1.2.1.39)	Aldehyde dehydrogenase (NADP(+)) (1.2.1.4)	Glutamate-5-semialdehyde dehydrogenase (1.2.1.41)	Transferred entry: 1.1.1.312 (1.2.1.45)	Formaldehyde dehydrogenase (1.2.1.46)	Aldehyde dehydrogenase (NAD(P)(+)) (1.2.1.5)	Long-chain-fatty-acyl-CoA reductase (1.2.1.50)	Pyruvate dehydrogenase (NADP(+)) (1.2.1.51)	Phenylglyoxylate dehydrogenase (acylating) (1.2.1.58)	Glyceraldehyde-3-phosphate dehydrogenase (NAD(P)(+)) (phosphorylating) (1.2.1.59)	5-carboxymethyl-2-hydroxymuconic-semialdehyde dehydrogenase (1.2.1.60)	4-formylbenzenesulfonate dehydrogenase (1.2.1.62)	4-hydroxybenzaldehyde dehydrogenase (1.2.1.64)	Salicylaldehyde dehydrogenase (1.2.1.65)	Transferred entry: 1.1.1.306 (1.2.1.66)	Vanillin dehydrogenase (1.2.1.67)	Coniferyl-aldehyde dehydrogenase (1.2.1.68)	Glutamyl-tRNA reductase (1.2.1.70)	Succinylglutamate-semialdehyde dehydrogenase (1.2.1.71)	Erythrose-4-phosphate dehydrogenase (1.2.1.72)	"3,4-dehydroadipyl-CoA semialdehyde dehydrogenase (NADP(+)) (1.2.1.77)"	Succinate-semialdehyde dehydrogenase (NADP(+)) (1.2.1.79)	Betaine-aldehyde dehydrogenase (1.2.1.8)	L-glutamate gamma-semialdehyde dehydrogenase (1.2.1.88)	Glyceraldehyde-3-phosphate dehydrogenase (NADP(+)) (1.2.1.9)	Fatty acyl-CoA reductase (1.2.1.n2)	Formate dehydrogenase (cytochrome) (1.2.2.1)	Deleted entry (1.2.2.2)	Carbon-monoxide dehydrogenase (cytochrome b-561) (1.2.2.4)	Aldehyde oxidase (1.2.3.1)	Pyruvate oxidase (1.2.3.3)	Oxidoreductases :: Acting on the aldehyde or oxo group of donors :: With a disulfide as acceptor (1.2.4.-)	Pyruvate dehydrogenase (acetyl-transferring) (1.2.4.1)	Oxoglutarate dehydrogenase (succinyl-transferring) (1.2.4.2)	3-methyl-2-oxobutanoate dehydrogenase (2-methylpropanoyl-transferring) (1.2.4.4)	Pyruvate dehydrogenase (quinone) (1.2.5.1)	Oxidoreductases :: Acting on the aldehyde or oxo group of donors :: With an iron-sulfur protein as acceptor (1.2.7.-)	Pyruvate synthase (1.2.7.1)	2-oxoglutarate synthase (1.2.7.3)	Aldehyde ferredoxin oxidoreductase (1.2.7.5)	Glyceraldehyde-3-phosphate dehydrogenase (ferredoxin) (1.2.7.6)	3-methyl-2-oxobutanoate dehydrogenase (ferredoxin) (1.2.7.7)	Indolepyruvate ferredoxin oxidoreductase (1.2.7.8)	Carbon-monoxide dehydrogenase (acceptor) (1.2.99.2)	Aldehyde dehydrogenase (pyrroloquinoline-quinone) (1.2.99.3)	Formylmethanofuran dehydrogenase (1.2.99.5)	Oxidoreductases :: Acting on phosphorus or arsenic in donors :: With disulfide as acceptor (1.20.4.-)	Arsenate reductase (glutaredoxin) (1.20.4.1)	Arsenate reductase (azurin) (1.20.9.1)	Arsenate reductase (donor) (1.20.99.1)	Oxidoreductases :: Acting on x-H and y-H to form an x-y bond (1.21.-.-)	Isopenicillin-N synthase (1.21.3.1)	Glycine reductase (1.21.4.2)	Sarcosine reductase (1.21.4.3)	Betaine reductase (1.21.4.4)	Oxidoreductases :: Acting on the CH-CH group of donors (1.3.-.-)	Oxidoreductases :: Acting on the CH-CH group of donors :: With NAD(+) or NADP(+) as acceptor (1.3.1.-)	Dihydrouracil dehydrogenase (NAD(+)) (1.3.1.1)	"Enoyl-[acyl-carrier-protein] reductase (NADPH, Si-specific) (1.3.1.10)"	Prephenate dehydrogenase (1.3.1.12)	Prephenate dehydrogenase (NADP(+)) (1.3.1.13)	Dihydroorotate dehydrogenase (NAD(+)) (1.3.1.14)	Dihydropyrimidine dehydrogenase (NADP(+)) (1.3.1.2)	"Trans-1,2-dihydrobenzene-1,2-diol dehydrogenase (1.3.1.20)"	Biliverdin reductase (1.3.1.24)	"1,6-dihydroxycyclohexa-2,4-diene-1-carboxylate dehydrogenase (1.3.1.25)"	"2,3-dihydro-2,3-dihydroxybenzoate dehydrogenase (1.3.1.28)"	Delta(4)-3-oxosteroid 5-beta-reductase (1.3.1.3)	2-enoate reductase (1.3.1.31)	Maleylacetate reductase (1.3.1.32)	Protochlorophyllide reductase (1.3.1.33)	"2,4-dienoyl-CoA reductase (NADPH) (1.3.1.34)"	Trans-2-enoyl-CoA reductase (NADPH) (1.3.1.38)	"Enoyl-[acyl-carrier-protein] reductase (NADPH, Re-specific) (1.3.1.39)"	12-oxophytodienoate reductase (1.3.1.42)	Arogenate dehydrogenase (1.3.1.43)	2'-hydroxyisoflavone reductase (1.3.1.45)	15-oxoprostaglandin 13-oxidase (1.3.1.48)	Precorrin-6A reductase (1.3.1.54)	"2,3-dihydroxy-2,3-dihydro-p-cumate dehydrogenase (1.3.1.58)"	Fumarate reductase (NADH) (1.3.1.6)	Dibenzothiophene dihydrodiol dehydrogenase (1.3.1.60)	Pimeloyl-CoA dehydrogenase (1.3.1.62)	Delta(24(24(1)))-sterol reductase (1.3.1.71)	2-alkenal reductase (NAD(P)(+)) (1.3.1.74)	Precorrin-2 dehydrogenase (1.3.1.76)	Geranylgeranyl diphosphate reductase (1.3.1.83)	Acrylyl-CoA reductase (NADPH) (1.3.1.84)	tRNA-dihydrouridine(47) synthase (NAD(P)(+)) (1.3.1.89)	Enoyl-[acyl-carrier-protein] reductase (NADH) (1.3.1.9)	UDP-N-acetylmuramate dehydrogenase (1.3.1.98)	Oxidoreductases :: Acting on the CH-CH group of donors :: With oxygen as acceptor (1.3.3.-)	Pyrroloquinoline-quinone synthase (1.3.3.11)	Coproporphyrinogen oxidase (1.3.3.3)	Protoporphyrinogen oxidase (1.3.3.4)	Bilirubin oxidase (1.3.3.5)	Acyl-CoA oxidase (1.3.3.6)	Succinate dehydrogenase (quinone) (1.3.5.1)	Dihydroorotate dehydrogenase (quinone) (1.3.5.2)	"9,9'-di-cis-zeta-carotene desaturase (1.3.5.6)"	Ferredoxin:protochlorophyllide reductase (ATP-dependent) (1.3.7.7)	Benzoyl-CoA reductase (1.3.7.8)	4-hydroxybenzoyl-CoA reductase (1.3.7.9)	Oxidoreductases :: Acting on the CH-CH group of donors :: With a flavin as acceptor (1.3.8.-)	Short-chain acyl-CoA dehydrogenase (1.3.8.1)	"4,4'-diapophytoene desaturase (1.3.8.2)"	(R)-benzylsuccinyl-CoA dehydrogenase (1.3.8.3)	Isovaleryl-CoA dehydrogenase (1.3.8.4)	Glutaryl-CoA dehydrogenase (ETF) (1.3.8.6)	Medium-chain acyl-CoA dehydrogenase (1.3.8.7)	Long-chain-acyl-CoA dehydrogenase (1.3.8.8)	Dihydroorotate oxidase (fumarate) (1.3.98.1)	Oxidoreductases :: Acting on the CH-CH group of donors :: With other acceptors (1.3.99.-)	Deleted entry (1.3.99.1)	Transferred entry: 1.3.8.4 (1.3.99.10)	2-methylacyl-CoA dehydrogenase (1.3.99.12)	Transferred entry: 1.3.8.8 (1.3.99.13)	Transferred entry: 1.3.7.8 (1.3.99.15)	Isoquinoline 1-oxidoreductase (1.3.99.16)	Transferred entry: 1.3.8.1 (1.3.99.2)	Transferred entry: 1.3.8.3 (1.3.99.21)	Coproporphyrinogen dehydrogenase (1.3.99.22)	"All-trans-retinol 13,14-reductase (1.3.99.23)"	"Transferred entry: 1.3.8.7, 1.3.8.8 and 1.3.8.9 (1.3.99.3)"	Glutaryl-CoA dehydrogenase (acceptor) (1.3.99.32)	3-oxosteroid 1-dehydrogenase (1.3.99.4)	3-oxo-5-alpha-steroid 4-dehydrogenase (acceptor) (1.3.99.5)	Transferred entry: 1.3.8.6 (1.3.99.7)	Oxidoreductases :: Acting on the CH-NH(2) group of donors (1.4.-.-)	Oxidoreductases :: Acting on the CH-NH(2) group of donors :: With NAD(+) or NADP(+) as acceptor (1.4.1.-)	Alanine dehydrogenase (1.4.1.1)	"L-erythro-3,5-diaminohexanoate dehydrogenase (1.4.1.11)"	"2,4-diaminopentanoate dehydrogenase (1.4.1.12)"	Glutamate synthase (NADPH) (1.4.1.13)	Glutamate synthase (NADH) (1.4.1.14)	Diaminopimelate dehydrogenase (1.4.1.16)	Glutamate dehydrogenase (1.4.1.2)	Aspartate dehydrogenase (1.4.1.21)	Glutamate dehydrogenase (NAD(P)(+)) (1.4.1.3)	Glutamate dehydrogenase (NADP(+)) (1.4.1.4)	Leucine dehydrogenase (1.4.1.9)	Oxidoreductases :: Acting on the CH-NH(2) group of donors :: With oxygen as acceptor (1.4.3.-)	Putrescine oxidase (1.4.3.10)	L-glutamate oxidase (1.4.3.11)	L-aspartate oxidase (1.4.3.16)	Glycine oxidase (1.4.3.19)	L-amino-acid oxidase (1.4.3.2)	D-amino-acid oxidase (1.4.3.3)	Monoamine oxidase (1.4.3.4)	Pyridoxal 5'-phosphate synthase (1.4.3.5)	Ethanolamine oxidase (1.4.3.8)	Glycine dehydrogenase (aminomethyl-transferring) (1.4.4.2)	Glutamate synthase (ferredoxin) (1.4.7.1)	D-amino-acid dehydrogenase (1.4.99.1)	Glycine dehydrogenase (cyanide-forming) (1.4.99.5)	Oxidoreductases :: Acting on the CH-NH group of donors (1.5.-.-)	Oxidoreductases :: Acting on the CH-NH group of donors :: With NAD(+) or NADP(+) as acceptor (1.5.1.-)	"Saccharopine dehydrogenase (NADP(+), L-glutamate-forming) (1.5.1.10)"	Transferred entry: 1.2.1.88 (1.5.1.12)	Methylenetetrahydrofolate dehydrogenase (NAD(+)) (1.5.1.15)	Pyrroline-5-carboxylate reductase (1.5.1.2)	Methylenetetrahydrofolate reductase (NAD(P)H) (1.5.1.20)	Opine dehydrogenase (1.5.1.28)	"Transferred entry: 1.5.1.38, 1.5.1.39 and 1.5.1.41 (1.5.1.29)"	Dihydrofolate reductase (1.5.1.3)	Flavin reductase (NADPH) (1.5.1.30)	"6,7-dihydropteridine reductase (1.5.1.34)"	FMN reductase (NADPH) (1.5.1.38)	FMN reductase (NAD(P)H) (1.5.1.39)	Riboflavin reductase (NAD(P)H) (1.5.1.41)	FMN reductase (NADH) (1.5.1.42)	Methylenetetrahydrofolate dehydrogenase (NADP(+)) (1.5.1.5)	Formyltetrahydrofolate dehydrogenase (1.5.1.6)	"Saccharopine dehydrogenase (NAD(+), L-lysine-forming) (1.5.1.7)"	"Saccharopine dehydrogenase (NADP(+), L-lysine-forming) (1.5.1.8)"	"Saccharopine dehydrogenase (NAD(+), L-glutamate-forming) (1.5.1.9)"	Oxidoreductases :: Acting on the CH-NH group of donors :: With oxygen as acceptor (1.5.3.-)	Sarcosine oxidase (1.5.3.1)	Dimethylglycine oxidase (1.5.3.10)	(R)-6-hydroxynicotine oxidase (1.5.3.6)	L-pipecolate oxidase (1.5.3.7)	Oxidoreductases :: Acting on the CH-NH group of donors :: With a quinone or similar compound as acceptor (1.5.5.-)	Electron-transferring-flavoprotein dehydrogenase (1.5.5.1)	Proline dehydrogenase (1.5.5.2)	Dimethylamine dehydrogenase (1.5.8.1)	Trimethylamine dehydrogenase (1.5.8.2)	Sarcosine dehydrogenase (1.5.8.3)	Dimethylglycine dehydrogenase (1.5.8.4)	"5,10-methylenetetrahydromethanopterin reductase (1.5.98.2)"	Transferred entry: 1.5.8.3 (1.5.99.1)	Transferred entry: 1.5.98.2 (1.5.99.11)	Transferred entry: 1.5.8.4 (1.5.99.2)	L-pipecolate dehydrogenase (1.5.99.3)	Nicotine dehydrogenase (1.5.99.4)	Methylglutamate dehydrogenase (1.5.99.5)	Spermidine dehydrogenase (1.5.99.6)	Transferred entry: 1.5.5.2 (1.5.99.8)	Transferred entry: 1.5.98.1 (1.5.99.9)	Oxidoreductases :: Acting on NADH or NADPH (1.6.-.-)	NAD(P)(+) transhydrogenase (Si-specific) (1.6.1.1)	NAD(P)(+) transhydrogenase (Re/Si-specific) (1.6.1.2)	Cytochrome-b5 reductase (1.6.2.2)	NADPH--hemoprotein reductase (1.6.2.4)	1.6.4.-	Oxidoreductases :: Acting on NADH or NADPH :: With a quinone or similar compound as acceptor (1.6.5.-)	NADPH dehydrogenase (quinone) (1.6.5.10)	NAD(P)H dehydrogenase (quinone) (1.6.5.2)	NADH:ubiquinone reductase (H(+)-translocating) (1.6.5.3)	NADPH:quinone reductase (1.6.5.5)	Oxidoreductases :: Acting on NADH or NADPH :: With a nitrogenous group as acceptor (1.6.6.-)	Trimethylamine-N-oxide reductase (1.6.6.9)	Oxidoreductases :: Acting on NADH or NADPH :: With other acceptors (1.6.99.-)	NADPH dehydrogenase (1.6.99.1)	NADH dehydrogenase (1.6.99.3)	NADH dehydrogenase (quinone) (1.6.99.5)	Oxidoreductases :: Acting on other nitrogenous compounds as donors (1.7.-.-)	Oxidoreductases :: Acting on other nitrogenous compounds as donors :: With NAD(+) or NADP(+) as acceptor (1.7.1.-)	Nitrate reductase (NADH) (1.7.1.1)	PreQ(1) synthase (1.7.1.13)	Nitrate reductase (NADPH) (1.7.1.3)	Nitrite reductase (NAD(P)H) (1.7.1.4)	GMP reductase (1.7.1.7)	Nitrite reductase (NO-forming) (1.7.2.1)	Nitrite reductase (cytochrome; ammonia-forming) (1.7.2.2)	Trimethylamine-N-oxide reductase (cytochrome c) (1.7.2.3)	Nitrous-oxide reductase (1.7.2.4)	Nitric-oxide reductase (cytochrome c) (1.7.2.5)	Factor independent urate hydroxylase (1.7.3.3)	Ferredoxin--nitrite reductase (1.7.7.1)	Ferredoxin--nitrate reductase (1.7.7.2)	Nitrate reductase (1.7.99.4)	Transferred entry: 1.7.2.4 (1.7.99.6)	Transferred entry: 1.7.2.5 (1.7.99.7)	Oxidoreductases :: Acting on a sulfur group of donors (1.8.-.-)	Oxidoreductases :: Acting on a sulfur group of donors :: With NAD(+) or NADP(+) as acceptor (1.8.1.-)	CoA-disulfide reductase (1.8.1.14)	Mycothione reductase (1.8.1.15)	Sulfite reductase (NADPH) (1.8.1.2)	Dihydrolipoyl dehydrogenase (1.8.1.4)	Glutathione-disulfide reductase (1.8.1.7)	Protein-disulfide reductase (1.8.1.8)	Thioredoxin-disulfide reductase (1.8.1.9)	Oxidoreductases :: Acting on a sulfur group of donors :: With a cytochrome as acceptor (1.8.2.-)	Sulfite dehydrogenase (1.8.2.1)	Sulfide-cytochrome-c reductase (flavocytochrome c) (1.8.2.3)	Sulfite oxidase (1.8.3.1)	Thiol oxidase (1.8.3.2)	Oxidoreductases :: Acting on a sulfur group of donors :: With a disulfide as acceptor (1.8.4.-)	Adenylyl-sulfate reductase (thioredoxin) (1.8.4.10)	Peptide-methionine (S)-S-oxide reductase (1.8.4.11)	Peptide-methionine (R)-S-oxide reductase (1.8.4.12)	L-methionine (R)-S-oxide reductase (1.8.4.14)	Phosphoadenylyl-sulfate reductase (thioredoxin) (1.8.4.8)	Oxidoreductases :: Acting on a sulfur group of donors :: With a quinone or similar compound as acceptor (1.8.5.-)	Dimethylsulfoxide reductase (1.8.5.3)	Sulfite reductase (ferredoxin) (1.8.7.1)	"Oxidoreductases :: Acting on a sulfur group of donors :: With other, known, acceptors (1.8.98.-)"	CoB--CoM heterodisulfide reductase (1.8.98.1)	Oxidoreductases :: Acting on a sulfur group of donors :: With other acceptors (1.8.99.-)	Sulfite reductase (1.8.99.1)	Adenylyl-sulfate reductase (1.8.99.2)	Oxidoreductases :: Acting on a heme group of donors :: With oxygen as acceptor (1.9.3.-)	Cytochrome-c oxidase (1.9.3.1)	Oxidoreductases :: Other oxidoreductases (1.97.-.-)	Oxidoreductases :: Other oxidoreductases :: Sole sub-subclass for oxidoreductases that do not belong in the other subclasses (1.97.1.-)	Photosystem I (1.97.1.12)	[Formate-C-acetyltransferase]-activating enzyme (1.97.1.4)	Selenate reductase (1.97.1.9)	Transferases (2.-.-.-)	Transferases :: Transferring one-carbon groups (2.1.-.-)	Transferases :: Transferring one-carbon groups :: Methyltransferases (2.1.1.-)	Homocysteine S-methyltransferase (2.1.1.10)	Protein-S-isoprenylcysteine O-methyltransferase (2.1.1.100)	Caffeoyl-CoA O-methyltransferase (2.1.1.104)	Uroporphyrinogen-III C-methyltransferase (2.1.1.107)	Magnesium protoporphyrin IX methyltransferase (2.1.1.11)	Site-specific DNA-methyltransferase (cytosine-N(4)-specific) (2.1.1.113)	Histone-arginine N-methyltransferase (2.1.1.125)	Methionine synthase (2.1.1.13)	Precorrin-2 C(20)-methyltransferase (2.1.1.130)	Precorrin-3B C(17)-methyltransferase (2.1.1.131)	"Precorrin-6B C(5,15)-methyltransferase (decarboxylating) (2.1.1.132)"	Precorrin-4 C(11)-methyltransferase (2.1.1.133)	Arsenite methyltransferase (2.1.1.137)	5-methyltetrahydropteroyltriglutamate--homocysteine S-methyltransferase (2.1.1.14)	Trans-aconitate 2-methyltransferase (2.1.1.144)	Thymidylate synthase (FAD) (2.1.1.148)	Cobalt-factor II C(20)-methyltransferase (2.1.1.151)	Precorrin-6A synthase (deacetylating) (2.1.1.152)	Demethylmenaquinone methyltransferase (2.1.1.163)	23S rRNA (uridine(2552)-2'-O)-methyltransferase (2.1.1.166)	Phosphatidylethanolamine N-methyltransferase (2.1.1.17)	16S rRNA (guanine(527)-N(7))-methyltransferase (2.1.1.170)	16S rRNA (guanine(966)-N(2))-methyltransferase (2.1.1.171)	16S rRNA (guanine(1207)-N(2))-methyltransferase (2.1.1.172)	23S rRNA (guanine(2445)-N(2))-methyltransferase (2.1.1.173)	23S rRNA (guanine(1835)-N(2))-methyltransferase (2.1.1.174)	16S rRNA (cytosine(967)-C(5))-methyltransferase (2.1.1.176)	23S rRNA (pseudouridine(1915)-N(3))-methyltransferase (2.1.1.177)	16S rRNA (cytosine(1407)-C(5))-methyltransferase (2.1.1.178)	23S rRNA (adenine(1618)-N(6))-methyltransferase (2.1.1.181)	16S rRNA (adenine(1518)-N(6)/adenine(1519)-N(6))-dimethyltransferase (2.1.1.182)	23S rRNA (adenine(2085)-N(6))-dimethyltransferase (2.1.1.184)	23S rRNA (guanosine(2251)-2'-O)-methyltransferase (2.1.1.185)	23S rRNA (cytidine(2498)-2'-O)-methyltransferase (2.1.1.186)	23S rRNA (guanine(745)-N(1))-methyltransferase (2.1.1.187)	23S rRNA (uracil(747)-C(5))-methyltransferase (2.1.1.189)	23S rRNA (uracil(1939)-C(5))-methyltransferase (2.1.1.190)	23S rRNA (cytosine(1962)-C(5))-methyltransferase (2.1.1.191)	23S rRNA (adenine(2503)-C(2))-methyltransferase (2.1.1.192)	16S rRNA (uracil(1498)-N(3))-methyltransferase (2.1.1.193)	Cobalt-precorrin-6B (C(15))-methyltransferase (decarboxylating) (2.1.1.196)	Malonyl-[acyl-carrier protein] O-methyltransferase (2.1.1.197)	16S rRNA (cytidine(1402)-2'-O)-methyltransferase (2.1.1.198)	16S rRNA (cytosine(1402)-N(4))-methyltransferase (2.1.1.199)	tRNA (cytidine(32)/uridine(32)-2'-O)-methyltransferase (2.1.1.200)	"2-methoxy-6-polyprenyl-1,4-benzoquinol methylase (2.1.1.201)"	tRNA (cytidine(56)-2'-O)-methyltransferase (2.1.1.206)	tRNA (cytidine(34)-2'-O)-methyltransferase (2.1.1.207)	Methylamine--glutamate N-methyltransferase (2.1.1.21)	tRNA (guanine(10)-N(2))-dimethyltransferase (2.1.1.213)	tRNA (adenine(57)-N(1)/adenine(58)-N(1))-methyltransferase (2.1.1.219)	tRNA (adenine(58)-N(1))-methyltransferase (2.1.1.220)	2-polyprenyl-6-hydroxyphenol methylase (2.1.1.222)	tRNA(1)(Val) (adenine(37)-N(6))-methyltransferase (2.1.1.223)	23S rRNA (cytidine(1920)-2'-O)-methyltransferase (2.1.1.226)	16S rRNA (cytidine(1409)-2'-O)-methyltransferase (2.1.1.227)	tRNA (guanine(37)-N(1))-methyltransferase (2.1.1.228)	16S rRNA (guanine(1516)-N(2))-methyltransferase (2.1.1.242)	[Trimethylamine--corrinoid protein] Co-methyltransferase (2.1.1.250)	23S rRNA (adenine(2030)-N(6))-methyltransferase (2.1.1.266)	Peptide chain release factor N(5)-glutamine methyltransferase (2.1.1.297)	Ribosomal protein L3 N(5)-glutamine methyltransferase (2.1.1.298)	tRNA (guanine(46)-N(7))-methyltransferase (2.1.1.33)	tRNA (guanosine(18)-2'-O)-methyltransferase (2.1.1.34)	tRNA (uracil(54)-C(5))-methyltransferase (2.1.1.35)	"Transferred entry: 2.1.1.217, 2.1.1.218, 2.1.1.219 and 2.1.1.220 (2.1.1.36)"	DNA (cytosine-5-)-methyltransferase (2.1.1.37)	Acetylserotonin O-methyltransferase (2.1.1.4)	Histone-lysine N-methyltransferase (2.1.1.43)	L-histidine N(alpha)-methyltransferase (2.1.1.44)	Thymidylate synthase (2.1.1.45)	Betaine--homocysteine S-methyltransferase (2.1.1.5)	Transferred entry: 2.1.1.187 and 2.1.1.188 (2.1.1.51)	"Transferred entry: 2.1.1.171, 2.1.1.172, 2.1.1.173 and 2.1.1.174 (2.1.1.52)"	mRNA (guanine-N(7)-)-methyltransferase (2.1.1.56)	tRNA (5-methylaminomethyl-2-thiouridylate)-methyltransferase (2.1.1.61)	Methylated-DNA--[protein]-cysteine S-methyltransferase (2.1.1.63)	3-demethylubiquinol 3-O-methyltransferase (2.1.1.64)	Transferred entry: 2.1.1.230 (2.1.1.66)	Thiopurine S-methyltransferase (2.1.1.67)	Phosphatidyl-N-methylethanolamine N-methyltransferase (2.1.1.71)	Site-specific DNA-methyltransferase (adenine-specific) (2.1.1.72)	(FADH(2)-oxidizing) (2.1.1.74)	Quercetin 3-O-methyltransferase (2.1.1.76)	Protein-L-isoaspartate(D-aspartate) O-methyltransferase (2.1.1.77)	Cyclopropane-fatty-acyl-phospholipid synthase (2.1.1.79)	Protein-glutamate O-methyltransferase (2.1.1.80)	Tocopherol O-methyltransferase (2.1.1.95)	"Transferases :: Transferring one-carbon groups :: Hydroxymethyl-, formyl- and related transferases (2.1.2.-)"	Glycine hydroxymethyltransferase (2.1.2.1)	Aminomethyltransferase (2.1.2.10)	3-methyl-2-oxobutanoate hydroxymethyltransferase (2.1.2.11)	UDP-4-amino-4-deoxy-L-arabinose formyltransferase (2.1.2.13)	Phosphoribosylglycinamide formyltransferase (2.1.2.2)	Phosphoribosylaminoimidazolecarboxamide formyltransferase (2.1.2.3)	Glutamate formimidoyltransferase (2.1.2.5)	Methionyl-tRNA formyltransferase (2.1.2.9)	Transferases :: Transferring one-carbon groups :: Carboxyl- and carbamoyltransferases (2.1.3.-)	Methylmalonyl-CoA carboxytransferase (2.1.3.1)	Aspartate carbamoyltransferase (2.1.3.2)	Ornithine carbamoyltransferase (2.1.3.3)	Putrescine carbamoyltransferase (2.1.3.6)	N-acetylornithine carbamoyltransferase (2.1.3.9)	Transferases :: Transferring one-carbon groups :: Amidinotransferases (2.1.4.-)	Molybdopterin molybdotransferase (2.10.1.1)	Transferases :: Transferring aldehyde or ketone residues :: Transketolases and transaldolases (2.2.1.-)	Transketolase (2.2.1.1)	"2-amino-3,7-dideoxy-D-threo-hept-6-ulosonate synthase (2.2.1.10)"	Transaldolase (2.2.1.2)	Formaldehyde transketolase (2.2.1.3)	2-hydroxy-3-oxoadipate synthase (2.2.1.5)	Acetolactate synthase (2.2.1.6)	1-deoxy-D-xylulose-5-phosphate synthase (2.2.1.7)	synthase (2.2.1.9)	Transferases :: Acyltransferases (2.3.-.-)	Transferases :: Acyltransferases :: Transferring groups other than amino-acyl groups (2.3.1.-)	Amino-acid N-acetyltransferase (2.3.1.1)	Formylmethanofuran--tetrahydromethanopterin N-formyltransferase (2.3.1.101)	N(6)-hydroxylysine O-acetyltransferase (2.3.1.102)	Arginine N-succinyltransferase (2.3.1.109)	Mycocerosate synthase (2.3.1.111)	"2,3,4,5-tetrahydropyridine-2,6-dicarboxylate N-succinyltransferase (2.3.1.117)"	N-hydroxyarylamine O-acetyltransferase (2.3.1.118)	Dihydrolipoyllysine-residue acetyltransferase (2.3.1.12)	Trehalose O-mycolyltransferase (2.3.1.122)	Ribosomal-protein-alanine N-acetyltransferase (2.3.1.128)	Acyl-[acyl-carrier-protein]--UDP-N-acetylglucosamine O-acyltransferase (2.3.1.129)	Glycine N-acyltransferase (2.3.1.13)	Glycerol-3-phosphate 1-O-acyltransferase (2.3.1.15)	Glucosamine-1-phosphate N-acetyltransferase (2.3.1.157)	Acetyl-CoA C-acyltransferase (2.3.1.16)	Lovastatin nonaketide synthase (2.3.1.161)	6-methylsalicylic acid synthase (2.3.1.165)	Dihydrolipoyllysine-residue (2-methylpropanoyl)transferase (2.3.1.168)	CO-methylating acetyl-CoA synthase (2.3.1.169)	3-oxoadipyl-CoA thiolase (2.3.1.174)	Propanoyl-CoA C-acyltransferase (2.3.1.176)	Beta-ketoacyl-[acyl-carrier-protein] synthase II (2.3.1.179)	Galactoside O-acetyltransferase (2.3.1.18)	Beta-ketoacyl-[acyl-carrier-protein] synthase III (2.3.1.180)	Lipoyl(octanoyl) transferase (2.3.1.181)	(R)-citramalate synthase (2.3.1.182)	Phosphinothricin acetyltransferase (2.3.1.183)	Acyl-homoserine-lactone synthase (2.3.1.184)	Mycothiol synthase (2.3.1.189)	Phosphate butyryltransferase (2.3.1.19)	UDP-3-O-(3-hydroxymyristoyl)glucosamine N-acyltransferase (2.3.1.191)	tRNA(Met) cytidine acetyltransferase (2.3.1.193)	Very-long-chain 3-oxoacyl-CoA synthase (2.3.1.199)	Diacylglycerol O-acyltransferase (2.3.1.20)	Lipoyl amidotransferase (2.3.1.200)	Carnitine O-palmitoyltransferase (2.3.1.21)	Phosphate propanoyltransferase (2.3.1.222)	Protein S-acyltransferase (2.3.1.225)	Chloramphenicol O-acetyltransferase (2.3.1.28)	Glycine C-acetyltransferase (2.3.1.29)	Serine O-acetyltransferase (2.3.1.30)	Homoserine O-acetyltransferase (2.3.1.31)	Glutamate N-acetyltransferase (2.3.1.35)	5-aminolevulinate synthase (2.3.1.37)	[Acyl-carrier-protein] S-acetyltransferase (2.3.1.38)	[Acyl-carrier-protein] S-malonyltransferase (2.3.1.39)	Acyl-[acyl-carrier-protein]--phospholipid O-acyltransferase (2.3.1.40)	Beta-ketoacyl-[acyl-carrier-protein] synthase I (2.3.1.41)	Phosphatidylcholine--sterol O-acyltransferase (2.3.1.43)	Homoserine O-succinyltransferase (2.3.1.46)	8-amino-7-oxononanoate synthase (2.3.1.47)	Histone acetyltransferase (2.3.1.48)	Arylamine N-acetyltransferase (2.3.1.5)	Serine C-palmitoyltransferase (2.3.1.50)	1-acylglycerol-3-phosphate O-acyltransferase (2.3.1.51)	Formate C-acetyltransferase (2.3.1.54)	Diamine N-acetyltransferase (2.3.1.57)	Dihydrolipoyllysine-residue succinyltransferase (2.3.1.61)	Carnitine O-acetyltransferase (2.3.1.7)	Naringenin-chalcone synthase (2.3.1.74)	Heparan-alpha-glucosaminide N-acetyltransferase (2.3.1.78)	Maltose O-acetyltransferase (2.3.1.79)	Phosphate acetyltransferase (2.3.1.8)	Aminoglycoside N(3')-acetyltransferase (2.3.1.81)	Aminoglycoside N(6')-acetyltransferase (2.3.1.82)	Fatty-acid synthase (2.3.1.85)	Fatty-acyl-CoA synthase (2.3.1.86)	Tetrahydrodipicolinate N-acetyltransferase (2.3.1.89)	Acetyl-CoA C-acetyltransferase (2.3.1.9)	6-deoxyerythronolide-B synthase (2.3.1.94)	Glycylpeptide N-tetradecanoyltransferase (2.3.1.97)	Phosphate acyltransferase (2.3.1.n2)	Transferases :: Acyltransferases :: Aminoacyltransferases (2.3.2.-)	Protein-glutamine gamma-glutamyltransferase (2.3.2.13)	Glutathione gamma-glutamylcysteinyltransferase (2.3.2.15)	Gamma-glutamyltransferase (2.3.2.2)	Lysyltransferase (2.3.2.3)	Glutaminyl-peptide cyclotransferase (2.3.2.5)	Leucyltransferase (2.3.2.6)	Arginyltransferase (2.3.2.8)	Transferases :: Acyltransferases :: Acyl groups converted into alkyl on transfer (2.3.3.-)	Citrate (Si)-synthase (2.3.3.1)	Hydroxymethylglutaryl-CoA synthase (2.3.3.10)	2-isopropylmalate synthase (2.3.3.13)	Homocitrate synthase (2.3.3.14)	Sulfoacetaldehyde acetyltransferase (2.3.3.15)	Citrate synthase (unknown stereospecificity) (2.3.3.16)	2-methylcitrate synthase (2.3.3.5)	ATP citrate synthase (2.3.3.8)	Malate synthase (2.3.3.9)	Transferases :: Glycosyltransferases (2.4.-.-)	Transferases :: Glycosyltransferases :: Hexosyltransferases (2.4.1.-)	Glycogen phosphorylase (2.4.1.1)	Levansucrase (2.4.1.10)	Dolichyl-phosphate-mannose-protein mannosyltransferase (2.4.1.109)	Glycogen(starch) synthase (2.4.1.11)	Dolichyl-phosphate beta-glucosyltransferase (2.4.1.117)	Transferred entry: 2.4.99.18 (2.4.1.119)	Cellulose synthase (UDP-forming) (2.4.1.12)	Inositol 3-alpha-galactosyltransferase (2.4.1.123)	Peptidoglycan glycosyltransferase (2.4.1.129)	Sucrose synthase (2.4.1.13)	"GDP-Man:Man(3)GlcNAc(2)-PP-dolichol alpha-1,2-mannosyltransferase (2.4.1.131)"	Sucrose-phosphate synthase (2.4.1.14)	"Alpha,alpha-trehalose-phosphate synthase (UDP-forming) (2.4.1.15)"	"1,2-diacylglycerol 3-glucosyltransferase (2.4.1.157)"	Chitin synthase (2.4.1.16)	Glucuronosyltransferase (2.4.1.17)	Sterol 3-beta-glucosyltransferase (2.4.1.173)	acetylgalactosaminyltransferase (2.4.1.175)	"1,4-alpha-glucan branching enzyme (2.4.1.18)"	Lipopolysaccharide N-acetylmannosaminouronosyltransferase (2.4.1.180)	Lipid-A-disaccharide synthase (2.4.1.182)	"Alpha-1,3-glucan synthase (2.4.1.183)"	Glycogenin glucosyltransferase (2.4.1.186)	mannosaminyltransferase (2.4.1.187)	Cyclomaltodextrin glucanotransferase (2.4.1.19)	Dextrin dextranase (2.4.1.2)	Cellobiose phosphorylase (2.4.1.20)	Starch synthase (2.4.1.21)	"1,3-beta-galactosyl-N-acetylhexosamine phosphorylase (2.4.1.211)"	Glucosylglycerol-phosphate synthase (2.4.1.213)	Trehalose 6-phosphate phosphorylase (2.4.1.216)	Mannosyl-3-phosphoglycerate synthase (2.4.1.217)	N-acetylgalactosaminyl-proteoglycan 3-beta-glucuronosyltransferase (2.4.1.226)	acetylglucosaminyltransferase (2.4.1.227)	Kojibiose phosphorylase (2.4.1.230)	"Alpha,alpha-trehalose synthase (2.4.1.245)"	Mannosylfructose-phosphate synthase (2.4.1.246)	4-alpha-glucanotransferase (2.4.1.25)	D-inositol-3-phosphate glycosyltransferase (2.4.1.250)	4-O-beta-D-mannosyl-D-glucose phosphorylase (2.4.1.281)	N-acetylglucosaminyl-diphospho-decaprenol L-rhamnosyltransferase (2.4.1.289)	Glucomannan 4-beta-mannosyltransferase (2.4.1.32)	"1,3-beta-glucan synthase (2.4.1.34)"	Fucosylgalactoside 3-alpha-galactosyltransferase (2.4.1.37)	Amylosucrase (2.4.1.4)	Glycoprotein-fucosylgalactoside alpha-N-acetylgalactosaminyltransferase (2.4.1.40)	Polypeptide N-acetylgalactosaminyltransferase (2.4.1.41)	Monogalactosyldiacylglycerol synthase (2.4.1.46)	N-acylsphingosine galactosyltransferase (2.4.1.47)	Dextransucrase (2.4.1.5)	Poly(glycerol-phosphate) alpha-glucosyltransferase (2.4.1.52)	Phosphatidylinositol alpha-mannosyltransferase (2.4.1.57)	Lipopolysaccharide glucosyltransferase I (2.4.1.58)	"Alpha,alpha-trehalose phosphorylase (2.4.1.64)"	Galactoside 2-alpha-L-fucosyltransferase (2.4.1.69)	Sucrose phosphorylase (2.4.1.7)	Phosphopolyprenol glucosyltransferase (2.4.1.78)	Maltose phosphorylase (2.4.1.8)	Ceramide glucosyltransferase (2.4.1.80)	Dolichyl-phosphate beta-D-mannosyltransferase (2.4.1.83)	Transferases :: Glycosyltransferases :: Pentosyltransferases (2.4.2.-)	Purine-nucleoside phosphorylase (2.4.2.1)	Orotate phosphoribosyltransferase (2.4.2.10)	Transferred entry: 6.3.4.21 (2.4.2.11)	Nicotinamide phosphoribosyltransferase (2.4.2.12)	Amidophosphoribosyltransferase (2.4.2.14)	ATP phosphoribosyltransferase (2.4.2.17)	Anthranilate phosphoribosyltransferase (2.4.2.18)	Nicotinate-nucleotide diphosphorylase (carboxylating) (2.4.2.19)	Pyrimidine-nucleoside phosphorylase (2.4.2.2)	Nicotinate-nucleotide--dimethylbenzimidazole phosphoribosyltransferase (2.4.2.21)	Xanthine phosphoribosyltransferase (2.4.2.22)	S-methyl-5'-thioadenosine phosphorylase (2.4.2.28)	tRNA-guanine(34) transglycosylase (2.4.2.29)	Uridine phosphorylase (2.4.2.3)	NAD(+)--protein-arginine ADP-ribosyltransferase (2.4.2.31)	Thymidine phosphorylase (2.4.2.4)	Lipid IV(A) 4-amino-4-deoxy-L-arabinosyltransferase (2.4.2.43)	S-methyl-5'-thioinosine phosphorylase (2.4.2.44)	tRNA-guanine(15) transglycosylase (2.4.2.48)	Triphosphoribosyl-dephospho-CoA synthase (2.4.2.52)	Undecaprenyl-phosphate 4-deoxy-4-formamido-L-arabinose transferase (2.4.2.53)	Adenine phosphoribosyltransferase (2.4.2.7)	Hypoxanthine phosphoribosyltransferase (2.4.2.8)	Uracil phosphoribosyltransferase (2.4.2.9)	Transferases :: Glycosyltransferases :: Transferring other glycosyl groups (2.4.99.-)	Starch synthase (maltosyl-transferring) (2.4.99.16)	S-adenosylmethionine:tRNA ribosyltransferase-isomerase (2.4.99.17)	Dolichyl-diphosphooligosaccharide--protein glycotransferase (2.4.99.18)	"Transferases :: Transferring alkyl or aryl groups, other than methyl groups (2.5.-.-)"	"Transferases :: Transferring alkyl or aryl groups, other than methyl groups :: Transferring alkyl or aryl groups, other than methyl groups (2.5.1.-)"	Dimethylallyltranstransferase (2.5.1.1)	"(2E,6E)-farnesyl diphosphate synthase (2.5.1.10)"	Dihydropteroate synthase (2.5.1.15)	Spermidine synthase (2.5.1.16)	"Cob(I)yrinic acid a,c-diamide adenosyltransferase (2.5.1.17)"	Glutathione transferase (2.5.1.18)	3-phosphoshikimate 1-carboxyvinyltransferase (2.5.1.19)	Thiamine pyridinylase (2.5.1.2)	Squalene synthase (2.5.1.21)	Alkylglycerone-phosphate synthase (2.5.1.26)	Geranylgeranyl diphosphate synthase (2.5.1.29)	Thiamine-phosphate diphosphorylase (2.5.1.3)	Heptaprenyl diphosphate synthase (2.5.1.30)	diphosphate specific) (2.5.1.31)	15-cis-phytoene synthase (2.5.1.32)	4-hydroxybenzoate polyprenyltransferase (2.5.1.39)	Phosphoglycerol geranylgeranyltransferase (2.5.1.41)	Homospermidine synthase (2.5.1.44)	Homospermidine synthase (spermidine-specific) (2.5.1.45)	Deoxyhypusine synthase (2.5.1.46)	Cysteine synthase (2.5.1.47)	Cystathionine gamma-synthase (2.5.1.48)	O-acetylhomoserine aminocarboxypropyltransferase (2.5.1.49)	Galactose-6-sulfurylase (2.5.1.5)	3-deoxy-7-phosphoheptulonate synthase (2.5.1.54)	3-deoxy-8-phosphooctulonate synthase (2.5.1.55)	N-acetylneuraminate synthase (2.5.1.56)	N-acylneuraminate-9-phosphate synthase (2.5.1.57)	Methionine adenosyltransferase (2.5.1.6)	Hydroxymethylbilane synthase (2.5.1.61)	Chlorophyll synthase (2.5.1.62)	O-phosphoserine sulfhydrylase (2.5.1.65)	UDP-N-acetylglucosamine 1-carboxyvinyltransferase (2.5.1.7)	Quinolinate synthase (2.5.1.72)	"1,4-dihydroxy-2-naphthoate polyprenyltransferase (2.5.1.74)"	tRNA dimethylallyltransferase (2.5.1.75)	"7,8-didemethyl-8-hydroxy-5-deazariboflavin synthase (2.5.1.77)"	"6,7-dimethyl-8-ribityllumazine synthase (2.5.1.78)"	diphosphate specific) (2.5.1.89)	Riboflavin synthase (2.5.1.9)	All-trans-octaprenyl-diphosphate synthase (2.5.1.90)	All-trans-decaprenyl-diphosphate synthase (2.5.1.91)	2.5.1.n9	Transferases :: Transferring nitrogenous groups (2.6.-.-)	Transferases :: Transferring nitrogenous groups :: Transaminases (aminotransferases) (2.6.1.-)	Aspartate transaminase (2.6.1.1)	L-glutamine:2-deoxy-scyllo-inosose aminotransferase (2.6.1.100)	Acetylornithine transaminase (2.6.1.11)	Ornithine aminotransferase (2.6.1.13)	Glutamine--fructose-6-phosphate transaminase (isomerizing) (2.6.1.16)	Succinyldiaminopimelate transaminase (2.6.1.17)	Beta-alanine--pyruvate transaminase (2.6.1.18)	4-aminobutyrate--2-oxoglutarate transaminase (2.6.1.19)	Alanine transaminase (2.6.1.2)	D-amino-acid transaminase (2.6.1.21)	(S)-3-amino-2-methylpropionate transaminase (2.6.1.22)	L-lysine 6-transaminase (2.6.1.36)	2-aminoethylphosphonate--pyruvate transaminase (2.6.1.37)	2-aminoadipate transaminase (2.6.1.39)	(R)-3-amino-2-methylpropionate--pyruvate transaminase (2.6.1.40)	Branched-chain-amino-acid transaminase (2.6.1.42)	Alanine--glyoxylate transaminase (2.6.1.44)	Serine--glyoxylate transaminase (2.6.1.45)	Diaminobutyrate--pyruvate transaminase (2.6.1.46)	Tyrosine transaminase (2.6.1.5)	Glutamine--scyllo-inositol transaminase (2.6.1.50)	Serine--pyruvate transaminase (2.6.1.51)	Phosphoserine transaminase (2.6.1.52)	Aromatic-amino-acid transaminase (2.6.1.57)	"dTDP-4-amino-4,6-dideoxygalactose transaminase (2.6.1.59)"	Adenosylmethionine--8-amino-7-oxononanoate transaminase (2.6.1.62)	Valine--pyruvate transaminase (2.6.1.66)	Kynurenine--oxoglutarate transaminase (2.6.1.7)	Diaminobutyrate--2-oxoglutarate transaminase (2.6.1.76)	Taurine--pyruvate aminotransferase (2.6.1.77)	Succinylornithine transaminase (2.6.1.81)	Putrescine aminotransferase (2.6.1.82)	LL-diaminopimelate aminotransferase (2.6.1.83)	Aminodeoxychorismate synthase (2.6.1.85)	UDP-4-amino-4-deoxy-L-arabinose aminotransferase (2.6.1.87)	Histidinol-phosphate transaminase (2.6.1.9)	UDP-2-acetamido-2-deoxy-ribo-hexuluronate aminotransferase (2.6.1.98)	Pyridoxine 5'-phosphate synthase (2.6.99.2)	N(6)-L-threonylcarbamoyladenine synthase (2.6.99.4)	Transferases :: Transferring phosphorous-containing groups (2.7.-.-)	Transferases :: Transferring phosphorous-containing groups :: Phosphotransferases with an alcohol group as acceptor (2.7.1.-)	S-methyl-5-thioribose kinase (2.7.1.100)	"Glucose-1,6-bisphosphate synthase (2.7.1.106)"	Diacylglycerol kinase (ATP) (2.7.1.107)	6-phosphofructokinase (2.7.1.11)	Transferred entry: 2.7.10.1 and 2.7.10.2 (2.7.1.112)	Deoxyguanosine kinase (2.7.1.113)	Gluconokinase (2.7.1.12)	Phosphoenolpyruvate--glycerone phosphotransferase (2.7.1.121)	Inositol-trisphosphate 3-kinase (2.7.1.127)	Dehydrogluconokinase (2.7.1.13)	Tetraacyldisaccharide 4'-kinase (2.7.1.130)	Phosphatidylinositol 3-kinase (2.7.1.137)	Tagatose-6-phosphate kinase (2.7.1.144)	Deoxynucleoside kinase (2.7.1.145)	4-(cytidine 5'-diphospho)-2-C-methyl-D-erythritol kinase (2.7.1.148)	Ribokinase (2.7.1.15)	1-phosphatidylinositol-3-phosphate 5-kinase (2.7.1.150)	Adenosylcobinamide kinase (2.7.1.156)	Ribulokinase (2.7.1.16)	CTP-dependent riboflavin kinase (2.7.1.161)	3-deoxy-D-manno-octulosonic acid kinase (2.7.1.166)	Xylulokinase (2.7.1.17)	Anhydro-N-acetylmuramic acid kinase (2.7.1.170)	Maltokinase (2.7.1.175)	Phosphoribulokinase (2.7.1.19)	Glucokinase (2.7.1.2)	Adenosine kinase (2.7.1.20)	Thymidine kinase (2.7.1.21)	Ribosylnicotinamide kinase (2.7.1.22)	NAD(+) kinase (2.7.1.23)	Dephospho-CoA kinase (2.7.1.24)	Adenylyl-sulfate kinase (2.7.1.25)	Riboflavin kinase (2.7.1.26)	Glycerone kinase (2.7.1.29)	Glycerol kinase (2.7.1.30)	Glycerate 3-kinase (2.7.1.31)	Pantothenate kinase (2.7.1.33)	Pyridoxal kinase (2.7.1.35)	Mevalonate kinase (2.7.1.36)	Homoserine kinase (2.7.1.39)	Fructokinase (2.7.1.4)	Pyruvate kinase (2.7.1.40)	2-dehydro-3-deoxygluconokinase (2.7.1.45)	D-ribulokinase (2.7.1.47)	Uridine kinase (2.7.1.48)	Hydroxymethylpyrimidine kinase (2.7.1.49)	Rhamnulokinase (2.7.1.5)	Hydroxyethylthiazole kinase (2.7.1.50)	Fucokinase (2.7.1.52)	L-xylulokinase (2.7.1.53)	1-phosphofructokinase (2.7.1.56)	2-dehydro-3-deoxygalactonokinase (2.7.1.58)	N-acetylglucosamine kinase (2.7.1.59)	Galactokinase (2.7.1.6)	Polyphosphate--glucose phosphotransferase (2.7.1.63)	1-phosphatidylinositol 4-kinase (2.7.1.67)	1-phosphatidylinositol-4-phosphate 5-kinase (2.7.1.68)	Protein-N(pi)-phosphohistidine--sugar phosphotransferase (2.7.1.69)	Shikimate kinase (2.7.1.71)	Streptomycin 6-kinase (2.7.1.72)	Inosine kinase (2.7.1.73)	Deoxyadenosine kinase (2.7.1.76)	Polynucleotide 5'-hydroxyl-kinase (2.7.1.78)	Pseudouridine kinase (2.7.1.83)	Streptomycin 3''-kinase (2.7.1.87)	Thiamine kinase (2.7.1.89)	Diphosphate--fructose-6-phosphate 1-phosphotransferase (2.7.1.90)	5-dehydro-2-deoxygluconokinase (2.7.1.92)	Kanamycin kinase (2.7.1.95)	Transferases :: Transferring phosphorous-containing groups :: Protein-tyrosine kinases (2.7.10.-)	Receptor protein-tyrosine kinase (2.7.10.1)	Non-specific protein-tyrosine kinase (2.7.10.2)	Transferases :: Transferring phosphorous-containing groups :: Protein-serine/threonine kinases (2.7.11.-)	Non-specific serine/threonine protein kinase (2.7.11.1)	cAMP-dependent protein kinase (2.7.11.11)	Protein kinase C (2.7.11.13)	Rhodopsin kinase (2.7.11.14)	[Beta-adrenergic-receptor] kinase (2.7.11.15)	Calcium/calmodulin-dependent protein kinase (2.7.11.17)	[Myosin light-chain] kinase (2.7.11.18)	Polo kinase (2.7.11.21)	Cyclin-dependent kinase (2.7.11.22)	[RNA-polymerase]-subunit kinase (2.7.11.23)	Mitogen-activated protein kinase (2.7.11.24)	Mitogen-activated protein kinase kinase kinase (2.7.11.25)	"[Pyruvate, phosphate dikinase] kinase (2.7.11.32)"	[Isocitrate dehydrogenase (NADP(+))] kinase (2.7.11.5)	[Myosin heavy-chain] kinase (2.7.11.7)	Dual-specificity kinase (2.7.12.1)	Mitogen-activated protein kinase kinase (2.7.12.2)	Transferases :: Transferring phosphorous-containing groups :: Protein-histidine kinases (2.7.13.-)	Protein-histidine pros-kinase (2.7.13.1)	Histidine kinase (2.7.13.3)	Transferases :: Transferring phosphorous-containing groups :: Phosphotransferases with a carboxyl group as acceptor (2.7.2.-)	Acetate kinase (2.7.2.1)	Glutamate 5-kinase (2.7.2.11)	Propionate kinase (2.7.2.15)	Carbamate kinase (2.7.2.2)	Phosphoglycerate kinase (2.7.2.3)	Aspartate kinase (2.7.2.4)	Butyrate kinase (2.7.2.7)	Acetylglutamate kinase (2.7.2.8)	Transferases :: Transferring phosphorous-containing groups :: Phosphotransferases with a nitrogenous group as acceptor (2.7.3.-)	Phosphoenolpyruvate--protein phosphotransferase (2.7.3.9)	Transferases :: Transferring phosphorous-containing groups :: Phosphotransferases with a phosphate group as acceptor (2.7.4.-)	Polyphosphate kinase (2.7.4.1)	UMP/CMP kinase (2.7.4.14)	Thiamine-phosphate kinase (2.7.4.16)	Phosphomevalonate kinase (2.7.4.2)	UMP kinase (2.7.4.22)	"Ribose 1,5-bisphosphate phosphokinase (2.7.4.23)"	(d)CMP kinase (2.7.4.25)	"([Pyruvate, phosphate dikinase] phosphate) phosphotransferase (2.7.4.27)"	Adenylate kinase (2.7.4.3)	Nucleoside-diphosphate kinase (2.7.4.6)	Phosphomethylpyrimidine kinase (2.7.4.7)	Guanylate kinase (2.7.4.8)	dTMP kinase (2.7.4.9)	Ribose-phosphate diphosphokinase (2.7.6.1)	Thiamine diphosphokinase (2.7.6.2)	2-amino-4-hydroxy-6-hydroxymethyldihydropteridine diphosphokinase (2.7.6.3)	GTP diphosphokinase (2.7.6.5)	Transferases :: Transferring phosphorous-containing groups :: Nucleotidyltransferases (2.7.7.-)	Nicotinamide-nucleotide adenylyltransferase (2.7.7.1)	UDP-glucose--hexose-1-phosphate uridylyltransferase (2.7.7.12)	Mannose-1-phosphate guanylyltransferase (2.7.7.13)	Choline-phosphate cytidylyltransferase (2.7.7.15)	Nicotinate-nucleotide adenylyltransferase (2.7.7.18)	Polynucleotide adenylyltransferase (2.7.7.19)	FAD synthetase (2.7.7.2)	Transferred entry: 2.7.7.72 (2.7.7.21)	Mannose-1-phosphate guanylyltransferase (GDP) (2.7.7.22)	UDP-N-acetylglucosamine diphosphorylase (2.7.7.23)	Glucose-1-phosphate thymidylyltransferase (2.7.7.24)	Transferred entry: 2.7.7.72 (2.7.7.25)	Glucose-1-phosphate adenylyltransferase (2.7.7.27)	Pantetheine-phosphate adenylyltransferase (2.7.7.3)	Glucose-1-phosphate cytidylyltransferase (2.7.7.33)	3-deoxy-manno-octulosonate cytidylyltransferase (2.7.7.38)	Glycerol-3-phosphate cytidylyltransferase (2.7.7.39)	Sulfate adenylyltransferase (2.7.7.4)	Phosphatidate cytidylyltransferase (2.7.7.41)	[Glutamate--ammonia-ligase] adenylyltransferase (2.7.7.42)	N-acylneuraminate cytidylyltransferase (2.7.7.43)	Streptomycin 3''-adenylyltransferase (2.7.7.47)	RNA-directed RNA polymerase (2.7.7.48)	RNA-directed DNA polymerase (2.7.7.49)	mRNA guanylyltransferase (2.7.7.50)	ATP adenylyltransferase (2.7.7.53)	tRNA nucleotidyltransferase (2.7.7.56)	"(2,3-dihydroxybenzoyl)adenylate synthase (2.7.7.58)"	[Protein-PII] uridylyltransferase (2.7.7.59)	DNA-directed RNA polymerase (2.7.7.6)	2-C-methyl-D-erythritol 4-phosphate cytidylyltransferase (2.7.7.60)	Citrate lyase holo-[acyl-carrier-protein] synthase (2.7.7.61)	Adenosylcobinamide-phosphate guanylyltransferase (2.7.7.62)	Lipoate--protein ligase (2.7.7.63)	Diguanylate cyclase (2.7.7.65)	Malonate decarboxylase holo-[acyl-carrier-protein] synthase (2.7.7.66)	2-phospho-L-lactate guanylyltransferase (2.7.7.68)	DNA-directed DNA polymerase (2.7.7.7)	CCA tRNA nucleotidyltransferase (2.7.7.72)	Sulfur carrier protein ThiS adenylyltransferase (2.7.7.73)	Molybdenum cofactor guanylyltransferase (2.7.7.77)	Polyribonucleotide nucleotidyltransferase (2.7.7.8)	Molybdopterin-synthase adenylyltransferase (2.7.7.80)	L-threonylcarbamoyladenylate synthase (2.7.7.87)	UTP--glucose-1-phosphate uridylyltransferase (2.7.7.9)	Transferases :: Transferring phosphorous-containing groups :: Transferases for other substituted phosphate groups (2.7.8.-)	CDP-diacylglycerol--inositol 3-phosphatidyltransferase (2.7.8.11)	CDP-glycerol glycerophosphotransferase (2.7.8.12)	Phospho-N-acetylmuramoyl-pentapeptide-transferase (2.7.8.13)	N-acetylglucosaminephosphotransferase (2.7.8.15)	Phosphatidylglycerol--membrane-oligosaccharide glycerophosphotransferase (2.7.8.20)	Carboxyvinyl-carboxyphosphonate phosphorylmutase (2.7.8.23)	Phosphatidylcholine synthase (2.7.8.24)	Transferred entry: 2.4.2.52 (2.7.8.25)	2-phospho-L-lactate transferase (2.7.8.28)	Undecaprenyl-phosphate glucose phosphotransferase (2.7.8.31)	N-acetylglucosaminephosphotransferase (2.7.8.33)	Alpha-D-ribose 1-methylphosphonate 5-triphosphate synthase (2.7.8.37)	CDP-diacylglycerol--glycerol-3-phosphate 3-phosphatidyltransferase (2.7.8.5)	Undecaprenyl-phosphate galactose phosphotransferase (2.7.8.6)	Holo-[acyl-carrier-protein] synthase (2.7.8.7)	CDP-diacylglycerol--serine O-phosphatidyltransferase (2.7.8.8)	"Pyruvate, phosphate dikinase (2.7.9.1)"	"Pyruvate, water dikinase (2.7.9.2)"	"Selenide, water dikinase (2.7.9.3)"	Transferases :: Transferring sulfur-containing groups (2.8.-.-)	Transferases :: Transferring sulfur-containing groups :: Sulfurtransferases (2.8.1.-)	Thiosulfate sulfurtransferase (2.8.1.1)	Thiazole synthase (2.8.1.10)	Molybdopterin synthase (2.8.1.12)	3-mercaptopyruvate sulfurtransferase (2.8.1.2)	tRNA sulfurtransferase (2.8.1.4)	Biotin synthase (2.8.1.6)	Cysteine desulfurase (2.8.1.7)	Lipoyl synthase (2.8.1.8)	Molybdenum cofactor sulfurtransferase (2.8.1.9)	Transferases :: Transferring sulfur-containing groups :: Sulfotransferases (2.8.2.-)	Aryl sulfotransferase (2.8.2.1)	Transferases :: Transferring sulfur-containing groups :: CoA-transferases (2.8.3.-)	Propionate CoA-transferase (2.8.3.1)	Citrate CoA-transferase (2.8.3.10)	Glutaconate CoA-transferase (2.8.3.12)	Succinyl-CoA:(R)-benzylsuccinate CoA-transferase (2.8.3.15)	Formyl-CoA transferase (2.8.3.16)	3-oxoacid CoA-transferase (2.8.3.5)	3-oxoadipate CoA-transferase (2.8.3.6)	Acetate CoA-transferase (2.8.3.8)	Butyrate--acetoacetate CoA-transferase (2.8.3.9)	tRNA-2-methylthio-N(6)-dimethylallyladenosine synthase (2.8.4.3)	Transferases :: Transferring selenium-containing groups :: Selenotransferases (2.9.1.-)	L-seryl-tRNA(Sec) selenium transferase (2.9.1.1)	Hydrolases (3.-.-.-)	Hydrolases :: Acting on ester bonds (3.1.-.-)	Hydrolases :: Acting on ester bonds :: Carboxylic ester hydrolases (3.1.1.-)	Carboxylesterase (3.1.1.1)	Pectinesterase (3.1.1.11)	Sterol esterase (3.1.1.13)	L-arabinonolactonase (3.1.1.15)	Gluconolactonase (3.1.1.17)	Arylesterase (3.1.1.2)	Tannase (3.1.1.20)	Hydroxybutyrate-dimer hydrolase (3.1.1.22)	Acylglycerol lipase (3.1.1.23)	3-oxoadipate enol-lactonase (3.1.1.24)	Aminoacyl-tRNA hydrolase (3.1.1.29)	Triacylglycerol lipase (3.1.1.3)	6-phosphogluconolactonase (3.1.1.31)	Phospholipase A(1) (3.1.1.32)	Phospholipase A(2) (3.1.1.4)	Cephalosporin-C deacetylase (3.1.1.41)	Chlorogenate hydrolase (3.1.1.42)	Alpha-amino-acid esterase (3.1.1.43)	Carboxymethylenebutenolidase (3.1.1.45)	1-alkyl-2-acetylglycerophosphocholine esterase (3.1.1.47)	Lysophospholipase (3.1.1.5)	Sialate O-acetylesterase (3.1.1.53)	"2-pyrone-4,6-dicarboxylate lactonase (3.1.1.57)"	N-acetylgalactosaminoglycan deacetylase (3.1.1.58)	Acetylesterase (3.1.1.6)	Protein-glutamate methylesterase (3.1.1.61)	Acetylcholinesterase (3.1.1.7)	Acetylxylan esterase (3.1.1.72)	Feruloyl esterase (3.1.1.73)	Poly(3-hydroxybutyrate) depolymerase (3.1.1.75)	Acyloxyacyl hydrolase (3.1.1.77)	Cholinesterase (3.1.1.8)	Cocaine esterase (3.1.1.84)	Pimeloyl-[acyl-carrier protein] methyl ester esterase (3.1.1.85)	Hydrolases :: Acting on ester bonds :: Exodeoxyribonucleases producing 5'-phosphomonoesters (3.1.11.-)	Exodeoxyribonuclease I (3.1.11.1)	Exodeoxyribonuclease III (3.1.11.2)	Exodeoxyribonuclease V (3.1.11.5)	Exodeoxyribonuclease VII (3.1.11.6)	Hydrolases :: Acting on ester bonds :: Exoribonucleases producing 5'-phosphomonoesters (3.1.13.-)	Exoribonuclease II (3.1.13.1)	Poly(A)-specific ribonuclease (3.1.13.4)	Ribonuclease D (3.1.13.5)	Hydrolases :: Acting on ester bonds :: Exonucleases active with either ribo- or deoxyribonucleic acid and producing 5'-phosphomonoesters (3.1.15.-)	Hydrolases :: Acting on ester bonds :: Exonucleases active with either ribo- or deoxyribonucleic acid and producing 3'-phosphomonoesters (3.1.16.-)	Hydrolases :: Acting on ester bonds :: Thiolester hydrolases (3.1.2.-)	Acetyl-CoA hydrolase (3.1.2.1)	S-formylglutathione hydrolase (3.1.2.12)	Oleoyl-[acyl-carrier-protein] hydrolase (3.1.2.14)	Palmitoyl-CoA hydrolase (3.1.2.2)	Acyl-CoA hydrolase (3.1.2.20)	4-hydroxybenzoyl-CoA thioesterase (3.1.2.23)	Choloyl-CoA hydrolase (3.1.2.27)	3-hydroxyisobutyryl-CoA hydrolase (3.1.2.4)	Hydroxyacylglutathione hydrolase (3.1.2.6)	Hydrolases :: Acting on ester bonds :: Endodeoxyribonucleases producing 5'-phosphomonoesters (3.1.21.-)	Deoxyribonuclease I (3.1.21.1)	Deoxyribonuclease IV (3.1.21.2)	Type I site-specific deoxyribonuclease (3.1.21.3)	Type II site-specific deoxyribonuclease (3.1.21.4)	Type III site-specific deoxyribonuclease (3.1.21.5)	Deoxyribonuclease V (3.1.21.7)	Hydrolases :: Acting on ester bonds :: Endodeoxyribonucleases producing other than 5'-phosphomonoesters (3.1.22.-)	Crossover junction endodeoxyribonuclease (3.1.22.4)	Hydrolases :: Acting on ester bonds :: Site-specific endodeoxyribonucleases specific for altered bases (3.1.25.-)	Hydrolases :: Acting on ester bonds :: Endoribonucleases producing 5'-phosphomonoesters (3.1.26.-)	Ribonuclease Z (3.1.26.11)	Ribonuclease E (3.1.26.12)	Ribonuclease III (3.1.26.3)	Ribonuclease H (3.1.26.4)	Ribonuclease P (3.1.26.5)	Ribonuclease M5 (3.1.26.8)	Hydrolases :: Acting on ester bonds :: Endoribonucleases producing other than 5'-phosphomonoesters (3.1.27.-)	Ribonuclease T(1) (3.1.27.3)	Enterobacter ribonuclease (3.1.27.6)	Transferred entry: 4.6.1.16 (3.1.27.9)	Hydrolases :: Acting on ester bonds :: Phosphoric monoester hydrolases (3.1.3.-)	Alkaline phosphatase (3.1.3.1)	Glucose-1-phosphatase (3.1.3.10)	Fructose-bisphosphatase (3.1.3.11)	Trehalose-phosphatase (3.1.3.12)	Histidinol-phosphatase (3.1.3.15)	Protein-serine/threonine phosphatase (3.1.3.16)	Phosphoglycolate phosphatase (3.1.3.18)	Acid phosphatase (3.1.3.2)	Sugar-phosphatase (3.1.3.23)	Sucrose-phosphate phosphatase (3.1.3.24)	Inositol-phosphate phosphatase (3.1.3.25)	4-phytase (3.1.3.26)	Phosphatidylglycerophosphatase (3.1.3.27)	N-acylneuraminate-9-phosphatase (3.1.3.29)	Phosphoserine phosphatase (3.1.3.3)	Phosphoinositide 5-phosphatase (3.1.3.36)	Phosphatidate phosphatase (3.1.3.4)	4-nitrophenylphosphatase (3.1.3.41)	[Pyruvate dehydrogenase (acetyl-transferring)]-phosphatase (3.1.3.43)	3-deoxy-manno-octulosonate-8-phosphatase (3.1.3.45)	"Fructose-2,6-bisphosphate 2-phosphatase (3.1.3.46)"	Protein-tyrosine-phosphatase (3.1.3.48)	5'-nucleotidase (3.1.3.5)	3'-nucleotidase (3.1.3.6)	"3'(2'),5'-bisphosphate nucleotidase (3.1.3.7)"	Mannosyl-3-phosphoglycerate phosphatase (3.1.3.70)	2-phosphosulfolactate phosphatase (3.1.3.71)	Adenosylcobalamin/alpha-ribazole phosphatase (3.1.3.73)	Pyridoxal phosphatase (3.1.3.74)	Acireductone synthase (3.1.3.77)	Mannosylfructose-phosphate phosphatase (3.1.3.79)	3-phytase (3.1.3.8)	2-hydroxy-3-keto-5-methylthiopentenyl-1-phosphate phosphatase (3.1.3.87)	5'-deoxynucleotidase (3.1.3.89)	Hydrolases :: Acting on ester bonds :: Endoribonucleases active with either ribo- or deoxyribonucleic acid and producing 5'-phosphomonoesters (3.1.30.-)	Aspergillus nuclease S(1) (3.1.30.1)	Hydrolases :: Acting on ester bonds :: Endoribonucleases active with either ribo- or deoxyribonucleic acid and producing 3'-phosphomonoesters (3.1.31.-)	Micrococcal nuclease (3.1.31.1)	Hydrolases :: Acting on ester bonds :: Phosphoric diester hydrolases (3.1.4.-)	Phosphodiesterase I (3.1.4.1)	Phosphoinositide phospholipase C (3.1.4.11)	Sphingomyelin phosphodiesterase (3.1.4.12)	[Acyl-carrier-protein] phosphodiesterase (3.1.4.14)	"2',3'-cyclic-nucleotide 2'-phosphodiesterase (3.1.4.16)"	"3',5'-cyclic-nucleotide phosphodiesterase (3.1.4.17)"	Phospholipase C (3.1.4.3)	"3',5'-cyclic-GMP phosphodiesterase (3.1.4.35)"	Phospholipase D (3.1.4.4)	Glycerophosphodiester phosphodiesterase (3.1.4.46)	Cyclic-guanylate-specific phosphodiesterase (3.1.4.52)	Hydrolases :: Acting on ester bonds :: Triphosphoric monoester hydrolases (3.1.5.-)	dGTPase (3.1.5.1)	Hydrolases :: Acting on ester bonds :: Sulfuric ester hydrolases (3.1.6.-)	Arylsulfatase (3.1.6.1)	Iduronate-2-sulfatase (3.1.6.13)	N-acetylglucosamine-6-sulfatase (3.1.6.14)	Steryl-sulfatase (3.1.6.2)	N-acetylgalactosamine-6-sulfatase (3.1.6.4)	Choline-sulfatase (3.1.6.6)	Cerebroside-sulfatase (3.1.6.8)	"Guanosine-3',5'-bis(diphosphate) 3'-diphosphatase (3.1.7.2)"	Aryldialkylphosphatase (3.1.8.1)	N-sulfoglucosamine sulfohydrolase (3.10.1.1)	Phosphonoacetaldehyde hydrolase (3.11.1.1)	Phosphonoacetate hydrolase (3.11.1.2)	Hydrolases :: Acting on carbon-sulfur bonds (3.13.-.-)	UDP-sulfoquinovose synthase (3.13.1.1)	2'-hydroxybiphenyl-2-sulfinate desulfinase (3.13.1.3)	Hydrolases :: Glycosylases (3.2.-.-)	"Hydrolases :: Glycosylases :: Glycosidases, i.e. enzymes hydrolyzing O- and S-glycosyl compounds (3.2.1.-)"	Alpha-amylase (3.2.1.1)	"Oligo-1,6-glucosidase (3.2.1.10)"	Mannosyl-oligosaccharide glucosidase (3.2.1.106)	"Mannosyl-oligosaccharide 1,2-alpha-mannosidase (3.2.1.113)"	Maltose-6'-phosphate glucosidase (3.2.1.122)	"Xylan alpha-1,2-glucuronosidase (3.2.1.131)"	Chitosanase (3.2.1.132)	"Glucan 1,4-alpha-maltohydrolase (3.2.1.133)"	Neopullulanase (3.2.1.135)	"Glucuronoarabinoxylan endo-1,4-beta-xylanase (3.2.1.136)"	Alpha-glucuronidase (3.2.1.139)	Chitinase (3.2.1.14)	4-alpha-D-((1->4)-alpha-D-glucano)trehalose trehalohydrolase (3.2.1.141)	Thioglucosidase (3.2.1.147)	Polygalacturonase (3.2.1.15)	"Xyloglucan-specific endo-beta-1,4-glucanase (3.2.1.151)"	Mannosylglycoprotein endo-beta-mannosidase (3.2.1.152)	"Galactan endo-1,6-beta-galactosidase (3.2.1.164)"	Lysozyme (3.2.1.17)	Exo-alpha-sialidase (3.2.1.18)	Beta-amylase (3.2.1.2)	Alpha-glucosidase (3.2.1.20)	Beta-glucosidase (3.2.1.21)	Alpha-galactosidase (3.2.1.22)	Beta-galactosidase (3.2.1.23)	Alpha-mannosidase (3.2.1.24)	Beta-mannosidase (3.2.1.25)	Beta-fructofuranosidase (3.2.1.26)	"Alpha,alpha-trehalase (3.2.1.28)"	"Glucan 1,4-alpha-glucosidase (3.2.1.3)"	Beta-glucuronidase (3.2.1.31)	"Amylo-alpha-1,6-glucosidase (3.2.1.33)"	Hyaluronoglucosaminidase (3.2.1.35)	"Xylan 1,4-beta-xylosidase (3.2.1.37)"	"Glucan endo-1,3-beta-D-glucosidase (3.2.1.39)"	Cellulase (3.2.1.4)	Alpha-L-rhamnosidase (3.2.1.40)	Pullulanase (3.2.1.41)	Glucosylceramidase (3.2.1.45)	Galactosylceramidase (3.2.1.46)	Sucrose alpha-glucosidase (3.2.1.48)	Alpha-N-acetylgalactosaminidase (3.2.1.49)	Alpha-N-acetylglucosaminidase (3.2.1.50)	Alpha-L-fucosidase (3.2.1.51)	Beta-N-acetylhexosaminidase (3.2.1.52)	Cyclomaltodextrinase (3.2.1.54)	Non-reducing end alpha-L-arabinofuranosidase (3.2.1.55)	"Glucan 1,3-beta-glucosidase (3.2.1.58)"	"Endo-1,3(4)-beta-glucanase (3.2.1.6)"	"1,2-alpha-L-fucosidase (3.2.1.63)"	"2,6-beta-fructan 6-levanbiohydrolase (3.2.1.64)"	Levanase (3.2.1.65)	"Galacturan 1,4-alpha-galacturonidase (3.2.1.67)"	Isoamylase (3.2.1.68)	"Glucan 1,6-alpha-glucosidase (3.2.1.70)"	Licheninase (3.2.1.73)	"Glucan 1,4-beta-glucosidase (3.2.1.74)"	"Glucan endo-1,6-beta-glucosidase (3.2.1.75)"	"Mannan endo-1,4-beta-mannosidase (3.2.1.78)"	"Endo-1,4-beta-xylanase (3.2.1.8)"	Fructan beta-fructosidase (3.2.1.80)	Beta-agarase (3.2.1.81)	Exo-poly-alpha-galacturonosidase (3.2.1.82)	"Glucan 1,3-alpha-glucosidase (3.2.1.84)"	6-phospho-beta-galactosidase (3.2.1.85)	6-phospho-beta-glucosidase (3.2.1.86)	"Arabinogalactan endo-beta-1,4-galactanase (3.2.1.89)"	"Cellulose 1,4-beta-cellobiosidase (non-reducing end) (3.2.1.91)"	"Alpha,alpha-phosphotrehalase (3.2.1.93)"	"Glucan 1,6-alpha-isomaltosidase (3.2.1.94)"	"Dextran 1,6-alpha-isomaltotriosidase (3.2.1.95)"	Mannosyl-glycoprotein endo-beta-N-acetylglucosaminidase (3.2.1.96)	"Glucan 1,4-alpha-maltohexaosidase (3.2.1.98)"	"Arabinan endo-1,5-alpha-L-arabinosidase (3.2.1.99)"	Hydrolases :: Glycosylases :: Hydrolyzing N-glycosyl compounds (3.2.2.-)	Purine nucleosidase (3.2.2.1)	Methylthioadenosine nucleosidase (3.2.2.16)	DNA-3-methyladenine glycosylase I (3.2.2.20)	DNA-3-methyladenine glycosylase II (3.2.2.21)	rRNA N-glycosylase (3.2.2.22)	DNA-formamidopyrimidine glycosylase (3.2.2.23)	ADP-ribosyl-[dinitrogen reductase] hydrolase (3.2.2.24)	Uracil-DNA glycosylase (3.2.2.27)	Double-stranded uracil-DNA glycosylase (3.2.2.28)	Uridine nucleosidase (3.2.2.3)	AMP nucleosidase (3.2.2.4)	Ribosylpyrimidine nucleosidase (3.2.2.8)	Adenosylhomocysteine nucleosidase (3.2.2.9)	Adenosylhomocysteinase (3.3.1.1)	Hydrolases :: Acting on ether bonds :: Ether hydrolases (3.3.2.-)	Isochorismatase (3.3.2.1)	Soluble epoxide hydrolase (3.3.2.10)	Leukotriene-A(4) hydrolase (3.3.2.6)	Microsomal epoxide hydrolase (3.3.2.9)	Hydrolases :: Acting on peptide bonds (peptide hydrolases) (3.4.-.-)	Hydrolases :: Acting on peptide bonds (peptide hydrolases) :: Aminopeptidases (3.4.11.-)	Leucyl aminopeptidase (3.4.11.1)	Bacterial leucyl aminopeptidase (3.4.11.10)	Cytosol alanyl aminopeptidase (3.4.11.14)	Aminopeptidase Y (3.4.11.15)	Methionyl aminopeptidase (3.4.11.18)	D-stereospecific aminopeptidase (3.4.11.19)	Membrane alanyl aminopeptidase (3.4.11.2)	PepB aminopeptidase (3.4.11.23)	Aminopeptidase S (3.4.11.24)	Beta-peptidyl aminopeptidase (3.4.11.25)	Tripeptide aminopeptidase (3.4.11.4)	Prolyl aminopeptidase (3.4.11.5)	Aminopeptidase B (3.4.11.6)	Glutamyl aminopeptidase (3.4.11.7)	Xaa-Pro aminopeptidase (3.4.11.9)	Hydrolases :: Acting on peptide bonds (peptide hydrolases) :: Dipeptidases (3.4.13.-)	Cytosol nonspecific dipeptidase (3.4.13.18)	Membrane dipeptidase (3.4.13.19)	Beta-Ala-His dipeptidase (3.4.13.20)	Dipeptidase E (3.4.13.21)	D-Ala-D-Ala dipeptidase (3.4.13.22)	Transferred entry: 3.4.13.18 and 3.4.13.20 (3.4.13.3)	Xaa-Pro dipeptidase (3.4.13.9)	Hydrolases :: Acting on peptide bonds (peptide hydrolases) :: Dipeptidyl-peptidases and tripeptidyl-peptidases (3.4.14.-)	Dipeptidyl-peptidase I (3.4.14.1)	Xaa-Pro dipeptidyl-peptidase (3.4.14.11)	Xaa-Xaa-Pro tripeptidyl-peptidase (3.4.14.12)	Dipeptidyl-peptidase II (3.4.14.2)	Dipeptidyl-peptidase III (3.4.14.4)	Dipeptidyl-peptidase IV (3.4.14.5)	Hydrolases :: Acting on peptide bonds (peptide hydrolases) :: Peptidyl-dipeptidases (3.4.15.-)	Peptidyl-dipeptidase A (3.4.15.1)	Peptidyl-dipeptidase Dcp (3.4.15.5)	Cyanophycinase (3.4.15.6)	Hydrolases :: Acting on peptide bonds (peptide hydrolases) :: Serine-type carboxypeptidases (3.4.16.-)	Serine-type D-Ala-D-Ala carboxypeptidase (3.4.16.4)	Carboxypeptidase C (3.4.16.5)	Carboxypeptidase D (3.4.16.6)	Hydrolases :: Acting on peptide bonds (peptide hydrolases) :: Metallocarboxypeptidases (3.4.17.-)	Carboxypeptidase A (3.4.17.1)	Glutamate carboxypeptidase (3.4.17.11)	Muramoyltetrapeptide carboxypeptidase (3.4.17.13)	Carboxypeptidase T (3.4.17.18)	Carboxypeptidase Taq (3.4.17.19)	Carboxypeptidase B (3.4.17.2)	Glutamate carboxypeptidase II (3.4.17.21)	Muramoylpentapeptide carboxypeptidase (3.4.17.8)	Hydrolases :: Acting on peptide bonds (peptide hydrolases) :: Omega peptidases (3.4.19.-)	Acylaminoacyl-peptidase (3.4.19.1)	Ubiquitinyl hydrolase 1 (3.4.19.12)	Glutathione hydrolase (3.4.19.13)	Pyroglutamyl-peptidase I (3.4.19.3)	Beta-aspartyl-peptidase (3.4.19.5)	Hydrolases :: Acting on peptide bonds (peptide hydrolases) :: Serine endopeptidases (3.4.21.-)	Chymotrypsin (3.4.21.1)	Sedolisin (3.4.21.100)	Xanthomonalisin (3.4.21.101)	C-terminal processing peptidase (3.4.21.102)	Rhomboid protease (3.4.21.105)	Peptidase Do (3.4.21.107)	HtrA2 peptidase (3.4.21.108)	Aqualysin 1 (3.4.21.111)	Alpha-lytic endopeptidase (3.4.21.12)	Prolyl oligopeptidase (3.4.21.26)	Trypsin (3.4.21.4)	Classical-complement-pathway C3/C5 convertase (3.4.21.43)	Endopeptidase La (3.4.21.53)	Kexin (3.4.21.61)	Subtilisin (3.4.21.62)	Oryzin (3.4.21.63)	Thermitase (3.4.21.66)	Protein C (activated) (3.4.21.69)	Plasmin (3.4.21.7)	IgA-specific serine endopeptidase (3.4.21.72)	Furin (3.4.21.75)	Streptogrisin B (3.4.21.81)	Oligopeptidase B (3.4.21.83)	Limulus clotting factor C (3.4.21.84)	Repressor LexA (3.4.21.88)	Signal peptidase I (3.4.21.89)	Endopeptidase Clp (3.4.21.92)	Hydrolases :: Acting on peptide bonds (peptide hydrolases) :: Cysteine endopeptidases (3.4.22.-)	Bleomycin hydrolase (3.4.22.40)	Calpain-1 (3.4.22.52)	Hydrolases :: Acting on peptide bonds (peptide hydrolases) :: Aspartic endopeptidases (3.4.23.-)	Acrocylindropepsin (3.4.23.28)	Signal peptidase II (3.4.23.36)	Prepilin peptidase (3.4.23.43)	Plasminogen activator Pla (3.4.23.48)	Omptin (3.4.23.49)	Hydrolases :: Acting on peptide bonds (peptide hydrolases) :: Metalloendopeptidases (3.4.24.-)	Neprilysin (3.4.24.11)	IgA-specific metalloendopeptidase (3.4.24.13)	Thimet oligopeptidase (3.4.24.15)	Procollagen C-endopeptidase (3.4.24.19)	Peptidyl-Lys metalloendopeptidase (3.4.24.20)	Vibriolysin (3.4.24.25)	Thermolysin (3.4.24.27)	Bacillolysin (3.4.24.28)	Aureolysin (3.4.24.29)	Microbial collagenase (3.4.24.3)	Peptidyl-Asp metalloendopeptidase (3.4.24.33)	Deuterolysin (3.4.24.39)	Serralysin (3.4.24.40)	Trimerelysin I (3.4.24.52)	Pitrilysin (3.4.24.55)	Insulysin (3.4.24.56)	O-sialoglycoprotein endopeptidase (3.4.24.57)	Mitochondrial processing peptidase (3.4.24.64)	Oligopeptidase A (3.4.24.70)	Endothelin-converting enzyme 1 (3.4.24.71)	Lysostaphin (3.4.24.75)	GPR endopeptidase (3.4.24.78)	Ste24 endopeptidase (3.4.24.84)	Hydrolases :: Acting on peptide bonds (peptide hydrolases) :: Threonine endopeptidases (3.4.25.-)	Proteasome endopeptidase complex (3.4.25.1)	HslU--HslV peptidase (3.4.25.2)	Hydrolases :: Acting on peptide bonds (peptide hydrolases) :: Endopeptidases of unknown catalytic mechanism (3.4.99.-)	"Hydrolases :: Acting on carbon-nitrogen bonds, other than peptide bonds (3.5.-.-)"	"Hydrolases :: Acting on carbon-nitrogen bonds, other than peptide bonds :: In linear amides (3.5.1.-)"	Asparaginase (3.5.1.1)	Formyltetrahydrofolate deformylase (3.5.1.10)	(R)-amidase (3.5.1.100)	L-proline amide hydrolase (3.5.1.101)	deacetylase (3.5.1.103)	UDP-3-O-acyl-N-acetylglucosamine deacetylase (3.5.1.108)	Penicillin amidase (3.5.1.11)	Peroxyureidoacrylate/ureidoacrylate amidohydrolase (3.5.1.110)	Mycothiol S-conjugate amidase (3.5.1.115)	N-acyl-aliphatic-L-amino acid amidohydrolase (3.5.1.14)	Acetylornithine deacetylase (3.5.1.16)	Succinyl-diaminopimelate desuccinylase (3.5.1.18)	Nicotinamidase (3.5.1.19)	Glutaminase (3.5.1.2)	Ceramidase (3.5.1.23)	Choloylglycine hydrolase (3.5.1.24)	N-acetylglucosamine-6-phosphate deacetylase (3.5.1.25)	N(4)-(beta-N-acetylglucosaminyl)-L-asparaginase (3.5.1.26)	N-acetylmuramoyl-L-alanine amidase (3.5.1.28)	5-aminopentanamidase (3.5.1.30)	Hippurate hydrolase (3.5.1.32)	Glutamin-(asparagin-)ase (3.5.1.38)	Amidase (3.5.1.4)	Chitin deacetylase (3.5.1.41)	Protein-glutamine glutaminase (3.5.1.44)	6-aminohexanoate-dimer hydrolase (3.5.1.46)	N-acetyldiaminopimelate deacetylase (3.5.1.47)	Acetylspermidine deacetylase (3.5.1.48)	Formamidase (3.5.1.49)	Urease (3.5.1.5)	N-carbamoylputrescine amidase (3.5.1.53)	Allophanate hydrolase (3.5.1.54)	"N,N-dimethylformamidase (3.5.1.56)"	N-carbamoylsarcosine amidase (3.5.1.59)	Beta-ureidopropionase (3.5.1.6)	Mimosinase (3.5.1.61)	N-formylglutamate deformylase (3.5.1.68)	N-carbamoyl-D-amino-acid hydrolase (3.5.1.77)	Glutathionylspermidine amidase (3.5.1.78)	N-acyl-D-amino-acid deacylase (3.5.1.81)	N-acyl-D-glutamate deacylase (3.5.1.82)	N-acyl-D-aspartate deacylase (3.5.1.83)	N-carbamoyl-L-amino-acid hydrolase (3.5.1.87)	Peptide deformylase (3.5.1.88)	Arylformamidase (3.5.1.9)	N-substituted formamide deformylase (3.5.1.91)	Glutaryl-7-aminocephalosporanic-acid acylase (3.5.1.93)	Gamma-glutamyl-gamma-aminobutyrate hydrolase (3.5.1.94)	Succinylglutamate desuccinylase (3.5.1.96)	Acyl-homoserine-lactone acylase (3.5.1.97)	Histone deacetylase (3.5.1.98)	4-deoxy-4-formamido-L-arabinose-phosphoundecaprenol deformylase (3.5.1.n3)	"Hydrolases :: Acting on carbon-nitrogen bonds, other than peptide bonds :: In cyclic amides (3.5.2.-)"	Barbiturase (3.5.2.1)	Creatininase (3.5.2.10)	6-aminohexanoate-cyclic-dimer hydrolase (3.5.2.12)	N-methylhydantoinase (ATP-hydrolyzing) (3.5.2.14)	Cyanuric acid amidohydrolase (3.5.2.15)	Hydroxyisourate hydrolase (3.5.2.17)	Enamidase (3.5.2.18)	Dihydropyrimidinase (3.5.2.2)	Dihydroorotase (3.5.2.3)	Allantoinase (3.5.2.5)	Beta-lactamase (3.5.2.6)	Imidazolonepropionase (3.5.2.7)	5-oxoprolinase (ATP-hydrolyzing) (3.5.2.9)	"Hydrolases :: Acting on carbon-nitrogen bonds, other than peptide bonds :: In linear amidines (3.5.3.-)"	Arginase (3.5.3.1)	Agmatinase (3.5.3.11)	Agmatine deiminase (3.5.3.12)	Formimidoylglutamate deiminase (3.5.3.13)	Dimethylargininase (3.5.3.18)	Transferred entry: 3.5.1.116 (3.5.3.19)	N-succinylarginine dihydrolase (3.5.3.23)	Creatinase (3.5.3.3)	Allantoicase (3.5.3.4)	Arginine deiminase (3.5.3.6)	Guanidinobutyrase (3.5.3.7)	Formimidoylglutamase (3.5.3.8)	Allantoate deiminase (3.5.3.9)	"Hydrolases :: Acting on carbon-nitrogen bonds, other than peptide bonds :: In cyclic amidines (3.5.4.-)"	Cytosine deaminase (3.5.4.1)	IMP cyclohydrolase (3.5.4.10)	Pterin deaminase (3.5.4.11)	dCMP deaminase (3.5.4.12)	dCTP deaminase (3.5.4.13)	GTP cyclohydrolase I (3.5.4.16)	Phosphoribosyl-AMP cyclohydrolase (3.5.4.19)	Adenine deaminase (3.5.4.2)	Creatinine deaminase (3.5.4.21)	1-pyrroline-4-hydroxy-2-carboxylate deaminase (3.5.4.22)	Blasticidin-S deaminase (3.5.4.23)	GTP cyclohydrolase II (3.5.4.25)	Diaminohydroxyphosphoribosylaminopyrimidine deaminase (3.5.4.26)	Methenyltetrahydromethanopterin cyclohydrolase (3.5.4.27)	S-adenosylhomocysteine deaminase (3.5.4.28)	GTP cyclohydrolase IIa (3.5.4.29)	Guanine deaminase (3.5.4.3)	S-methyl-5'-thioadenosine deaminase (3.5.4.31)	tRNA(adenine(34)) deaminase (3.5.4.33)	Adenosine deaminase (3.5.4.4)	Cytidine deaminase (3.5.4.5)	AMP deaminase (3.5.4.6)	Methenyltetrahydrofolate cyclohydrolase (3.5.4.9)	"Hydrolases :: Acting on carbon-nitrogen bonds, other than peptide bonds :: In nitriles (3.5.5.-)"	Nitrilase (3.5.5.1)	Cyanoalanine nitrilase (3.5.5.4)	Aliphatic nitrilase (3.5.5.7)	Thiocyanate hydrolase (3.5.5.8)	Aminopyrimidine aminohydrolase (3.5.99.2)	Hydroxydechloroatrazine ethylaminohydrolase (3.5.99.3)	N-isopropylammelide isopropylaminohydrolase (3.5.99.4)	Glucosamine-6-phosphate deaminase (3.5.99.6)	1-aminocyclopropane-1-carboxylate deaminase (3.5.99.7)	Hydrolases :: Acting on acid anhydrides (3.6.-.-)	Hydrolases :: Acting on acid anhydrides :: In phosphorous-containing anhydrides (3.6.1.-)	Inorganic diphosphatase (3.6.1.1)	Endopolyphosphatase (3.6.1.10)	Exopolyphosphatase (3.6.1.11)	ADP-ribose diphosphatase (3.6.1.13)	Adenosine-tetraphosphatase (3.6.1.14)	Nucleoside-triphosphate phosphatase (3.6.1.15)	Bis(5'-nucleosyl)-tetraphosphatase (asymmetrical) (3.6.1.17)	Nucleoside-triphosphate diphosphatase (3.6.1.19)	NAD(+) diphosphatase (3.6.1.22)	dUTP diphosphatase (3.6.1.23)	Nucleoside phosphoacylhydrolase (3.6.1.24)	CDP-diacylglycerol diphosphatase (3.6.1.26)	Undecaprenyl-diphosphate phosphatase (3.6.1.27)	Adenosinetriphosphatase (3.6.1.3)	Phosphoribosyl-ATP diphosphatase (3.6.1.31)	Transferred entry: 3.6.3.14 (3.6.1.34)	"Guanosine-5'-triphosphate,3'-diphosphate diphosphatase (3.6.1.40)"	Bis(5'-nucleosyl)-tetraphosphatase (symmetrical) (3.6.1.41)	UDP-sugar diphosphatase (3.6.1.45)	"UDP-2,3-diacylglucosamine diphosphatase (3.6.1.54)"	Acylphosphatase (3.6.1.7)	ATP diphosphatase (3.6.1.8)	Nucleotide diphosphatase (3.6.1.9)	Hydrolases :: Acting on acid anhydrides :: Acting on acid anhydrides; catalyzing transmembrane movement of substances (3.6.3.-)	Phospholipid-translocating ATPase (3.6.3.1)	Hydrogen/potassium-exchanging ATPase (3.6.3.10)	Potassium-transporting ATPase (3.6.3.12)	H(+)-transporting two-sector ATPase (3.6.3.14)	Sodium-transporting two-sector ATPase (3.6.3.15)	Arsenite-transporting ATPase (3.6.3.16)	Monosaccharide-transporting ATPase (3.6.3.17)	Maltose-transporting ATPase (3.6.3.19)	Magnesium-importing ATPase (3.6.3.2)	Glycerol-3-phosphate-transporting ATPase (3.6.3.20)	Polar-amino-acid-transporting ATPase (3.6.3.21)	Nonpolar-amino-acid-transporting ATPase (3.6.3.22)	Oligopeptide-transporting ATPase (3.6.3.23)	Nickel-transporting ATPase (3.6.3.24)	Sulfate-transporting ATPase (3.6.3.25)	Nitrate-transporting ATPase (3.6.3.26)	Phosphate-transporting ATPase (3.6.3.27)	Phosphonate-transporting ATPase (3.6.3.28)	Molybdate-transporting ATPase (3.6.3.29)	Cadmium-exporting ATPase (3.6.3.3)	Fe(3+)-transporting ATPase (3.6.3.30)	Polyamine-transporting ATPase (3.6.3.31)	Quaternary-amine-transporting ATPase (3.6.3.32)	Vitamin B12-transporting ATPase (3.6.3.33)	Iron-chelate-transporting ATPase (3.6.3.34)	Taurine-transporting ATPase (3.6.3.36)	Capsular-polysaccharide-transporting ATPase (3.6.3.38)	Cu(2+)-exporting ATPase (3.6.3.4)	Teichoic-acid-transporting ATPase (3.6.3.40)	Heme-transporting ATPase (3.6.3.41)	Beta-glucan-transporting ATPase (3.6.3.42)	Peptide-transporting ATPase (3.6.3.43)	Xenobiotic-transporting ATPase (3.6.3.44)	Channel-conductance-controlling ATPase (3.6.3.49)	Zinc-exporting ATPase (3.6.3.5)	Ag(+)-exporting ATPase (3.6.3.53)	Proton-exporting ATPase (3.6.3.6)	Calcium-transporting ATPase (3.6.3.8)	Sodium/potassium-exchanging ATPase (3.6.3.9)	Transferred entry: 3.6.3.54 (3.6.3.n1)	Hydrolases :: Acting on acid anhydrides :: Acting on acid anhydrides; involved in cellular and subcellular movement (3.6.4.-)	Myosin ATPase (3.6.4.1)	DNA helicase (3.6.4.12)	RNA helicase (3.6.4.13)	Microtubule-severing ATPase (3.6.4.3)	Plus-end-directed kinesin ATPase (3.6.4.4)	Vesicle-fusing ATPase (3.6.4.6)	Proteasome ATPase (3.6.4.8)	Hydrolases :: Acting on acid anhydrides :: Acting on GTP; involved in cellular and subcellular movement (3.6.5.-)	Protein-synthesizing GTPase (3.6.5.3)	Signal-recognition-particle GTPase (3.6.5.4)	Dynamin GTPase (3.6.5.5)	Elongation factor 4 (3.6.5.n1)	Hydrolases :: Acting on carbon-carbon bonds :: In ketonic substances (3.7.1.-)	Fumarylacetoacetase (3.7.1.2)	"3D-(3,5/4)-trihydroxycyclohexane-1,2-dione acylhydrolase (decyclizing) (3.7.1.22)"	Kynureninase (3.7.1.3)	Acylpyruvate hydrolase (3.7.1.5)	"2,6-dioxo-6-phenylhexa-3-enoate hydrolase (3.7.1.8)"	Transferred entry: 3.7.1.22 (3.7.1.n2)	Hydrolases :: Acting on halide bonds :: In C-halide compounds (3.8.1.-)	(S)-2-haloacid dehalogenase (3.8.1.2)	Haloacetate dehalogenase (3.8.1.3)	Haloalkane dehalogenase (3.8.1.5)	Atrazine chlorohydrolase (3.8.1.8)	Lyases (4.-.-.-)	Lyases :: Carbon-carbon lyases (4.1.-.-)	Lyases :: Carbon-carbon lyases :: Carboxy-lyases (4.1.1.-)	Pyruvate decarboxylase (4.1.1.1)	Aspartate 1-decarboxylase (4.1.1.11)	Aspartate 4-decarboxylase (4.1.1.12)	Glutamate decarboxylase (4.1.1.15)	Ornithine decarboxylase (4.1.1.17)	Lysine decarboxylase (4.1.1.18)	Arginine decarboxylase (4.1.1.19)	Oxalate decarboxylase (4.1.1.2)	Diaminopimelate decarboxylase (4.1.1.20)	Phosphoribosylaminoimidazole carboxylase (4.1.1.21)	Histidine decarboxylase (4.1.1.22)	Orotidine-5'-phosphate decarboxylase (4.1.1.23)	Tyrosine decarboxylase (4.1.1.25)	Aromatic-L-amino-acid decarboxylase (4.1.1.28)	Oxaloacetate decarboxylase (4.1.1.3)	Phosphoenolpyruvate carboxylase (4.1.1.31)	Phosphoenolpyruvate carboxykinase (GTP) (4.1.1.32)	Diphosphomevalonate decarboxylase (4.1.1.33)	UDP-glucuronate decarboxylase (4.1.1.35)	Phosphopantothenoylcysteine decarboxylase (4.1.1.36)	Uroporphyrinogen decarboxylase (4.1.1.37)	Ribulose-bisphosphate carboxylase (4.1.1.39)	Acetoacetate decarboxylase (4.1.1.4)	Methylmalonyl-CoA decarboxylase (4.1.1.41)	4-carboxymuconolactone decarboxylase (4.1.1.44)	Aminocarboxymuconate-semialdehyde decarboxylase (4.1.1.45)	o-pyrocatechuate decarboxylase (4.1.1.46)	Tartronate-semialdehyde synthase (4.1.1.47)	Indole-3-glycerol-phosphate synthase (4.1.1.48)	Phosphoenolpyruvate carboxykinase (ATP) (4.1.1.49)	Acetolactate decarboxylase (4.1.1.5)	Adenosylmethionine decarboxylase (4.1.1.50)	"4,5-dihydroxyphthalate decarboxylase (4.1.1.55)"	Protocatechuate decarboxylase (4.1.1.63)	"2,2-dialkylglycine decarboxylase (pyruvate) (4.1.1.64)"	Phosphatidylserine decarboxylase (4.1.1.65)	"5-oxopent-3-ene-1,2,5-tricarboxylate decarboxylase (4.1.1.68)"	"3,4-dihydroxyphthalate decarboxylase (4.1.1.69)"	Benzoylformate decarboxylase (4.1.1.7)	Glutaconyl-CoA decarboxylase (4.1.1.70)	2-oxoglutarate decarboxylase (4.1.1.71)	Tartrate decarboxylase (4.1.1.73)	Indolepyruvate decarboxylase (4.1.1.74)	5-guanidino-2-oxopentanoate decarboxylase (4.1.1.75)	Arylmalonate decarboxylase (4.1.1.76)	2-oxo-3-hexenedioate decarboxylase (4.1.1.77)	Oxalyl-CoA decarboxylase (4.1.1.8)	Threonine-phosphate decarboxylase (4.1.1.81)	Phosphonopyruvate decarboxylase (4.1.1.82)	3-dehydro-L-gulonate-6-phosphate decarboxylase (4.1.1.85)	Diaminobutyrate decarboxylase (4.1.1.86)	Malonyl-CoA decarboxylase (4.1.1.9)	Carboxynorspermidine decarboxylase (4.1.1.96)	Transferred entry: 4.1.1.97 (4.1.1.n1)	Lyases :: Carbon-carbon lyases :: Aldehyde-lyases (4.1.2.-)	Fructose-bisphosphate aldolase (4.1.2.13)	2-dehydro-3-deoxy-phosphogluconate aldolase (4.1.2.14)	L-fuculose-phosphate aldolase (4.1.2.17)	Rhamnulose-1-phosphate aldolase (4.1.2.19)	Ketotetrose-phosphate aldolase (4.1.2.2)	2-dehydro-3-deoxyglucarate aldolase (4.1.2.20)	2-dehydro-3-deoxy-6-phosphogalactonate aldolase (4.1.2.21)	Fructose-6-phosphate phosphoketolase (4.1.2.22)	Dihydroneopterin aldolase (4.1.2.25)	5-dehydro-2-deoxyphosphogluconate aldolase (4.1.2.29)	Benzoin aldolase (4.1.2.38)	Deoxyribose-phosphate aldolase (4.1.2.4)	Tagatose-bisphosphate aldolase (4.1.2.40)	3-hexulose-6-phosphate synthase (4.1.2.43)	Benzoyl-CoA-dihydrodiol lyase (4.1.2.44)	Low-specificity L-threonine aldolase (4.1.2.48)	L-allo-threonine aldolase (4.1.2.49)	L-threonine aldolase (4.1.2.5)	4-hydroxy-2-oxoheptanedioate aldolase (4.1.2.52)	Phosphoketolase (4.1.2.9)	Lyases :: Carbon-carbon lyases :: Oxo-acid-lyases (4.1.3.-)	Isocitrate lyase (4.1.3.1)	Transferred entry: 2.3.3.13 (4.1.3.12)	4-hydroxy-2-oxoglutarate aldolase (4.1.3.16)	Malyl-CoA lyase (4.1.3.24)	Anthranilate synthase (4.1.3.27)	N-acetylneuraminate lyase (4.1.3.3)	Methylisocitrate lyase (4.1.3.30)	"2,3-dimethylmalate lyase (4.1.3.32)"	Citryl-CoA lyase (4.1.3.34)	"1,4-dihydroxy-2-naphthoyl-CoA synthase (4.1.3.36)"	Aminodeoxychorismate lyase (4.1.3.38)	4-hydroxy-2-oxovalerate aldolase (4.1.3.39)	Hydroxymethylglutaryl-CoA lyase (4.1.3.4)	Chorismate lyase (4.1.3.40)	Citrate (pro-3S)-lyase (4.1.3.6)	Lyases :: Carbon-carbon lyases :: Other carbon-carbon lyases (4.1.99.-)	Tryptophanase (4.1.99.1)	"3,4-dihydroxy-2-butanone-4-phosphate synthase (4.1.99.12)"	Phosphomethylpyrimidine synthase (4.1.99.17)	Cyclic pyranopterin phosphate synthase (4.1.99.18)	2-iminoacetate synthase (4.1.99.19)	Tyrosine phenol-lyase (4.1.99.2)	Deoxyribodipyrimidine photo-lyase (4.1.99.3)	Lyases :: Carbon-oxygen lyases (4.2.-.-)	Lyases :: Carbon-oxygen lyases :: Hydro-lyases (4.2.1.-)	Carbonate dehydratase (4.2.1.1)	3-dehydroquinate dehydratase (4.2.1.10)	Cyclohexyl-isocyanide hydratase (4.2.1.103)	Cyanase (4.2.1.104)	hydratase (4.2.1.107)	Methylthioribulose 1-phosphate dehydratase (4.2.1.109)	Phosphopyruvate hydratase (4.2.1.11)	o-succinylbenzoate synthase (4.2.1.113)	3-hydroxypropionyl-CoA dehydratase (4.2.1.116)	3-dehydroshikimate dehydratase (4.2.1.118)	Enoyl-CoA hydratase 2 (4.2.1.119)	Phosphogluconate dehydratase (4.2.1.12)	4-hydroxybutanoyl-CoA dehydratase (4.2.1.120)	N-acetylmuramic acid 6-phosphate etherase (4.2.1.126)	"UDP-N-acetylglucosamine 4,6-dehydratase (configuration-retaining) (4.2.1.135)"	ADP-dependent NAD(P)H-hydrate dehydratase (4.2.1.136)	Crotonobetainyl-CoA hydratase (4.2.1.149)	Enoyl-CoA hydratase (4.2.1.17)	Methylglutaconyl-CoA hydratase (4.2.1.18)	Imidazoleglycerol-phosphate dehydratase (4.2.1.19)	Fumarate hydratase (4.2.1.2)	Tryptophan synthase (4.2.1.20)	Cystathionine beta-synthase (4.2.1.22)	Porphobilinogen synthase (4.2.1.24)	L-arabinonate dehydratase (4.2.1.25)	Propanediol dehydratase (4.2.1.28)	Aconitate hydratase (4.2.1.3)	Glycerol dehydratase (4.2.1.30)	L(+)-tartrate dehydratase (4.2.1.32)	3-isopropylmalate dehydratase (4.2.1.33)	Homoaconitate hydratase (4.2.1.36)	Gluconate dehydratase (4.2.1.39)	Glucarate dehydratase (4.2.1.40)	5-dehydro-4-deoxyglucarate dehydratase (4.2.1.41)	Galactarate dehydratase (4.2.1.42)	2-dehydro-3-deoxy-L-arabinonate dehydratase (4.2.1.43)	Myo-inosose-2 dehydratase (4.2.1.44)	"CDP-glucose 4,6-dehydratase (4.2.1.45)"	"dTDP-glucose 4,6-dehydratase (4.2.1.46)"	"GDP-mannose 4,6-dehydratase (4.2.1.47)"	Urocanate hydratase (4.2.1.49)	Prephenate dehydratase (4.2.1.51)	Transferred entry: 4.3.3.7 (4.2.1.52)	Oleate hydratase (4.2.1.53)	3-hydroxybutyryl-CoA dehydratase (4.2.1.55)	3-hydroxyacyl-[acyl-carrier-protein] dehydratase (4.2.1.59)	Galactonate dehydratase (4.2.1.6)	Transferred entry: 4.2.1.59 (4.2.1.60)	Transferred entry: 4.2.1.59 (4.2.1.61)	Cyanide hydratase (4.2.1.66)	L-fuconate dehydratase (4.2.1.68)	Cyanamide hydratase (4.2.1.69)	Altronate dehydratase (4.2.1.7)	Pseudouridylate synthase (4.2.1.70)	Uroporphyrinogen-III synthase (4.2.1.75)	2-methylcitrate dehydratase (4.2.1.79)	Mannonate dehydratase (4.2.1.8)	2-oxopent-4-enoate hydratase (4.2.1.80)	Xylonate dehydratase (4.2.1.82)	4-oxalmesaconate hydratase (4.2.1.83)	Nitrile hydratase (4.2.1.84)	Dimethylmaleate hydratase (4.2.1.85)	Transferred entry: 2.8.3.21 and 4.2.1.149 (4.2.1.89)	Dihydroxy-acid dehydratase (4.2.1.9)	L-rhamnonate dehydratase (4.2.1.90)	Arogenate dehydratase (4.2.1.91)	4a-hydroxytetrahydrobiopterin dehydratase (4.2.1.96)	2-methylisocitrate dehydratase (4.2.1.99)	Lyases :: Carbon-oxygen lyases :: Acting on polysaccharides (4.2.2.-)	Hyaluronate lyase (4.2.2.1)	Pectin lyase (4.2.2.10)	Inulin fructotransferase (DFA-I-forming) (4.2.2.17)	Pectate lyase (4.2.2.2)	Poly(beta-D-mannuronate) lyase (4.2.2.3)	Chondroitin AC lyase (4.2.2.5)	Oligogalacturonide lyase (4.2.2.6)	Pectate disaccharide-lyase (4.2.2.9)	Peptidoglycan lytic exotransglycosylase (4.2.2.n1)	Peptidoglycan lytic endotransglycosylase (4.2.2.n2)	Lyases :: Carbon-oxygen lyases :: Acting on phosphates (4.2.3.-)	Threonine synthase (4.2.3.1)	6-pyruvoyltetrahydropterin synthase (4.2.3.12)	Methylglyoxal synthase (4.2.3.3)	3-dehydroquinate synthase (4.2.3.4)	Chorismate synthase (4.2.3.5)	Lyases :: Carbon-oxygen lyases :: Other carbon-oxygen lyases (4.2.99.-)	DNA-(apurinic or apyrimidinic site) lyase (4.2.99.18)	"2-succinyl-6-hydroxy-2,4-cyclohexadiene-1-carboxylate synthase (4.2.99.20)"	Lyases :: Carbon-nitrogen lyases (4.3.-.-)	Lyases :: Carbon-nitrogen lyases :: Ammonia-lyases (4.3.1.-)	Aspartate ammonia-lyase (4.3.1.1)	Ornithine cyclodeaminase (4.3.1.12)	3-aminobutyryl-CoA ammonia-lyase (4.3.1.14)	Diaminopropionate ammonia-lyase (4.3.1.15)	Threo-3-hydroxy-L-aspartate ammonia-lyase (4.3.1.16)	L-serine ammonia-lyase (4.3.1.17)	D-serine ammonia-lyase (4.3.1.18)	Threonine ammonia-lyase (4.3.1.19)	Methylaspartate ammonia-lyase (4.3.1.2)	Phenylalanine ammonia-lyase (4.3.1.24)	Histidine ammonia-lyase (4.3.1.3)	Formimidoyltetrahydrofolate cyclodeaminase (4.3.1.4)	Ethanolamine ammonia-lyase (4.3.1.7)	Argininosuccinate lyase (4.3.2.1)	Adenylosuccinate lyase (4.3.2.2)	Ureidoglycolate lyase (4.3.2.3)	Strictosidine synthase (4.3.3.2)	4-hydroxy-tetrahydrodipicolinate synthase (4.3.3.7)	Lyases :: Carbon-nitrogen lyases :: Other carbon-nitrogen lyases (4.3.99.-)	7-carboxy-7-deazaguanine synthase (4.3.99.3)	Lyases :: Carbon-sulfur lyases (4.4.-.-)	Lyases :: Carbon-sulfur lyases :: Carbon-sulfur lyases (4.4.1.-)	Cystathionine gamma-lyase (4.4.1.1)	Methionine gamma-lyase (4.4.1.11)	Cysteine-S-conjugate beta-lyase (4.4.1.13)	1-aminocyclopropane-1-carboxylate synthase (4.4.1.14)	D-cysteine desulfhydrase (4.4.1.15)	Selenocysteine lyase (4.4.1.16)	Holocytochrome-c synthase (4.4.1.17)	Phosphosulfolactate synthase (4.4.1.19)	S-ribosylhomocysteine lyase (4.4.1.21)	S-(hydroxymethyl)glutathione synthase (4.4.1.22)	2-hydroxypropyl-CoM lyase (4.4.1.23)	Lactoylglutathione lyase (4.4.1.5)	Cystathionine beta-lyase (4.4.1.8)	Lyases :: Phosphorus-oxygen lyases (4.6.-.-)	Adenylate cyclase (4.6.1.1)	"2-C-methyl-D-erythritol 2,4-cyclodiphosphate synthase (4.6.1.12)"	Guanylate cyclase (4.6.1.2)	Ferrochelatase (4.99.1.1)	Alkylmercury lyase (4.99.1.2)	Sirohydrochlorin cobaltochelatase (4.99.1.3)	Sirohydrochlorin ferrochelatase (4.99.1.4)	Isomerases (5.-.-.-)	Isomerases :: Racemases and epimerases (5.1.-.-)	Isomerases :: Racemases and epimerases :: Acting on amino acids and derivatives (5.1.1.-)	Alanine racemase (5.1.1.1)	Phenylalanine racemase (ATP-hydrolyzing) (5.1.1.11)	Ornithine racemase (5.1.1.12)	Aspartate racemase (5.1.1.13)	Isopenicillin-N epimerase (5.1.1.17)	Glutamate racemase (5.1.1.3)	Proline racemase (5.1.1.4)	Diaminopimelate epimerase (5.1.1.7)	4-hydroxyproline epimerase (5.1.1.8)	Isomerases :: Racemases and epimerases :: Acting on hydroxy acids and derivatives (5.1.2.-)	Mandelate racemase (5.1.2.2)	3-hydroxybutyryl-CoA epimerase (5.1.2.3)	Isomerases :: Racemases and epimerases :: Acting on carbohydrates and derivatives (5.1.3.-)	Ribulose-phosphate 3-epimerase (5.1.3.1)	CDP-paratose 2-epimerase (5.1.3.10)	Cellobiose epimerase (5.1.3.11)	UDP-glucuronate 5'-epimerase (5.1.3.12)	"dTDP-4-dehydrorhamnose 3,5-epimerase (5.1.3.13)"	UDP-N-acetylglucosamine 2-epimerase (non-hydrolyzing) (5.1.3.14)	Glucose-6-phosphate 1-epimerase (5.1.3.15)	"GDP-mannose 3,5-epimerase (5.1.3.18)"	UDP-glucose 4-epimerase (5.1.3.2)	ADP-glyceromanno-heptose 6-epimerase (5.1.3.20)	Maltose epimerase (5.1.3.21)	L-ribulose-5-phosphate 3-epimerase (5.1.3.22)	"UDP-2,3-diacetamido-2,3-dideoxyglucuronic acid 2-epimerase (5.1.3.23)"	Aldose 1-epimerase (5.1.3.3)	L-ribulose-5-phosphate 4-epimerase (5.1.3.4)	UDP-glucuronate 4-epimerase (5.1.3.6)	UDP-N-acetylglucosamine 4-epimerase (5.1.3.7)	N-acylglucosamine 2-epimerase (5.1.3.8)	N-acylglucosamine-6-phosphate 2-epimerase (5.1.3.9)	L-rhamnose mutarotase (5.1.3.n3)	Isomerases :: Racemases and epimerases :: Acting on other compounds (5.1.99.-)	Methylmalonyl-CoA epimerase (5.1.99.1)	Alpha-methylacyl-CoA racemase (5.1.99.4)	Hydantoin racemase (5.1.99.5)	NAD(P)H-hydrate epimerase (5.1.99.6)	Isomerases :: Cis-trans-isomerases (5.2.-.-)	Maleate isomerase (5.2.1.1)	Maleylacetoacetate isomerase (5.2.1.2)	Maleylpyruvate isomerase (5.2.1.4)	Linoleate isomerase (5.2.1.5)	Peptidylprolyl isomerase (5.2.1.8)	"Isomerases :: Intramolecular oxidoreductases :: Interconverting aldoses and ketoses, and related compounds (5.3.1.-)"	Triose-phosphate isomerase (5.3.1.1)	Glucuronate isomerase (5.3.1.12)	Arabinose-5-phosphate isomerase (5.3.1.13)	L-rhamnose isomerase (5.3.1.14)	D-lyxose ketol-isomerase (5.3.1.15)	isomerase (5.3.1.16)	5-dehydro-4-deoxy-D-glucuronate isomerase (5.3.1.17)	Hydroxypyruvate isomerase (5.3.1.22)	S-methyl-5-thioribose-1-phosphate isomerase (5.3.1.23)	Phosphoribosylanthranilate isomerase (5.3.1.24)	L-fucose isomerase (5.3.1.25)	Galactose-6-phosphate isomerase (5.3.1.26)	6-phospho-3-hexuloisomerase (5.3.1.27)	D-sedoheptulose 7-phosphate isomerase (5.3.1.28)	"Ribose 1,5-bisphosphate isomerase (5.3.1.29)"	5-deoxy-glucuronate isomerase (5.3.1.30)	L-arabinose isomerase (5.3.1.4)	Xylose isomerase (5.3.1.5)	Ribose-5-phosphate isomerase (5.3.1.6)	Mannose-6-phosphate isomerase (5.3.1.8)	Glucose-6-phosphate isomerase (5.3.1.9)	Transferred entry: 5.3.1.30 (5.3.1.n1)	Isomerases :: Intramolecular oxidoreductases :: Interconverting keto- and enol- groups (5.3.2.-)	Phenylpyruvate tautomerase (5.3.2.1)	"2,3-diketo-5-methylthiopentyl-1-phosphate enolase (5.3.2.5)"	Isomerases :: Intramolecular oxidoreductases :: Transposing C==C bonds (5.3.3.-)	Steroid Delta-isomerase (5.3.3.1)	5-carboxymethyl-2-hydroxymuconate Delta-isomerase (5.3.3.10)	Isopentenyl-diphosphate Delta-isomerase (5.3.3.2)	Vinylacetyl-CoA Delta-isomerase (5.3.3.3)	Muconolactone Delta-isomerase (5.3.3.4)	Methylitaconate Delta-isomerase (5.3.3.6)	Dodecenoyl-CoA isomerase (5.3.3.8)	Protein disulfide-isomerase (5.3.4.1)	Isomerases :: Intramolecular oxidoreductases :: Other intramolecular oxidoreductases (5.3.99.-)	Isomerases :: Intramolecular transferases (mutases) :: Transferring acyl groups (5.4.1.-)	Transferred entry: 5.4.99.61 (5.4.1.2)	Isomerases :: Intramolecular transferases (mutases) :: Phosphotransferases (phosphomutases) (5.4.2.-)	Transferred entry: 5.4.2.11 and 5.4.2.12 (5.4.2.1)	Phosphoglucosamine mutase (5.4.2.10)	"Phosphoglycerate mutase (2,3-diphosphoglycerate-dependent) (5.4.2.11)"	"Phosphoglycerate mutase (2,3-diphosphoglycerate-independent) (5.4.2.12)"	"Phosphoglucomutase (alpha-D-glucose-1,6-bisphosphate-dependent) (5.4.2.2)"	Phosphoacetylglucosamine mutase (5.4.2.3)	Beta-phosphoglucomutase (5.4.2.6)	Phosphopentomutase (5.4.2.7)	Phosphomannomutase (5.4.2.8)	Phosphoenolpyruvate mutase (5.4.2.9)	Isomerases :: Intramolecular transferases (mutases) :: Transferring amino groups (5.4.3.-)	"Lysine 2,3-aminomutase (5.4.3.2)"	"Beta-lysine 5,6-aminomutase (5.4.3.3)"	"D-lysine 5,6-aminomutase (5.4.3.4)"	"D-ornithine 4,5-aminomutase (5.4.3.5)"	"Glutamate-1-semialdehyde 2,1-aminomutase (5.4.3.8)"	Isochorismate synthase (5.4.4.2)	Isomerases :: Intramolecular transferases (mutases) :: Transferring other groups (5.4.99.-)	tRNA pseudouridine(38-40) synthase (5.4.99.12)	Isobutyryl-CoA mutase (5.4.99.13)	(1->4)-alpha-D-glucan 1-alpha-D-glucosylmutase (5.4.99.15)	Maltose alpha-D-glucosyltransferase (5.4.99.16)	Squalene--hopene cyclase (5.4.99.17)	5-(carboxyamino)imidazole ribonucleotide mutase (5.4.99.18)	16S rRNA pseudouridine(516) synthase (5.4.99.19)	Methylmalonyl-CoA mutase (5.4.99.2)	tRNA pseudouridine(55) synthase (5.4.99.25)	tRNA pseudouridine(13) synthase (5.4.99.27)	Chorismate mutase (5.4.99.5)	UDP-galactopyranose mutase (5.4.99.9)	Isomerases :: Intramolecular lyases (5.5.-.-)	Isomerases :: Intramolecular lyases :: Intramolecular lyases (5.5.1.-)	Muconate cycloisomerase (5.5.1.1)	"3-carboxy-cis,cis-muconate cycloisomerase (5.5.1.2)"	Inositol-3-phosphate synthase (5.5.1.4)	"Carboxy-cis,cis-muconate cyclase (5.5.1.5)"	Chloromuconate cycloisomerase (5.5.1.7)	D-ribose pyranase (5.5.1.n1)	Isomerases :: Other isomerases :: Sole sub-subclass for isomerases that do not belong in the other subclasses (5.99.1.-)	DNA topoisomerase (5.99.1.2)	DNA topoisomerase (ATP-hydrolyzing) (5.99.1.3)	2-hydroxychromene-2-carboxylate isomerase (5.99.1.4)	Ligases (6.-.-.-)	Ligases :: Forming carbon-oxygen bonds :: Ligases forming aminoacyl-tRNA and related compounds (6.1.1.-)	Tyrosine--tRNA ligase (6.1.1.1)	Methionine--tRNA ligase (6.1.1.10)	Serine--tRNA ligase (6.1.1.11)	Aspartate--tRNA ligase (6.1.1.12)	D-alanine--poly(phosphoribitol) ligase (6.1.1.13)	Glycine--tRNA ligase (6.1.1.14)	Proline--tRNA ligase (6.1.1.15)	Cysteine--tRNA ligase (6.1.1.16)	Glutamate--tRNA ligase (6.1.1.17)	Glutamine--tRNA ligase (6.1.1.18)	Arginine--tRNA ligase (6.1.1.19)	Tryptophan--tRNA ligase (6.1.1.2)	Phenylalanine--tRNA ligase (6.1.1.20)	Histidine--tRNA ligase (6.1.1.21)	Asparagine--tRNA ligase (6.1.1.22)	Aspartate--tRNA(Asn) ligase (6.1.1.23)	Threonine--tRNA ligase (6.1.1.3)	Leucine--tRNA ligase (6.1.1.4)	Isoleucine--tRNA ligase (6.1.1.5)	Lysine--tRNA ligase (6.1.1.6)	Alanine--tRNA ligase (6.1.1.7)	Valine--tRNA ligase (6.1.1.9)	Ligases :: Forming carbon-sulfur bonds :: Acid--thiol ligases (6.2.1.-)	Acetate--CoA ligase (6.2.1.1)	4-coumarate--CoA ligase (6.2.1.12)	Acetate--CoA ligase (ADP-forming) (6.2.1.13)	6-carboxyhexanoate--CoA ligase (6.2.1.14)	Acetoacetate--CoA ligase (6.2.1.16)	Propionate--CoA ligase (6.2.1.17)	Long-chain-fatty-acid--luciferin-component ligase (6.2.1.19)	Butyrate--CoA ligase (6.2.1.2)	Long-chain-fatty-acid--[acyl-carrier-protein] ligase (6.2.1.20)	[Citrate (pro-3S)-lyase] ligase (6.2.1.22)	Benzoate--CoA ligase (6.2.1.25)	o-succinylbenzoate--CoA ligase (6.2.1.26)	4-hydroxybenzoate--CoA ligase (6.2.1.27)	Long-chain-fatty-acid--CoA ligase (6.2.1.3)	Phenylacetate--CoA ligase (6.2.1.30)	Anthranilate--CoA ligase (6.2.1.32)	Trans-feruloyl-CoA synthase (6.2.1.34)	Succinate--CoA ligase (GDP-forming) (6.2.1.4)	Succinate--CoA ligase (ADP-forming) (6.2.1.5)	Amino acid--[acyl-carrier-protein] ligase (6.2.1.n2)	Ligases :: Forming carbon-nitrogen bonds (6.3.-.-)	Ligases :: Forming carbon-nitrogen bonds :: Acid--ammonia (or amide) ligases (amide synthases) (6.3.1.-)	Aspartate--ammonia ligase (6.3.1.1)	Glutamate--putrescine ligase (6.3.1.11)	ligase (6.3.1.13)	Glutamate--ammonia ligase (6.3.1.2)	NAD(+) synthase (6.3.1.5)	Glutathionylspermidine synthase (6.3.1.8)	Trypanothione synthase (6.3.1.9)	Ligases :: Forming carbon-nitrogen bonds :: Acid--amino-acid ligases (peptide synthases) (6.3.2.-)	Pantoate--beta-alanine ligase (6.3.2.1)	UDP-N-acetylmuramoyl-tripeptide--D-alanyl-D-alanine ligase (6.3.2.10)	Dihydrofolate synthase (6.3.2.12)	"UDP-N-acetylmuramoyl-L-alanyl-D-glutamate--2,6-diaminopimelate ligase (6.3.2.13)"	Tetrahydrofolate synthase (6.3.2.17)	Ubiquitin--protein ligase (6.3.2.19)	Glutamate--cysteine ligase (6.3.2.2)	N-(5-amino-5-carboxypentanoyl)-L-cysteinyl-D-valine synthase (6.3.2.26)	Cyanophycin synthase (L-aspartate-adding) (6.3.2.29)	Glutathione synthase (6.3.2.3)	Cyanophycin synthase (L-arginine-adding) (6.3.2.30)	Coenzyme F420-0:L-glutamate ligase (6.3.2.31)	D-alanine--D-alanine ligase (6.3.2.4)	Phosphopantothenate--cysteine ligase (6.3.2.5)	Phosphoribosylaminoimidazolesuccinocarboxamide synthase (6.3.2.6)	UDP-N-acetylmuramoyl-L-alanyl-D-glutamate--L-lysine ligase (6.3.2.7)	UDP-N-acetylmuramate--L-alanine ligase (6.3.2.8)	UDP-N-acetylmuramoyl-L-alanine--D-glutamate ligase (6.3.2.9)	Pup--protein ligase (6.3.2.n2)	Phosphoribosylformylglycinamidine cyclo-ligase (6.3.3.1)	5-formyltetrahydrofolate cyclo-ligase (6.3.3.2)	Dethiobiotin synthase (6.3.3.3)	Ligases :: Forming carbon-nitrogen bonds :: Other carbon--nitrogen ligases (6.3.4.-)	Phosphoribosylamine--glycine ligase (6.3.4.13)	Biotin carboxylase (6.3.4.14)	Biotin--[acetyl-CoA-carboxylase] ligase (6.3.4.15)	Carbamoyl-phosphate synthase (ammonia) (6.3.4.16)	5-(carboxyamino)imidazole ribonucleotide synthase (6.3.4.18)	tRNA(Ile)-lysidine synthetase (6.3.4.19)	CTP synthase (glutamine hydrolyzing) (6.3.4.2)	7-cyano-7-deazaguanine synthase (6.3.4.20)	Nicotinate phosphoribosyltransferase (6.3.4.21)	tRNA(Ile)(2)-agmatinylcytidine synthase (6.3.4.22)	Formate--tetrahydrofolate ligase (6.3.4.3)	Adenylosuccinate synthase (6.3.4.4)	Argininosuccinate synthase (6.3.4.5)	Urea carboxylase (6.3.4.6)	Ligases :: Forming carbon-nitrogen bonds :: Carbon--nitrogen ligases with glutamine as amido-N-donor (6.3.5.-)	NAD(+) synthase (glutamine-hydrolyzing) (6.3.5.1)	GMP synthase (glutamine-hydrolyzing) (6.3.5.2)	Phosphoribosylformylglycinamidine synthase (6.3.5.3)	Asparagine synthase (glutamine-hydrolyzing) (6.3.5.4)	Carbamoyl-phosphate synthase (glutamine-hydrolyzing) (6.3.5.5)	Asparaginyl-tRNA synthase (glutamine-hydrolyzing) (6.3.5.6)	Glutaminyl-tRNA synthase (glutamine-hydrolyzing) (6.3.5.7)	"Hydrogenobyrinic acid a,c-diamide synthase (glutamine-hydrolyzing) (6.3.5.9)"	Ligases :: Forming carbon-carbon bonds :: Ligases that form carbon-carbon bonds (6.4.1.-)	Pyruvate carboxylase (6.4.1.1)	Acetyl-CoA carboxylase (6.4.1.2)	Propionyl-CoA carboxylase (6.4.1.3)	Methylcrotonoyl-CoA carboxylase (6.4.1.4)	Ligases :: Forming phosphoric ester bonds :: Ligases that form phosphoric-ester bonds (6.5.1.-)	DNA ligase (ATP) (6.5.1.1)	DNA ligase (NAD(+)) (6.5.1.2)	RNA ligase (ATP) (6.5.1.3)	RNA 3'-terminal-phosphate cyclase (ATP) (6.5.1.4)	Ligases :: Forming nitrogen-metal bonds :: Forming coordination complexes (6.6.1.-)	Magnesium chelatase (6.6.1.1)	Cobaltochelatase (6.6.1.2)
PHYLLO09	2077	16	0	10	20	0	5	1	0	3	0	1	0	0	0	0	2	0	0	0	4	0	0	1	0	0	0	0	0	0	1	0	0	0	1	1	1	0	0	0	0	0	0	0	0	1	0	0	1	0	0	0	0	1	5	6	0	0	0	0	1	0	0	1	0	0	3	0	3	0	3	0	0	3	0	0	0	0	1	0	1	0	0	0	3	0	0	0	0	0	0	0	0	0	0	2	0	0	0	1	1	0	0	2	1	1	1	1	0	0	4	0	0	0	0	0	0	0	0	2	0	0	0	0	0	0	0	0	0	0	0	4	2	2	0	0	2	0	0	5	0	0	1	2	0	0	0	0	0	0	0	0	0	0	0	0	0	0	0	0	0	0	0	4	0	3	1	0	0	1	1	1	0	1	0	0	0	0	0	0	0	1	2	0	0	0	0	0	0	0	0	1	9	0	0	0	0	0	0	0	0	1	0	0	0	0	1	0	1	3	0	0	0	0	0	0	0	0	0	0	1	1	0	0	0	0	0	0	2	0	0	0	0	0	0	0	0	0	1	0	0	0	0	0	1	0	0	1	0	1	0	0	0	1	0	0	0	0	0	0	0	0	1	0	0	1	0	0	0	0	6	1	0	0	0	0	0	0	0	0	0	0	0	0	0	0	0	0	0	0	0	0	0	0	0	0	2	0	0	0	0	0	0	0	0	0	0	0	0	1	0	0	0	0	0	0	0	0	0	0	0	0	0	0	1	0	1	0	0	0	0	0	0	0	0	1	1	1	0	2	0	2	1	0	0	0	0	2	1	0	0	13	0	1	0	0	1	0	1	0	0	1	0	0	2	0	0	3	4	0	3	0	0	4	0	0	0	2	0	3	0	7	0	0	3	0	0	1	0	0	0	0	0	0	0	0	0	0	0	0	0	0	5	2	0	0	0	0	3	0	0	0	1	0	3	0	0	14	16	0	0	2	0	2	0	0	0	2	2	0	0	0	3	0	0	0	0	0	0	0	0	0	0	0	0	0	0	0	0	0	0	0	0	0	0	0	0	0	0	0	0	0	0	0	0	0	0	0	0	6	0	0	0	0	2	3	0	0	1	1	1	0	0	0	0	0	0	0	3	4	0	0	0	0	0	0	0	4	4	0	0	0	0	1	0	0	2	0	1	0	0	0	0	0	0	0	0	0	2	3	0	0	0	0	0	1	0	0	0	3	1	0	0	0	1	0	5	3	0	0	0	0	0	1	0	1	3	0	0	1	0	0	0	0	0	0	0	0	0	0	0	0	1	0	0	0	0	1	0	0	0	0	0	0	0	0	0	0	0	0	0	3	0	1	0	4	0	0	0	0	0	0	34	3	0	0	0	4	1	23	1	0	1	1	0	7	0	0	0	0	0	0	0	2	0	6	0	0	2	2	0	0	1	11	0	1	2	0	0	0	0	0	0	0	2	0	0	3	0	0	0	0	0	0	0	0	0	11	0	0	0	1	0	5	1	9	0	0	0	0	0	0	0	9	0	4	1	0	0	3	0	0	0	0	0	1	0	0	0	0	0	1	0	0	0	0	1	1	0	2	1	0	0	0	1	0	0	0	0	1	0	0	1	2	0	0	0	0	0	0	0	0	4	0	0	0	0	0	1	0	0	0	1	0	1	0	6	1	0	0	1	0	0	0	0	0	0	2	1	0	2	0	2	0	0	0	0	0	0	1	0	0	1	1	0	1	2	0	0	0	3	0	2	1	4	0	0	3	7	0	0	6	2	0	0	0	0	0	0	4	0	0	0	0	0	0	3	0	0	0	0	1	0	3	1	1	0	1	0	0	0	0	0	0	0	0	0	0	0	0	1	1	1	0	0	1	0	1	0	1	0	0	2	0	0	0	1	1	0	2	0	0	0	3	2	1	0	0	1	0	6	1	0	2	0	0	0	3	1	0	0	0	0	0	1	3	0	0	0	0	0	2	3	2	5	0	0	0	0	0	3	0	12	0	0	0	0	0	0	0	0	0	3	0	2	0	0	1	0	0	1	2	0	0	0	0	0	3	2	0	0	2	0	0	0	0	0	0	0	0	0	0	0	0	0	0	0	0	0	0	0	0	0	0	3	1	2	0	0	3	2	1	4	0	1	0	0	1	0	0	0	0	0	0	0	0	0	1	5	1	2	1	0	0	3	1	1	1	0	0	3	0	0	0	0	1	2	0	0	2	0	0	0	0	0	1	0	4	0	7	4	0	0	7	5	1	0	3	0	1	3	0	0	0	1	0	0	0	0	13	7	0	3	0	5	3	0	0	0	0	0	0	1	0	0	3	3	0	0	0	0	2	1	2	0	1	0	0	0	0	0	0	1	0	0	3	0	5	0	1	1	0	0	0	2	0	0	0	0	0	0	1	0	0	0	1	0	0	0	2	0	0	0	0	0	0	3	0	1	0	1	1	1	0	1	2	0	0	0	0	0	1	4	0	0	1	0	0	0	0	0	1	1	0	1	0	0	0	3	1	0	1	0	0	0	0	0	0	1	0	0	1	2	1	6	0	0	0	0	1	0	0	0	0	0	0	0	0	0	0	0	0	0	23	0	1	1	0	0	1	5	1	1	9	5	2	3	0	2	0	5	0	0	0	2	0	0	1	0	1	0	0	8	9	0	0	2	0	0	0	0	0	0	0	1	0	1	3	1	1	0	1	1	2	0	0	0	7	0	0	1	1	0	14	0	0	0	0	2	0	0	41	0	0	0	5	0	0	3	1	0	0	1	0	0	0	0	0	0	0	0	0	1	2	0	1	2	2	0	0	2	0	1	0	0	0	2	6	9	0	0	0	1	1	0	0	0	6	0	0	0	0	3	0	0	2	10	2	2	0	0	0	5	0	0	1	0	1	0	1	0	0	0	0	0	0	2	0	0	0	0	0	0	3	0	0	1	0	0	0	0	0	0	0	3	3	1	0	3	0	2	0	0	3	4	2	0	0	0	0	0	0	1	1	0	1	1	1	1	0	0	0	2	0	0	3	0	1	0	0	0	0	0	1	0	7	0	1	0	1	2	0	0	0	0	1	0	0	0	0	0	0	0	0	1	0	1	1	0	0	0	0	0	0	0	0	0	0	0	0	0	0	0	0	0	0	0	0	2	3	3	0	0	4	1	0	1	1	0	0	0	0	0	0	1	2	1	0	0	0	0	1	0	2	4	2	0	0	0	0	0	0	1	0	0	2	1	0	0	0	0	0	0	0	3	0	1	7	0	1	1	0	1	0	1	0	0	0	1	0	3	1	1	0	0	0	0	1	1	1	0	1	1	0	0	0	0	0	0	0	0	0	0	0	0	0	0	0	0	0	2	0	0	0	0	0	0	0	0	0	0	0	0	0	0	1	0	0	0	0	1	0	0	2	0	3	1	0	1	1	2	4	0	0	0	5	0	3	0	0	0	0	1	0	1	3	1	0	2	1	0	0	0	0	1	0	0	0	0	0	0	0	0	0	0	0	2	0	0	0	0	0	1	0	1	0	0	0	0	0	2	0	0	1	5	0	0	0	2	0	0	1	0	0	0	0	1	8	0	0	0	0	0	0	0	0	0	0	0	2	0	3	0	0	0	0	0	1	0	0	0	10	0	1	0	0	0	0	0	0	0	2	0	0	0	0	0	0	0	1	3	1	0	0	0	0	2	1	0	1	2	1	2	0	0	0	0	0	0	0	1	1	0	0	1	0	0	0	0	1	0	0	1	6	0	0	0	0	0	0	0	0	0	0	0	0	0	0	0	1	0	0	0	2	2	1	0	0	1	0	0	0	0	0	0	0	0	0	0	0	0	4	3	0	0	1	0	0	0	1	1	2	0	0	0	0	0	0	0	0	0	0	0	0	0	0	2	3	0	2	0	0	0	1	0	0	1	0	0	0	1	0	0	0	0	0	0	0	0	0	1	0	0	0	0	3	23	5	0	0	1	0	3	0	1	1	1	0	0	1	5	2	0	2	0	0	0	0	0	0	26	0	0	1	7	0	0	9	0	0	1	0	0	0	1	6	0	6	2	1	5	0	2	1	0	1	1	0	5	2	0	0	0	3	0	1	0	0	0	0	0	18	0	9	4	0	0	3	0	0	0	0	0	7	1	4	1	1	0	0	0	0	0	0	3	0	0	0	2	0	0	2	0	0	0	0	0	5	4	0	1	0	0	1	4	0	0	0	1	0	0	0	0	0	0	0	0	0	3	1	0	0	0	0	1	0	0	0	0	1	0	0	0	0	0	1	1	0	0	0	1	0	0	5	6	0	1	1	0	0	0	0	1	0	0	0	1	0	0	0	0	1	0	0	0	2	0	0	0	1	0	0	0	1	0	0	0	1	0	0	0	0	1	3	1	0	0	0	0	3	5	1	0	0	0	0	6	0	0	0	0	1	2	0	0	0	0	4	0	2	4	8	1	3	0	0	14	0	0	5	0	0	0	1	0	1	0	0	4	0	1	1	0	0	1	1	0	0	0	0	0	0	0	0	1	0	0	0	0	0	0	0	0	7	0	1	0	2	0	0	0	0	0	0	0	0	0	2	0	0	1	0	0	4	2	0	1	0	0	0	0	0	0	0	0	1	0	3	0	0	1	0	0	5	1	0	0	0	1	1	0	0	2	2	0	0	1	0	0	0	0	0	0	0	1	1	0	0	0	2	0	1	0	0	0	1	4	0	1	2	0	2	0	2	0	0	0	0	0	1	0	0	0	2	5	0	0	2	0	0	0	0	2	0	0	0	0	0	1	0	0	0	0	0	0	0	1	0	0	4	0	0	2	0	0	0	1	0	3	2	1	0	0	0	0	0	0	0	0	4	2	4	0	0	0	0	0	0	1	1	0	0	0	0	0	1	0	1	0	0	5	0	1	2	0	0	1	3	0	0	0	0	0	0	0	0	9	0	0	8	1	0	0	0	5	1	0	1	0	0	0	0	1	1	0	0	0	1	6	18	0	0	0	3	6	4	0	2	6	4	1	8	8	3	5	10	3	0	2	7	9	4	2	9	6	2	4	0	2	0	0	0	5	0	0	0	1	3	0	9	0	0	0	0	7	0	0	0	0	0	0	7	4	0	1	4	0	2	1	2	0	0	0	0	1	0	1	0	1	1	1	0	1	1	0	3	0	0	0	3	2	1	0	0	0	3	1	1	0	0	1	8	0	8	1	6	13	12	3	0	5	0	0	3	4	4	2	1	16	6	0	0	0	2	2
PHYLLO10	3779	21	1	13	37	0	11	2	0	0	0	0	0	0	0	0	1	0	0	0	0	0	0	6	0	0	0	1	0	0	3	0	0	0	0	0	0	0	0	0	2	0	0	0	0	2	0	0	5	0	1	0	0	0	6	3	0	0	0	0	1	1	0	3	0	0	4	0	6	0	0	1	0	1	0	0	2	0	0	2	0	1	0	0	12	1	0	0	0	2	1	0	0	0	0	0	10	0	0	3	2	0	0	5	2	8	1	0	1	0	1	0	0	0	0	0	0	1	0	1	2	0	0	0	1	0	0	0	0	0	0	3	6	0	1	0	1	0	2	32	0	0	2	3	0	0	0	0	0	0	0	0	0	0	0	0	0	0	0	0	0	0	1	2	1	4	3	0	0	0	2	0	0	0	0	0	0	2	0	0	0	0	1	0	0	0	0	0	0	1	0	2	8	0	0	1	0	0	0	0	0	1	0	1	0	7	8	2	5	0	0	0	0	0	0	0	0	0	0	0	0	0	2	0	0	0	0	2	2	0	0	0	0	0	2	0	0	0	0	0	0	0	0	0	0	0	1	0	0	0	3	0	0	1	0	0	0	0	0	1	0	0	0	0	0	0	0	0	0	1	6	0	0	0	0	0	0	0	0	0	0	3	0	0	0	0	0	0	0	0	0	0	1	0	0	0	5	0	0	0	0	0	0	0	0	1	0	0	1	0	0	0	0	0	0	0	0	0	0	0	0	0	1	0	0	0	0	0	0	0	0	0	0	0	0	0	5	0	0	0	0	2	0	0	0	0	2	6	1	0	0	22	0	1	0	0	0	1	3	2	0	1	0	0	2	0	3	3	3	0	2	0	1	4	0	0	1	2	0	2	1	8	1	0	5	4	4	1	0	0	0	0	0	0	0	0	0	0	0	0	0	0	2	5	0	0	0	2	6	0	1	0	0	0	0	0	0	9	15	1	1	4	0	1	0	0	0	4	0	0	0	1	1	0	0	0	0	0	0	0	0	2	0	0	1	0	0	1	0	0	0	0	0	0	0	0	3	0	0	1	0	0	0	0	0	0	0	0	0	1	1	0	0	0	2	1	0	0	0	0	0	0	3	1	0	0	0	0	9	10	0	0	12	1	0	1	1	6	2	1	0	0	0	2	0	0	6	0	0	0	0	0	3	0	0	0	0	0	9	2	0	0	0	0	0	0	0	0	0	2	0	0	0	0	0	0	7	14	2	0	0	0	0	3	0	2	3	0	1	0	0	5	0	0	0	0	1	0	0	0	0	0	1	0	0	0	0	3	0	0	0	0	0	0	0	0	0	0	0	0	0	9	0	0	2	5	0	0	0	0	0	1	27	0	0	0	0	1	4	21	2	0	2	45	0	4	2	0	0	0	0	1	0	1	0	3	0	0	2	6	0	0	7	10	0	2	2	0	0	0	0	0	0	0	0	0	0	0	0	0	1	0	0	0	0	0	0	24	0	0	0	1	0	12	0	27	0	0	1	2	0	0	0	11	1	1	0	0	0	8	1	0	0	0	4	0	0	1	3	1	0	0	0	0	0	1	2	0	0	0	0	0	2	0	1	1	0	2	2	1	0	2	0	0	0	0	0	0	2	0	1	1	1	2	0	3	0	0	1	2	1	0	3	0	0	0	5	0	0	0	0	4	0	3	0	0	0	8	0	0	1	6	6	0	1	1	2	3	0	3	0	0	2	1	0	6	2	0	0	0	0	0	8	0	3	0	2	7	5	1	0	11	1	0	0	1	0	4	0	4	0	2	2	0	2	0	7	0	0	1	0	1	0	8	0	11	1	0	0	0	1	0	0	0	0	0	0	0	0	0	0	3	2	1	1	0	0	4	0	6	0	2	1	0	0	0	1	3	0	3	0	0	0	1	4	0	0	0	0	0	6	1	0	2	0	0	0	12	0	0	1	2	0	1	0	4	0	0	1	0	0	7	9	6	6	0	0	0	0	0	1	0	21	0	0	0	4	0	0	0	0	0	4	0	0	0	0	0	0	0	2	2	0	0	0	0	0	4	0	0	0	0	0	0	0	0	0	0	0	0	0	0	0	0	0	0	1	0	0	0	0	1	0	1	4	2	2	0	0	5	1	2	29	0	1	0	0	5	0	0	0	0	0	0	2	0	0	1	18	3	1	5	0	0	12	4	6	1	2	1	4	3	0	0	0	1	3	3	1	1	0	0	0	2	0	5	3	2	0	5	3	0	0	5	3	0	0	39	6	0	3	0	2	0	0	0	0	0	0	25	6	0	8	0	6	4	0	3	0	0	0	0	1	1	0	3	0	0	0	0	0	0	6	0	0	2	0	0	0	0	0	0	0	2	0	2	0	2	5	3	2	0	0	2	0	0	0	1	0	0	0	3	0	0	0	1	0	0	0	2	0	0	2	2	0	0	4	0	1	0	3	2	1	1	0	4	0	2	8	0	3	0	4	0	0	0	0	1	0	0	2	0	2	0	3	0	0	0	5	3	0	1	0	0	0	0	0	0	1	0	3	3	6	4	1	0	0	0	0	0	0	0	0	0	0	0	0	3	0	0	0	0	0	40	0	2	3	0	0	7	4	0	1	9	4	2	8	0	7	0	15	0	2	0	1	1	1	0	0	3	0	3	11	5	0	2	2	0	0	0	1	0	2	0	1	0	2	1	2	2	0	7	2	0	0	0	0	0	0	0	0	1	0	42	0	0	0	0	2	0	1	64	1	0	1	10	0	0	0	3	0	0	5	0	1	0	0	0	0	0	0	1	1	6	3	2	0	3	0	0	2	0	2	1	1	0	6	6	5	0	0	0	0	0	0	0	0	5	1	3	0	0	4	0	1	7	67	1	0	1	0	0	2	0	0	30	0	2	0	1	1	3	0	0	1	0	2	0	0	1	0	0	1	8	0	0	2	0	0	0	0	1	0	1	3	5	0	0	4	0	0	0	0	2	0	0	0	0	1	0	0	0	2	1	0	0	7	0	2	0	0	1	1	0	4	9	5	2	0	0	0	0	0	0	9	5	0	2	3	1	2	1	1	0	0	1	0	0	0	2	0	0	0	0	1	0	2	10	0	0	0	0	0	0	0	0	0	0	0	0	0	0	0	5	0	0	0	0	1	3	1	0	0	1	1	0	1	2	3	0	0	0	0	0	0	1	0	0	0	0	0	0	0	0	8	1	0	0	0	0	0	0	0	2	0	2	2	3	0	1	0	0	0	4	0	0	1	9	3	6	0	0	2	6	2	1	0	0	2	0	2	0	0	1	0	0	0	1	5	5	0	3	0	0	0	0	0	0	1	0	0	0	1	0	4	0	0	0	0	0	1	0	0	1	0	0	0	1	0	5	0	1	2	0	0	2	0	1	0	0	4	0	1	4	0	1	0	0	1	13	4	2	0	0	0	7	0	2	0	0	0	1	0	0	0	10	0	0	1	4	0	0	0	1	1	0	0	1	1	0	1	0	1	3	1	1	4	0	0	0	0	1	1	0	0	0	0	0	0	0	1	0	0	3	15	0	0	0	7	0	0	2	0	0	1	0	0	6	0	0	0	0	0	0	0	0	0	2	0	0	3	7	2	2	0	0	0	1	1	0	0	13	0	0	0	0	0	0	0	0	0	36	0	0	1	0	0	0	0	3	1	0	0	0	0	0	0	2	0	4	12	0	1	0	0	0	0	0	0	1	1	0	1	0	4	0	0	0	0	1	0	0	3	0	0	1	0	1	0	0	2	1	1	0	0	0	0	0	2	0	0	0	2	2	0	0	0	0	1	0	1	0	1	0	0	0	0	0	0	0	0	1	2	0	5	2	1	0	1	1	2	1	0	0	0	0	1	0	0	1	0	0	2	1	0	0	1	9	0	0	0	0	1	1	0	0	0	0	0	0	4	5	0	0	1	0	0	0	0	0	0	0	1	3	0	4	33	5	0	1	0	0	36	0	2	0	3	0	0	4	7	0	0	1	2	0	0	0	0	0	22	0	0	7	11	1	0	49	0	0	1	0	0	0	2	9	0	17	4	2	4	28	0	2	0	0	0	0	6	1	0	0	2	9	0	1	0	0	0	0	0	25	0	9	3	0	0	0	0	0	2	0	0	11	2	1	0	2	0	0	0	0	0	0	0	0	0	0	3	0	1	0	0	5	2	0	0	8	4	0	4	0	0	1	9	2	1	0	2	3	1	0	0	0	0	0	0	1	0	0	0	2	0	0	4	0	0	0	0	2	0	0	0	0	0	0	0	0	0	3	1	0	0	0	4	1	0	1	0	0	0	0	1	0	0	0	1	0	0	1	0	0	0	0	1	4	0	0	0	6	0	0	0	0	0	1	0	33	1	0	0	1	4	1	1	0	0	1	1	9	1	1	0	0	0	0	4	0	0	0	0	4	0	0	0	1	0	11	0	1	6	6	0	7	0	0	14	0	0	4	0	0	4	0	48	1	0	0	7	7	4	1	2	0	0	0	3	0	0	0	0	0	3	0	0	0	3	0	0	0	1	0	0	10	0	0	0	5	0	0	0	0	1	0	0	0	0	2	0	0	1	0	0	1	1	0	1	0	0	0	4	2	0	0	0	4	1	9	0	0	7	0	0	5	2	1	0	5	0	1	0	0	1	1	0	0	0	0	0	1	0	0	0	1	1	0	1	2	0	36	0	1	0	0	0	0	9	2	4	1	0	5	0	0	1	0	0	5	0	0	0	0	0	1	0	0	0	7	0	0	0	0	9	0	0	0	0	0	0	1	0	4	0	1	0	1	2	0	0	11	1	0	2	1	0	0	2	1	7	0	2	0	0	0	0	0	0	2	0	4	1	7	0	0	0	0	0	0	3	0	0	1	1	2	0	0	0	0	2	0	3	2	4	0	0	0	0	2	0	0	0	0	0	0	0	0	27	2	0	8	4	0	0	0	11	3	0	1	1	0	0	1	1	2	0	0	0	6	16	20	0	0	0	8	5	2	3	0	4	9	1	4	6	9	3	16	2	5	5	15	13	14	5	10	6	0	7	0	1	0	1	1	0	0	0	0	0	1	0	9	1	0	0	0	10	0	1	0	0	0	0	27	2	0	0	1	5	2	0	3	0	0	8	3	0	1	0	0	6	3	5	0	1	6	0	3	0	2	0	2	5	0	2	0	0	5	0	4	0	0	2	7	0	3	4	3	12	5	21	0	4	0	0	1	8	3	7	3	17	7	1	0	0	4	1
PHYLLO11	440	9	2	1	2	0	0	0	0	0	0	0	0	0	0	0	0	0	0	0	1	0	0	0	0	0	0	0	0	0	0	0	0	0	1	0	0	0	0	0	0	0	0	0	0	0	0	0	1	0	0	0	0	0	0	2	0	0	0	0	0	0	0	0	0	0	0	0	0	0	0	0	0	0	0	0	0	0	0	0	0	1	0	0	1	0	0	0	0	0	0	0	0	0	0	0	1	0	0	0	0	0	0	1	1	1	3	0	1	0	4	0	0	0	0	0	0	0	1	0	0	0	0	0	0	0	0	0	0	0	0	1	1	0	0	0	0	0	0	0	0	0	0	0	0	0	0	0	0	1	0	0	0	0	0	0	0	0	0	0	0	0	0	0	0	0	0	0	0	0	0	0	0	0	0	0	0	0	0	0	0	0	0	0	0	0	0	0	0	0	0	0	2	0	0	0	0	0	0	0	0	0	0	0	0	0	0	0	1	1	0	0	0	0	0	0	0	0	0	0	0	0	0	0	0	0	0	0	0	0	0	0	0	0	0	0	0	0	0	0	0	0	0	0	0	0	0	0	0	0	0	0	0	0	0	0	0	0	0	0	0	0	0	0	0	0	0	0	0	0	2	0	0	0	0	0	0	0	0	0	0	0	0	0	0	0	0	0	0	0	0	0	0	0	0	0	0	0	0	0	0	0	0	0	0	0	0	0	0	0	0	1	0	0	0	0	0	0	0	0	1	0	0	0	2	0	0	0	0	0	0	0	0	0	0	0	0	0	0	0	0	0	0	0	0	0	1	1	0	0	0	1	0	0	0	0	0	0	0	0	0	0	0	0	0	0	0	0	1	0	0	0	0	2	0	0	0	1	0	1	0	0	0	0	1	0	0	0	0	1	0	0	0	0	0	0	0	0	0	0	0	0	0	0	0	0	0	0	0	0	0	0	0	0	0	0	0	3	1	0	0	0	0	1	0	0	0	0	0	0	0	0	0	0	0	0	0	0	0	0	0	0	0	0	0	0	0	0	0	0	0	1	0	0	0	0	1	0	0	0	0	0	0	0	0	0	0	0	0	1	0	0	0	0	0	1	0	0	0	0	0	0	0	2	0	0	0	0	0	0	0	0	0	0	0	0	0	2	0	0	0	0	0	0	0	0	3	0	0	0	0	0	0	0	0	0	0	0	0	0	0	0	0	0	0	0	0	0	0	0	0	0	0	0	0	0	1	2	0	0	0	0	0	0	0	0	0	0	0	0	0	0	0	0	0	0	0	0	0	0	0	1	0	0	0	0	0	1	0	0	0	0	0	0	0	0	0	0	0	0	0	0	0	0	1	0	0	0	0	0	0	0	17	0	0	0	0	1	0	2	0	0	0	0	0	0	0	0	0	0	0	0	0	0	0	1	0	0	0	0	0	0	0	5	0	0	4	0	0	0	0	0	0	0	0	0	0	0	0	0	0	0	1	0	0	0	0	4	0	0	1	0	0	0	0	0	1	0	0	2	0	0	0	0	0	1	0	0	0	0	1	0	0	0	0	0	0	0	0	0	0	0	0	0	0	0	0	0	0	0	0	0	0	0	0	0	0	0	0	0	0	0	0	0	0	0	0	0	0	0	0	0	1	0	0	1	0	0	0	0	0	0	0	0	0	0	0	0	0	0	0	0	0	0	0	0	0	3	0	0	0	0	2	0	0	0	0	0	0	0	0	0	0	0	0	1	0	0	0	0	0	0	0	0	1	0	0	0	0	0	0	6	0	0	0	0	0	0	0	0	0	0	0	0	0	0	0	0	0	0	0	0	0	1	0	1	1	0	0	0	0	0	0	0	0	0	0	0	0	1	0	0	0	0	0	0	0	0	0	1	0	0	0	0	0	0	0	0	0	0	0	0	0	0	1	0	0	0	0	0	1	0	0	1	0	0	0	0	0	0	0	0	0	0	0	0	0	0	2	0	0	0	0	0	2	0	0	0	0	0	0	0	2	0	0	0	0	0	0	0	0	0	4	0	0	0	0	0	0	0	0	0	0	0	0	0	0	0	0	0	0	0	0	0	0	0	0	0	0	0	0	0	0	0	0	0	0	0	0	0	0	0	0	0	0	0	0	0	0	3	1	0	0	0	0	0	0	0	0	0	0	1	0	0	0	0	0	0	0	0	1	0	0	0	1	0	0	0	0	0	0	0	0	0	0	0	0	0	0	0	0	1	0	0	0	0	0	0	0	0	1	0	0	1	1	0	0	1	0	0	1	0	0	0	0	0	0	0	0	3	2	0	1	0	1	0	0	0	0	0	0	0	0	0	0	0	0	0	0	0	0	0	0	0	0	0	0	0	0	0	0	0	0	0	0	1	0	0	0	0	2	0	0	0	0	0	0	0	0	0	0	0	0	0	0	2	0	0	0	0	0	0	0	0	0	0	1	0	0	0	0	0	0	0	0	0	0	0	1	0	0	0	2	0	0	0	0	0	0	0	0	0	0	0	0	0	0	0	2	0	0	0	0	0	0	0	0	0	1	0	1	2	0	0	1	0	0	0	0	0	0	0	1	1	0	0	0	0	0	0	0	0	0	3	0	0	0	0	0	0	1	1	0	3	0	0	0	0	0	0	0	0	0	0	0	0	0	0	0	0	0	0	0	2	1	0	0	0	2	0	0	0	0	0	1	0	0	0	0	0	0	2	0	0	0	0	7	0	0	0	1	0	0	3	0	0	0	0	0	0	0	5	0	0	0	0	0	0	0	0	0	0	0	0	0	0	0	0	0	0	0	0	0	1	0	0	0	0	0	0	0	0	0	0	0	0	0	0	0	0	0	0	0	0	0	0	0	0	1	1	0	0	0	0	0	0	3	0	3	0	0	0	1	0	0	0	0	1	1	0	0	0	0	0	0	0	0	0	0	0	0	0	0	0	0	0	0	0	0	0	0	0	0	0	0	0	0	0	0	1	0	0	0	0	0	0	0	0	0	0	0	0	0	0	0	0	2	0	0	0	0	0	1	0	0	0	1	0	0	0	0	0	0	0	1	0	0	0	0	0	0	0	0	0	0	0	0	0	0	1	0	0	0	0	0	0	0	0	0	0	0	0	0	0	0	0	0	0	0	0	0	0	0	2	0	0	0	0	0	4	0	0	0	1	0	0	0	0	1	0	0	0	0	0	0	0	0	0	0	0	0	0	0	0	2	1	0	0	0	0	0	0	0	0	0	0	0	0	0	0	0	0	0	0	0	0	0	0	1	0	0	0	0	0	0	0	0	1	0	0	0	0	0	0	0	0	0	0	0	0	0	2	0	0	0	0	0	0	0	0	0	0	0	0	0	0	0	0	0	0	5	0	0	0	0	0	0	0	0	0	0	0	0	0	0	1	0	0	0	0	0	0	0	0	0	0	0	0	0	4	1	0	0	0	0	0	0	0	0	0	0	0	0	0	0	2	0	0	1	0	0	0	0	0	0	0	0	0	0	0	0	0	0	0	0	0	0	0	0	0	0	0	0	0	0	0	0	0	0	0	0	0	0	0	0	0	0	0	0	1	0	0	0	0	0	0	0	2	0	0	0	0	0	2	0	0	0	0	0	1	0	0	0	0	0	0	0	0	0	0	0	1	0	0	0	1	0	0	0	1	0	0	0	0	0	0	0	0	0	0	0	0	0	0	0	0	2	0	0	0	1	0	0	0	0	0	0	0	1	0	1	0	1	0	0	0	0	2	0	0	0	0	0	0	0	0	0	0	0	0	0	0	0	0	0	0	0	0	0	0	0	0	0	0	2	0	0	0	0	0	0	1	0	0	0	0	0	1	0	0	0	0	0	0	0	0	0	0	0	0	0	1	0	0	0	0	0	0	0	0	0	0	0	0	0	0	1	1	0	0	0	0	0	0	0	0	0	0	0	0	0	0	0	0	1	0	0	0	0	0	0	0	0	0	0	1	3	1	0	0	1	0	0	0	1	0	0	0	0	0	2	0	0	0	0	0	0	0	0	0	4	0	0	1	2	0	0	4	0	0	0	0	0	1	0	2	0	0	0	0	0	2	0	0	0	0	0	0	4	0	0	0	0	0	0	0	0	0	0	0	0	5	0	1	0	0	0	0	0	0	0	0	0	1	1	0	0	0	0	0	0	0	1	0	0	0	0	0	0	0	0	0	0	0	0	0	0	0	0	0	0	0	0	0	1	2	0	0	0	2	0	0	0	0	0	0	0	2	1	0	0	0	0	0	0	0	0	0	0	0	0	0	0	0	0	0	0	0	0	0	0	0	0	1	3	0	0	0	0	0	0	0	0	0	0	0	0	0	0	0	0	0	0	0	0	0	0	0	0	0	0	0	0	0	0	0	0	0	0	0	1	0	1	0	0	0	0	0	0	0	0	0	0	0	0	0	1	0	0	0	0	0	0	0	0	0	0	1	0	0	2	1	0	1	0	0	2	0	0	1	0	0	0	0	0	0	0	0	0	0	1	0	0	0	0	0	1	0	0	0	0	1	0	0	0	0	0	0	0	0	0	0	0	0	0	0	0	0	1	0	0	0	0	0	0	0	0	0	0	0	0	0	0	0	2	0	1	0	0	0	0	0	0	0	0	0	0	0	0	0	0	0	0	0	1	0	0	0	0	0	0	0	0	0	0	0	0	0	0	0	0	0	0	0	0	0	1	0	0	0	0	0	0	0	0	0	1	0	0	0	0	1	0	0	0	0	0	1	0	0	0	1	0	0	0	0	0	0	1	0	0	0	0	0	0	0	0	0	0	0	0	0	0	0	0	0	0	0	0	0	1	2	0	0	0	0	0	0	0	0	0	0	0	0	0	0	0	2	1	0	0	0	0	0	0	0	0	0	0	0	0	0	0	0	0	0	0	2	0	0	1	1	0	0	0	0	0	0	0	0	0	0	0	0	2	0	5	1	0	0	0	0	0	0	3	0	0	0	1	0	0	0	1	0	0	0	0	0	1	6	0	2	0	0	4	0	0	0	0	0	0	0	0	0	0	3	2	0	0	1	1	3	0	1	1	0	0	0	0	0	1	0	0	0	0	0	0	0	0	0	0	0	0	0	0	0	0	0	0	0	0	3	0	0	0	0	3	0	0	0	0	0	1	0	0	0	0	0	0	0	1	0	0	0	0	0	0	0	0	0	0	0	0	0	1	3	0	0	0	0	1	1	0	0	1	0	0	2	3	0	0	0	0	0	0	0	0	0	0	0	0	0	0	0	0
PHYLLO12	3300	36	1	4	1	0	13	4	1	0	0	0	0	0	0	0	0	0	2	0	3	0	0	0	0	0	0	0	0	0	0	0	0	0	1	1	0	0	0	0	2	0	0	0	0	1	1	0	3	0	0	0	1	0	1	9	0	0	0	0	0	0	0	2	2	0	2	0	2	0	0	2	0	5	0	0	4	0	0	2	0	3	0	0	4	0	0	1	0	0	0	0	0	0	0	0	3	0	0	3	2	0	0	3	0	7	0	0	0	0	0	2	0	0	1	1	7	1	2	0	0	0	2	2	1	0	0	0	0	1	1	2	4	0	0	0	0	1	4	10	0	0	3	1	0	0	2	0	0	0	0	0	0	0	0	0	0	0	0	0	0	0	1	3	8	3	6	0	0	1	5	0	0	0	0	0	0	0	0	0	0	0	9	0	0	0	1	0	0	0	0	4	22	0	0	0	0	0	0	0	0	0	2	2	0	4	3	0	8	2	0	0	0	0	0	0	0	0	0	1	0	0	1	0	0	2	0	2	2	0	0	0	0	2	0	0	0	0	0	0	0	0	2	0	1	0	0	0	0	4	2	0	3	0	1	0	0	0	0	0	0	0	0	0	3	0	0	0	0	0	6	0	0	0	0	0	0	0	0	0	0	1	0	0	0	0	0	0	0	0	0	0	0	0	0	0	0	1	0	0	0	2	0	0	0	0	0	0	0	5	0	0	0	0	0	0	0	0	0	0	2	0	1	0	1	0	0	0	0	0	0	0	0	0	0	0	4	1	0	0	0	2	0	0	0	0	9	3	1	1	3	11	4	5	0	0	0	0	5	1	0	0	0	0	5	0	0	11	1	0	3	0	1	10	0	1	0	0	0	3	0	8	2	0	5	0	1	3	0	0	0	1	0	0	0	0	0	0	0	0	0	0	5	0	0	0	1	0	1	0	0	0	1	0	0	1	0	9	11	1	1	3	1	1	0	0	0	1	0	0	0	0	2	0	0	0	0	0	0	2	0	1	1	1	1	0	0	0	0	2	0	2	0	0	0	0	4	0	0	0	0	0	1	0	0	0	0	0	0	6	1	0	0	0	2	4	0	0	1	4	0	1	6	4	0	1	0	0	2	0	0	0	1	1	0	0	0	8	10	1	0	0	0	2	0	0	8	0	1	0	0	0	0	0	0	3	0	0	12	4	0	1	0	0	2	1	2	0	0	1	0	0	0	2	3	0	6	8	4	1	0	2	0	5	0	1	7	0	0	1	2	1	0	0	0	0	0	0	0	0	0	1	2	2	0	0	0	3	1	0	0	0	0	0	0	0	0	0	0	0	0	4	0	3	2	6	0	4	0	2	2	1	21	3	0	0	0	0	3	37	0	0	0	1	0	8	0	0	0	2	0	0	0	1	0	12	0	0	1	0	0	0	5	7	0	0	6	0	0	0	0	2	0	0	0	3	0	3	0	0	1	0	1	0	0	0	0	18	0	0	2	2	0	11	1	19	1	0	0	4	0	0	0	8	0	1	0	0	0	7	0	0	0	0	0	0	0	1	0	2	0	0	0	0	0	0	1	0	1	0	0	0	1	1	3	0	0	1	0	4	0	0	0	0	0	0	0	0	2	0	0	0	3	0	0	0	3	4	6	0	1	0	6	0	1	0	4	0	0	0	0	0	1	4	0	0	0	5	2	0	0	3	0	0	1	4	2	1	0	0	0	0	4	1	0	1	0	0	0	0	0	0	9	0	0	0	0	9	3	0	1	9	0	0	0	1	0	2	1	1	0	4	3	0	1	0	3	0	1	1	0	1	0	4	0	6	0	0	0	2	0	0	4	0	0	0	0	0	0	0	0	2	2	2	0	0	1	0	3	2	0	1	0	0	0	0	1	4	0	1	0	0	0	0	4	0	0	1	1	0	4	1	0	3	0	0	0	1	0	0	4	1	0	0	0	11	0	0	3	2	0	4	10	8	7	0	0	0	0	0	7	0	22	0	0	0	0	0	1	0	0	0	3	0	3	0	0	0	0	0	0	0	0	0	0	0	0	3	1	0	0	3	0	0	0	0	0	0	0	1	0	0	0	0	0	0	0	0	1	0	0	0	0	0	7	0	2	0	0	2	1	3	2	0	1	0	0	8	0	0	0	0	0	0	0	0	0	0	2	2	2	3	0	0	6	0	1	0	3	1	3	4	0	0	0	0	5	0	3	1	0	0	0	0	0	4	0	2	0	8	0	0	0	4	2	0	0	7	3	2	0	0	0	0	0	0	0	0	0	13	11	0	3	0	4	0	0	4	0	0	0	0	0	0	0	3	0	0	0	1	0	0	2	0	0	5	2	0	0	0	0	0	0	4	1	4	0	2	0	7	10	0	0	1	6	0	0	2	2	0	0	1	0	0	0	0	3	0	3	1	0	0	3	2	0	0	0	1	0	0	2	3	0	2	1	4	0	0	0	0	6	1	5	0	0	0	0	0	0	0	0	0	0	0	8	0	0	0	24	2	0	0	2	0	0	0	1	0	0	0	0	1	3	3	9	0	0	0	0	0	0	0	0	0	0	1	0	2	0	0	0	0	0	37	0	2	4	0	0	1	6	0	2	17	7	4	15	0	2	0	2	0	2	0	2	0	2	0	0	3	0	2	6	9	1	0	1	0	1	0	2	0	1	1	3	0	0	1	1	0	0	4	2	11	2	0	11	7	0	0	2	0	2	52	0	0	2	0	3	0	0	59	2	0	0	7	0	1	3	5	0	0	0	0	0	0	3	0	1	0	0	0	3	1	0	1	6	1	0	0	2	1	0	0	0	0	2	9	9	0	0	0	1	1	0	0	0	3	2	0	1	0	3	0	0	5	25	1	1	1	0	0	0	0	0	0	0	2	0	6	4	0	0	0	0	0	0	0	2	0	0	0	0	0	0	1	0	0	0	0	0	0	0	0	7	13	1	2	5	0	1	0	0	2	2	4	0	0	0	0	0	1	0	1	0	2	11	0	4	0	0	3	2	0	2	7	2	1	2	0	0	0	0	0	7	7	0	4	0	0	3	1	0	0	0	0	1	0	0	4	1	0	0	0	0	0	0	1	0	2	0	0	0	0	0	0	0	0	0	0	0	0	0	7	0	0	0	2	0	10	0	0	0	2	1	0	4	7	1	0	0	0	0	1	0	1	0	0	0	0	0	0	0	2	9	3	0	0	0	2	0	0	0	0	0	0	1	1	0	0	0	0	0	1	0	0	0	3	0	9	0	0	0	0	1	0	1	0	0	0	0	0	0	0	1	0	0	0	2	4	0	2	0	0	0	0	0	0	1	0	0	0	0	0	0	0	0	0	0	0	7	0	1	0	0	0	0	0	0	3	4	0	0	0	0	5	0	4	0	0	4	2	0	4	0	0	0	0	0	15	0	1	0	0	0	5	0	7	0	0	0	0	0	0	0	12	0	0	0	1	0	0	0	4	0	0	1	0	0	0	0	0	0	1	2	0	3	0	0	0	0	2	1	0	0	0	0	0	0	1	3	0	0	0	11	1	0	0	5	0	0	0	0	0	2	0	0	12	0	0	1	0	0	0	0	0	0	3	0	4	2	4	3	0	0	2	0	0	0	0	0	16	1	0	0	0	0	0	0	0	0	0	0	0	0	2	0	0	0	0	6	1	0	0	1	0	3	0	0	0	3	3	2	0	0	0	0	0	0	0	2	0	0	1	0	0	0	1	0	7	0	2	1	1	0	0	0	4	0	0	7	0	0	0	1	0	0	0	0	1	0	0	1	0	3	0	0	0	1	5	0	0	0	0	0	0	0	0	0	0	0	1	8	0	7	0	2	0	0	0	2	0	1	0	2	0	0	2	4	1	0	0	3	2	0	0	2	1	0	6	0	0	0	1	0	0	1	0	3	0	0	0	2	0	0	0	2	0	0	0	0	0	0	0	0	2	34	2	0	9	2	0	4	0	0	2	4	0	0	3	2	1	2	0	0	0	1	0	0	0	40	0	0	3	19	0	0	13	0	1	0	0	0	0	1	5	0	5	2	7	4	2	4	2	0	1	5	0	25	0	0	0	1	5	0	2	0	0	4	0	0	24	0	7	5	0	1	1	0	0	2	0	0	5	0	1	0	1	0	0	0	0	0	0	1	0	0	2	4	0	0	0	0	4	0	7	0	4	1	0	2	0	0	0	4	3	0	0	0	1	1	0	0	0	0	0	0	0	3	0	0	2	0	0	1	0	0	0	0	0	1	0	0	0	1	0	1	0	0	0	1	0	0	6	5	1	0	0	0	0	0	0	0	0	0	5	0	0	0	0	0	2	0	0	4	2	0	1	0	10	0	0	0	0	0	3	2	4	0	0	0	0	1	5	1	0	0	1	3	1	6	0	0	0	0	0	5	0	0	0	0	1	0	2	0	1	0	6	0	3	6	13	0	5	0	0	9	0	0	10	0	1	3	1	2	0	3	0	6	2	5	1	0	0	0	1	4	0	0	0	2	0	0	0	1	3	1	0	0	0	0	0	0	8	0	0	0	0	0	0	0	4	0	0	0	0	0	0	0	1	4	0	1	6	0	2	3	0	0	0	5	0	0	0	0	7	0	11	0	0	2	0	3	4	6	0	0	2	0	0	0	0	0	1	0	2	0	0	0	0	1	0	0	2	2	1	4	0	2	4	0	0	1	1	0	2	5	3	0	0	0	3	0	0	1	1	1	2	1	6	0	0	0	2	0	0	0	3	0	0	0	0	1	7	1	0	0	0	0	0	0	0	0	0	0	0	1	0	0	18	0	3	2	3	1	0	3	0	1	3	0	0	0	0	1	0	0	0	1	1	1	9	0	0	0	0	1	0	0	0	0	0	0	0	0	1	0	1	2	0	5	2	0	0	1	0	0	5	0	2	2	0	0	0	2	0	3	0	0	7	3	0	0	0	0	6	1	4	3	0	1	1	5	0	0	0	0	1	13	28	3	1	1	4	11	2	4	0	7	8	2	15	4	5	2	4	2	1	6	4	11	4	7	11	14	1	6	0	0	0	0	0	0	0	3	0	0	2	0	6	2	0	0	0	7	0	0	3	0	1	0	16	1	1	0	3	2	3	1	1	0	2	4	0	0	1	0	0	1	0	2	0	3	4	1	2	1	0	0	6	4	3	0	0	0	2	0	3	0	1	5	8	1	7	1	8	6	9	12	0	2	1	0	6	6	3	0	0	3	5	0	1	0	0	1
PHYLLO13	18591	167	25	47	50	0	65	10	0	0	3	0	0	0	0	0	2	0	0	0	10	0	1	9	0	0	0	6	0	0	4	0	0	0	12	4	0	0	0	0	8	3	0	2	1	5	2	2	33	0	2	4	2	1	21	26	1	0	0	1	9	0	0	2	2	0	24	0	12	1	2	3	1	10	0	1	15	0	0	35	4	13	1	0	31	7	0	0	0	2	10	0	1	0	0	2	11	0	5	11	39	0	0	35	1	48	17	2	4	0	33	0	0	0	1	1	5	2	0	1	0	1	8	1	2	0	0	6	0	7	0	19	11	0	1	0	9	4	8	22	1	1	14	13	0	1	0	0	0	8	0	3	1	1	0	0	0	0	2	0	1	1	3	31	11	22	14	0	0	8	32	0	0	4	0	0	1	2	0	1	2	6	19	0	0	0	0	0	1	1	1	3	53	0	2	0	7	0	0	0	0	0	0	2	0	23	23	1	94	2	0	0	0	1	2	0	0	0	1	0	6	6	3	0	0	0	0	1	20	7	2	0	0	0	0	1	0	0	10	0	0	0	1	1	4	9	4	2	0	14	9	0	2	3	0	0	0	0	0	5	0	1	0	0	9	1	0	0	1	0	46	1	2	0	0	0	0	0	0	2	0	6	0	4	0	0	0	0	3	0	0	1	0	2	4	0	0	2	1	1	2	2	0	4	1	0	8	4	1	19	0	0	0	3	1	2	0	0	0	2	11	2	3	1	5	1	1	1	0	0	0	0	16	0	0	0	14	4	1	1	2	16	0	0	1	0	24	37	8	2	0	108	11	31	0	0	0	3	30	11	0	8	0	0	22	5	4	30	20	0	27	1	1	51	1	0	1	3	0	24	1	24	6	0	18	0	0	20	1	3	0	0	0	0	0	1	0	0	0	0	0	0	23	5	2	0	0	24	19	0	0	0	3	0	1	7	5	72	55	10	4	14	1	10	0	0	0	4	13	4	0	3	15	0	0	0	0	0	0	0	9	1	1	1	3	1	0	0	0	1	5	0	1	0	0	0	28	0	0	2	0	0	0	0	0	0	0	0	0	14	1	2	7	0	17	17	0	1	12	0	0	10	21	4	1	3	0	2	14	21	0	0	10	6	1	4	2	60	64	7	1	0	2	3	1	0	18	0	0	0	1	0	9	0	0	4	0	0	75	24	0	25	0	1	9	2	3	0	0	21	0	1	0	1	8	0	30	34	14	0	3	7	0	10	0	8	26	1	1	9	3	0	0	0	1	4	0	0	3	0	0	1	19	2	0	0	0	18	1	0	0	0	0	0	0	2	0	4	0	1	0	32	0	4	15	39	0	7	0	7	2	8	160	17	0	0	2	1	13	222	8	0	3	11	1	36	3	2	1	6	1	0	8	4	0	46	0	0	8	7	0	1	12	58	8	8	34	1	1	0	1	1	0	0	13	7	5	16	0	1	8	0	2	5	1	0	0	138	0	5	14	1	0	32	1	108	1	0	1	9	0	0	0	54	7	2	1	3	0	23	1	0	2	3	12	6	2	0	4	8	1	5	4	6	0	3	9	0	8	1	7	1	8	2	28	9	0	6	10	7	0	6	0	5	0	0	0	0	6	0	0	0	10	2	0	3	4	8	6	3	12	1	18	0	0	1	19	0	0	0	1	0	5	8	0	0	1	58	5	1	9	16	15	2	15	33	12	9	0	5	4	1	11	8	0	20	20	0	0	0	4	0	44	0	15	0	1	72	31	4	2	106	19	0	0	7	1	16	0	20	0	5	4	0	41	1	32	4	0	2	0	12	3	20	0	11	8	1	0	0	0	0	0	1	0	5	0	0	0	8	1	6	11	16	7	3	0	17	0	23	1	4	4	1	0	2	9	14	2	25	0	1	0	3	28	0	0	1	5	1	48	15	3	5	1	0	0	23	9	0	9	3	2	11	1	41	0	0	10	5	0	27	38	42	49	2	2	1	0	0	10	0	84	2	1	0	15	0	1	2	0	0	28	0	14	3	0	1	1	0	1	15	0	0	0	0	0	21	6	0	0	12	0	1	0	1	0	0	0	0	0	0	0	1	0	0	4	1	0	7	0	1	1	6	27	5	10	0	0	43	14	19	11	1	2	2	2	26	2	0	6	0	0	0	0	2	5	5	10	13	9	14	0	2	46	1	3	12	5	7	28	30	0	0	2	0	7	3	3	4	0	0	1	1	1	16	9	20	0	41	7	1	0	12	20	0	0	39	14	0	6	3	11	0	12	0	0	0	6	30	42	0	28	2	50	17	14	18	4	1	3	0	1	0	0	12	2	5	1	0	0	1	20	13	1	16	1	1	10	0	0	2	7	8	2	24	0	14	16	22	20	5	0	4	9	0	0	0	0	0	0	6	1	1	0	11	8	0	1	4	0	0	8	8	0	2	16	3	2	1	14	3	3	3	3	28	5	7	8	0	13	6	22	6	0	3	1	4	2	0	0	0	1	1	4	1	0	0	64	7	1	4	0	1	0	0	1	3	5	0	9	7	18	6	44	1	1	0	0	2	0	2	0	0	1	0	4	5	4	2	0	0	0	163	0	9	19	0	0	20	26	0	13	94	33	10	33	0	16	0	18	1	6	4	18	7	2	19	11	19	2	4	63	38	3	10	12	0	5	16	1	0	5	4	24	0	9	4	1	6	1	52	14	24	0	1	0	31	0	0	10	0	14	271	13	0	1	0	11	0	0	304	4	0	3	49	0	7	19	16	0	0	15	0	1	0	2	0	0	0	0	0	6	9	0	11	23	30	6	0	23	3	11	1	0	2	18	45	13	3	0	0	16	0	1	3	0	11	9	13	7	0	18	1	1	25	112	12	13	4	1	0	9	3	0	0	1	4	2	16	7	4	0	0	0	0	8	0	5	0	0	0	0	18	0	2	1	5	0	0	0	1	2	10	17	61	32	9	28	1	10	0	0	11	12	5	1	2	0	1	1	0	7	8	5	1	97	0	2	2	2	9	23	9	2	34	5	12	0	0	0	0	0	0	34	25	3	20	6	4	19	6	4	0	1	9	6	7	0	24	1	0	0	0	7	0	0	17	5	1	1	1	0	0	2	0	1	0	0	1	0	0	0	21	2	5	0	1	7	12	1	0	1	14	2	1	6	20	12	1	0	0	2	13	0	7	0	0	3	0	0	3	0	4	64	7	1	0	0	1	2	0	0	0	1	2	1	10	0	0	0	0	0	30	2	0	6	42	8	30	5	7	11	5	9	3	1	0	9	2	3	6	3	0	0	0	0	0	6	30	1	18	1	0	0	2	0	1	1	0	0	0	0	1	8	2	0	0	1	0	13	2	1	5	0	0	0	0	0	14	2	0	4	1	0	8	0	16	0	0	11	0	2	39	1	2	3	0	8	71	17	19	0	1	0	35	3	39	0	1	0	4	19	0	1	16	5	0	11	2	0	0	3	2	0	0	1	0	0	0	1	0	1	12	1	3	37	0	0	0	0	14	1	1	2	0	1	0	0	2	20	0	0	2	47	0	0	0	31	3	0	4	0	0	5	0	0	69	0	1	0	2	0	0	2	0	0	18	0	14	9	30	3	0	0	3	0	5	9	0	0	92	1	0	0	0	0	1	0	1	0	2	0	0	1	0	6	1	1	7	18	4	1	0	1	2	9	4	1	7	30	13	18	0	0	1	0	5	4	1	6	9	15	1	12	0	0	3	1	14	0	10	1	5	6	0	1	6	1	4	39	1	13	0	0	0	0	0	0	0	2	0	1	11	19	0	0	0	0	7	1	1	0	3	0	0	0	6	0	0	0	14	24	1	18	5	10	0	0	2	5	3	0	0	7	13	5	2	2	1	0	4	7	7	0	0	6	29	2	11	1	0	0	15	4	1	6	0	11	4	6	10	2	0	2	2	3	0	1	0	1	1	0	6	2	29	233	21	3	5	2	0	43	2	3	9	2	0	0	15	37	1	0	3	2	3	7	0	1	1	147	3	2	20	106	1	3	74	0	3	11	5	2	1	14	23	0	32	17	3	19	15	20	9	0	2	19	1	61	2	1	1	8	34	0	2	1	2	2	0	1	113	1	50	54	2	0	3	0	4	14	0	2	47	3	4	0	2	0	1	0	1	7	2	1	1	7	1	21	2	1	1	1	8	3	27	1	16	14	0	15	1	0	2	32	24	0	3	8	16	9	3	0	4	0	1	3	7	18	0	2	1	0	1	10	3	0	1	1	8	2	0	0	0	1	0	4	0	0	6	0	4	0	23	34	5	4	2	0	0	5	0	0	0	0	15	0	0	0	1	0	14	0	1	9	23	0	1	0	30	0	8	0	0	6	8	2	4	9	0	1	2	24	44	27	0	0	10	3	12	23	7	0	5	0	1	30	0	0	5	0	10	0	3	0	2	0	26	0	23	34	57	7	23	2	0	119	2	3	38	0	3	15	6	14	0	4	0	30	24	8	2	2	1	0	7	12	0	0	0	0	0	6	2	2	12	2	0	0	0	0	0	0	60	0	1	0	40	2	1	0	1	3	0	0	0	0	11	0	0	31	0	2	23	14	7	7	0	0	0	20	2	0	0	1	13	0	23	0	3	8	0	15	19	22	3	0	23	0	7	0	0	4	4	0	2	4	1	0	0	1	1	1	10	9	10	17	3	0	9	0	0	1	1	0	15	21	8	2	12	0	22	2	10	2	0	8	6	1	14	0	0	0	3	4	0	1	20	5	2	2	1	11	0	2	2	1	2	0	0	2	17	0	0	0	0	0	0	0	84	2	15	6	5	4	0	9	3	9	3	7	1	0	0	4	0	0	3	5	15	13	44	0	0	0	0	0	0	7	5	1	0	0	5	5	2	0	2	0	1	26	8	10	21	0	3	4	21	0	0	7	2	1	0	25	2	83	15	0	12	27	2	2	0	30	13	4	13	14	0	0	8	6	6	0	0	3	4	54	172	0	3	13	24	33	26	17	4	42	32	14	34	28	43	26	32	27	7	27	38	54	61	35	62	60	15	58	0	0	0	2	3	0	1	2	0	0	9	1	56	4	2	0	0	24	0	2	0	0	4	2	73	14	3	1	20	9	23	4	13	8	1	26	1	8	10	3	0	18	9	9	0	27	20	6	20	2	8	1	7	27	3	3	2	11	43	8	18	0	12	26	38	37	27	9	41	74	29	80	0	19	0	3	26	41	24	21	7	20	27	0	1	0	6	23
PHYLLO14	8732	85	11	40	19	0	18	5	0	0	0	7	0	0	8	0	4	0	3	0	6	0	0	2	1	0	0	11	0	2	1	0	0	0	3	4	0	0	0	0	10	1	0	0	0	9	0	0	9	0	0	7	0	0	12	7	0	0	0	0	1	0	0	0	3	0	5	0	4	0	1	0	0	9	0	0	18	0	0	2	0	6	0	0	12	0	0	6	0	0	1	0	0	0	0	1	10	0	0	7	19	0	5	10	0	15	6	0	1	0	12	0	0	0	0	0	0	3	3	2	0	0	1	2	4	0	1	0	0	2	1	4	16	0	3	2	4	1	5	18	0	0	10	0	0	0	0	0	0	3	0	0	0	0	0	0	0	1	1	0	5	1	5	22	6	16	1	0	0	0	13	0	0	0	0	0	0	7	0	0	4	0	25	0	0	0	0	0	0	0	0	1	50	0	0	0	3	0	0	0	0	0	0	5	0	18	9	0	24	0	0	0	0	0	0	0	0	0	0	0	1	5	0	6	0	1	0	0	3	2	0	0	0	0	0	0	0	0	1	0	1	1	1	0	1	1	0	0	0	7	1	0	0	2	0	0	0	0	0	0	0	0	0	0	7	0	0	1	0	0	11	0	0	1	0	1	0	0	0	0	0	0	0	0	0	0	0	0	0	0	0	0	3	1	0	0	0	0	0	0	0	1	0	0	0	0	0	0	4	17	0	0	0	0	0	0	0	0	0	0	2	0	0	0	1	0	0	0	0	0	0	0	3	1	0	1	9	2	0	0	0	3	0	0	0	0	8	10	7	0	0	60	11	11	0	0	0	0	5	6	0	0	0	0	5	0	5	11	8	0	17	0	1	31	0	3	2	1	0	6	0	10	4	0	3	0	0	7	0	0	0	0	0	0	0	5	0	0	0	0	0	0	8	2	4	0	0	15	9	0	0	2	6	0	0	1	0	15	30	1	0	3	0	3	0	0	0	0	2	0	0	0	3	0	0	0	0	0	0	0	0	5	0	0	2	0	0	0	1	0	1	3	0	0	0	0	5	0	0	1	0	0	0	0	0	0	0	0	0	5	0	1	0	0	8	14	0	6	3	4	1	2	8	5	0	3	0	0	1	4	0	0	0	0	0	1	5	8	55	0	0	0	0	0	0	0	18	3	0	0	0	0	0	0	0	3	0	0	41	4	0	1	0	1	5	0	0	0	0	8	0	0	0	0	5	0	8	11	8	0	0	1	1	1	0	1	10	0	4	8	0	0	0	0	0	3	2	0	0	0	0	3	2	0	0	0	0	7	0	0	0	0	0	0	0	0	0	0	0	0	0	17	0	0	17	10	0	1	1	3	1	4	103	12	0	0	0	1	8	93	5	0	1	9	0	12	5	0	0	5	0	0	0	2	1	17	0	0	4	2	0	0	26	13	4	4	5	0	0	0	0	0	2	0	0	1	0	1	0	0	1	2	0	0	1	0	1	33	1	0	3	5	0	31	6	38	0	0	0	1	2	2	0	28	1	1	0	0	0	34	3	0	0	0	5	3	3	5	1	3	0	8	3	1	1	1	4	0	3	1	2	1	9	6	11	4	0	0	5	6	0	5	0	3	1	0	0	0	0	0	0	0	4	0	0	1	0	6	9	3	3	0	15	0	0	0	5	0	4	3	0	4	2	3	0	0	0	42	2	0	0	7	9	0	7	11	3	8	0	2	8	0	1	1	0	4	6	0	0	0	0	1	27	0	23	1	0	29	10	0	1	49	7	0	0	4	0	11	0	9	0	3	3	0	9	3	9	0	0	0	0	3	2	9	5	3	6	2	0	7	0	0	3	0	0	1	0	0	0	3	2	5	5	2	1	7	0	1	1	7	0	12	0	1	0	5	2	8	4	6	0	0	0	0	6	0	0	0	0	0	18	2	0	7	2	0	0	13	2	0	0	0	0	6	0	14	0	0	6	0	0	2	32	43	23	0	3	0	0	0	40	1	43	0	1	0	9	0	0	0	0	1	8	3	4	0	0	0	0	0	1	10	0	0	0	0	1	10	2	0	0	8	0	0	0	2	0	0	0	0	0	1	0	0	0	1	7	0	0	3	0	2	0	3	16	6	1	0	0	6	5	3	1	0	2	3	0	14	1	0	3	10	0	0	0	7	2	2	5	12	3	6	0	3	11	2	5	8	0	2	22	10	1	0	0	1	0	0	9	0	0	0	0	1	0	7	3	2	0	12	8	0	0	5	0	0	0	13	6	0	3	0	2	0	8	1	0	0	1	37	18	0	10	1	13	7	0	10	2	0	1	0	0	1	0	9	0	0	0	0	3	4	5	4	0	4	2	1	7	1	0	0	4	0	3	8	0	3	9	17	15	7	0	1	2	0	0	5	0	0	0	1	0	6	0	1	2	0	0	2	0	0	5	7	0	6	7	0	7	4	6	4	3	5	4	15	4	11	1	0	6	4	21	3	4	2	0	4	1	0	6	3	0	0	12	0	0	0	90	3	0	5	0	0	0	1	0	1	3	0	3	4	23	5	11	0	0	0	0	0	0	0	0	0	0	0	0	9	0	2	0	2	0	89	0	5	4	0	0	15	26	0	3	77	28	5	24	0	3	1	8	0	2	0	9	3	3	7	3	8	0	3	22	19	7	6	0	0	4	3	5	0	0	3	14	0	3	2	0	2	0	21	6	12	0	0	0	19	0	0	2	6	0	100	2	0	0	3	3	0	0	139	5	0	3	12	0	3	9	12	0	0	9	0	10	0	0	0	0	0	3	0	7	15	1	9	5	20	4	0	5	3	1	0	0	8	4	19	10	0	0	0	5	0	0	0	0	1	5	1	1	0	10	0	5	31	52	6	2	0	0	0	0	0	0	0	0	2	4	3	6	9	1	3	0	0	5	0	4	0	1	0	2	12	0	0	0	0	0	0	0	0	3	3	2	17	7	3	21	0	3	0	0	8	0	1	0	0	0	0	0	0	5	4	1	5	44	1	2	3	0	1	7	5	0	9	10	2	4	0	0	0	0	0	26	21	4	8	2	2	6	3	2	3	0	6	0	7	0	7	0	0	0	0	2	0	2	11	1	1	2	2	0	0	2	0	0	0	3	0	0	0	0	14	1	0	0	2	4	8	0	0	1	5	3	0	7	8	5	0	0	0	0	2	0	7	0	0	0	0	0	0	0	7	52	6	0	1	1	0	0	0	0	0	0	0	1	4	0	0	0	0	0	1	2	0	3	27	9	21	0	0	1	8	1	0	0	0	5	0	4	1	0	0	0	0	0	0	1	20	0	2	0	0	0	0	0	0	1	0	0	0	0	0	2	0	0	0	0	0	22	0	0	15	0	0	0	0	0	3	1	0	6	0	0	3	0	4	0	0	8	0	0	4	0	2	0	0	0	27	2	10	3	0	0	8	0	14	1	0	0	6	1	0	0	5	1	0	0	0	0	0	3	6	0	0	1	0	0	0	1	0	0	1	0	0	21	0	0	0	0	3	5	0	3	0	0	0	0	0	4	0	0	1	37	0	0	0	20	3	1	7	0	0	1	0	0	18	0	0	0	0	0	0	0	0	0	19	0	9	1	11	1	0	0	5	0	8	2	0	2	49	0	0	0	0	0	0	0	0	0	0	0	0	0	0	6	0	0	1	5	1	0	0	0	0	4	0	4	0	19	7	7	0	0	0	0	0	5	0	2	4	5	1	4	0	0	12	1	26	0	5	0	9	2	0	0	1	0	0	7	0	5	0	0	0	0	0	0	3	2	1	0	2	2	0	0	0	1	1	0	0	3	0	0	0	0	4	0	1	0	0	7	1	21	4	3	1	0	4	0	1	0	0	2	2	1	0	0	2	0	0	12	5	0	0	3	7	0	1	0	0	0	3	0	1	1	0	8	1	0	9	0	0	2	0	5	0	0	0	2	0	0	4	0	6	130	7	0	6	1	0	1	1	7	1	2	0	3	13	16	1	0	5	2	1	1	0	0	0	103	1	1	8	67	0	1	41	5	10	2	0	0	0	6	3	0	17	20	3	5	4	10	6	0	5	1	0	17	0	1	0	3	11	0	2	1	0	0	0	0	56	2	21	18	0	0	0	0	2	7	0	0	12	3	0	0	0	0	0	0	0	5	0	0	0	2	0	48	1	3	0	1	6	8	8	9	5	5	1	4	0	0	0	13	5	2	0	3	4	0	0	0	2	0	0	1	5	7	3	5	2	0	0	2	5	0	0	0	2	1	1	0	0	0	1	0	0	0	1	0	0	0	3	12	1	0	0	1	0	1	0	2	0	0	1	3	0	0	0	0	1	2	0	6	5	0	1	0	10	0	0	0	0	5	4	0	0	0	0	0	0	4	11	6	0	0	1	4	5	11	7	0	0	0	7	8	0	0	0	0	0	1	9	0	1	0	16	1	7	15	23	0	7	0	0	39	0	0	39	0	2	5	1	2	0	9	0	21	5	2	2	2	0	0	7	6	0	0	0	0	0	6	1	4	4	10	0	0	0	0	0	0	18	0	1	5	5	1	1	0	0	0	0	0	0	0	19	0	0	9	0	0	6	9	1	9	0	0	0	10	0	0	0	0	10	1	9	0	0	18	0	1	11	8	1	0	7	0	0	0	0	1	4	0	0	0	1	0	0	3	0	0	7	6	0	16	2	0	11	0	0	0	2	1	1	13	7	0	1	0	5	0	4	0	0	1	16	0	8	0	1	1	1	7	0	1	11	10	0	0	0	5	4	0	0	0	0	1	2	0	0	0	1	0	0	0	0	0	33	3	10	8	7	2	0	3	0	4	1	5	0	0	0	6	0	0	8	12	5	5	9	0	0	0	0	0	0	5	2	6	1	0	13	2	0	0	0	1	0	10	3	3	7	0	0	4	8	0	0	5	1	1	0	12	3	28	5	0	2	3	0	1	0	8	6	5	10	6	0	0	1	0	2	0	0	2	2	19	60	0	2	5	20	16	8	7	1	13	9	15	15	9	21	16	13	8	8	7	10	20	21	10	19	14	1	15	1	0	1	0	1	0	0	2	0	0	2	1	22	3	0	0	0	7	0	0	0	0	4	0	8	4	1	0	17	5	2	4	3	7	0	19	13	1	3	1	0	4	6	5	0	14	7	0	1	2	4	0	10	3	6	0	0	1	18	2	8	0	1	8	15	18	8	3	19	26	23	41	0	6	0	0	5	13	6	5	2	6	13	0	0	0	4	1
PHYLLO15	11249	116	10	35	40	0	30	0	0	3	0	2	0	0	3	1	0	1	1	1	8	1	0	3	2	0	0	7	0	0	3	0	0	2	12	7	0	0	0	0	5	1	0	4	0	9	0	0	21	0	2	3	1	0	13	6	0	0	0	0	9	0	0	2	0	0	9	0	9	0	10	4	0	13	0	0	12	0	0	14	1	13	0	0	25	3	0	0	0	1	2	0	1	0	0	1	14	0	0	7	19	0	0	9	1	27	23	1	4	0	13	0	0	1	0	0	0	0	1	3	0	2	4	0	1	0	0	1	1	3	0	9	18	0	0	1	1	0	6	11	0	1	7	4	0	0	0	0	0	4	0	0	0	4	0	0	0	1	5	0	0	0	2	13	13	18	11	0	0	2	8	0	0	0	0	0	0	1	0	0	1	3	8	0	1	0	0	0	0	0	0	3	42	0	0	0	0	1	0	0	0	3	0	1	2	13	19	0	38	3	0	1	0	0	0	0	0	0	0	1	1	2	1	1	0	3	0	4	11	5	0	0	0	1	0	0	0	0	7	0	0	0	1	0	2	0	0	0	0	8	6	1	3	2	0	0	0	0	0	3	0	0	0	0	5	0	0	0	0	0	22	1	0	0	0	0	0	0	0	0	0	1	0	0	1	1	0	0	0	0	0	0	1	1	0	1	1	0	3	0	2	0	0	1	0	0	0	0	1	16	0	0	0	2	2	2	0	0	0	0	2	0	2	0	3	0	1	2	1	0	0	0	1	0	0	0	12	2	0	0	0	11	1	0	0	0	10	15	4	0	2	77	10	10	0	1	0	0	15	7	0	0	0	0	13	0	15	15	15	0	12	0	1	26	0	3	7	3	0	8	2	18	3	0	4	0	1	7	0	0	0	0	0	0	0	0	0	0	0	0	0	0	16	9	1	0	3	3	7	2	1	0	4	0	0	0	7	55	32	7	1	20	1	1	0	0	2	6	5	1	0	1	4	0	0	0	0	0	0	0	4	2	1	2	5	0	0	1	0	0	2	3	0	0	0	1	12	0	0	2	0	0	0	0	0	0	0	0	0	11	0	0	1	0	7	2	0	5	4	2	1	2	7	4	0	0	0	0	5	8	0	1	5	4	1	6	1	24	35	0	0	0	0	2	2	0	16	0	4	0	0	1	1	0	0	7	0	0	37	2	1	4	0	2	1	4	3	1	0	15	5	0	0	0	2	0	25	9	7	0	0	2	0	6	0	1	9	0	2	5	0	0	0	0	0	0	0	0	0	0	0	1	6	1	0	0	0	3	0	0	0	0	1	0	0	1	3	0	0	0	0	23	0	1	10	18	0	0	0	1	0	6	50	5	1	0	3	3	19	101	8	0	1	6	0	26	6	0	1	2	1	0	1	0	0	30	0	0	4	4	2	0	14	42	12	7	20	0	0	0	0	0	0	0	11	5	0	7	0	0	6	0	1	4	0	0	0	54	0	1	0	2	0	30	1	58	0	0	1	5	0	0	0	26	0	1	2	0	0	14	4	0	0	1	6	2	1	0	1	4	0	4	1	3	2	1	11	0	1	2	0	1	9	2	10	1	0	1	4	1	0	4	0	4	1	0	0	1	7	0	0	0	11	3	0	0	6	7	3	3	3	0	12	0	3	0	17	0	3	0	2	1	6	7	0	0	0	18	1	0	1	13	5	0	5	24	7	12	0	3	3	0	10	3	0	9	7	3	0	0	0	0	38	0	14	0	4	44	17	0	3	56	10	0	0	6	0	5	0	7	3	1	4	0	16	5	14	0	0	3	0	4	0	14	4	8	12	3	1	0	0	0	3	2	0	4	1	0	0	2	0	1	11	9	6	1	2	3	0	12	0	0	0	0	0	3	5	20	6	14	0	1	0	0	22	0	0	2	1	0	22	0	1	12	3	0	0	14	3	0	4	2	0	4	5	24	0	0	2	1	0	15	31	29	16	2	0	1	0	0	22	0	59	0	0	0	5	0	0	0	0	0	18	0	7	0	0	0	2	0	1	4	0	0	6	0	0	7	0	0	0	8	0	0	0	0	1	0	0	0	1	0	0	0	0	0	0	1	0	5	0	1	0	1	11	11	4	0	4	18	12	8	4	1	5	3	0	6	1	0	4	3	0	0	0	4	3	2	10	7	6	6	2	3	31	3	14	11	3	3	13	14	0	0	0	1	4	3	1	1	0	0	0	0	0	17	5	14	0	21	10	1	2	13	13	0	0	25	23	1	6	0	3	0	3	0	0	0	9	35	30	0	16	3	19	9	2	6	5	0	0	0	2	0	0	16	3	0	0	0	3	1	6	6	0	7	3	3	4	0	0	0	0	5	3	20	0	8	9	10	22	0	0	1	15	0	1	2	2	0	0	9	0	1	0	8	2	0	0	4	0	0	9	1	0	2	5	1	3	3	9	2	13	3	1	21	4	9	7	0	13	5	12	3	0	4	0	1	0	1	2	0	0	0	1	0	0	0	93	3	0	1	0	0	0	0	2	1	4	0	2	2	9	2	14	1	0	0	0	0	0	0	0	0	0	0	4	0	0	0	0	1	0	74	0	3	12	0	1	13	24	0	5	69	37	3	34	0	8	0	12	0	5	4	5	4	5	7	3	13	2	3	54	24	6	7	6	0	5	5	1	1	0	6	13	1	12	2	0	7	0	26	3	17	0	0	1	8	1	1	10	2	1	173	4	0	0	6	1	2	0	211	5	0	8	31	0	1	7	19	0	0	14	0	3	0	0	0	0	0	1	0	4	10	1	6	8	14	0	0	12	1	7	0	0	6	13	28	13	2	0	0	12	0	2	0	0	6	7	7	2	0	18	0	3	25	78	13	9	3	0	0	1	1	0	0	0	2	7	8	6	2	0	0	2	1	3	0	6	0	0	0	3	12	0	0	0	0	0	0	0	2	2	2	8	14	11	6	40	0	4	2	0	10	1	8	5	0	0	0	0	0	5	6	0	9	41	0	2	1	0	3	13	4	5	10	8	4	5	0	1	1	0	0	18	8	3	8	7	0	7	4	2	1	0	5	0	4	0	6	0	0	0	0	5	0	3	9	1	0	0	0	0	0	1	0	0	0	0	0	0	0	0	15	1	2	0	0	1	5	7	2	0	2	4	0	4	20	0	0	0	0	0	1	0	7	3	0	3	0	0	0	0	2	37	10	2	0	0	0	0	0	0	0	0	1	5	8	0	4	0	0	0	3	3	0	4	37	3	20	6	4	4	3	3	2	0	0	4	1	2	2	2	0	0	0	0	0	5	19	1	7	0	0	0	2	1	0	1	0	0	0	0	0	3	3	0	2	2	0	16	0	0	3	0	0	4	0	1	10	2	0	2	1	0	2	2	5	0	0	5	0	0	24	0	0	2	0	2	32	15	10	0	2	0	15	0	18	2	0	0	9	5	0	0	5	4	1	3	2	0	0	3	3	0	0	1	0	0	0	0	0	5	10	0	1	14	1	1	0	0	4	2	0	4	1	0	0	0	0	3	0	1	0	34	0	0	0	10	3	0	4	1	1	2	0	0	25	0	1	1	0	0	0	0	0	0	12	0	10	8	18	1	1	0	0	0	10	3	0	0	84	0	0	0	0	0	0	0	0	0	0	0	0	0	0	7	0	0	0	11	2	0	1	0	1	2	5	0	7	17	3	6	0	0	1	0	2	1	1	2	11	9	6	4	0	0	5	2	18	0	10	1	4	8	1	1	3	0	3	8	0	10	0	0	0	0	0	0	0	1	0	0	7	20	0	0	0	0	0	0	0	1	0	0	1	0	6	0	0	0	7	13	1	14	1	8	0	1	4	4	2	0	0	4	7	0	4	1	2	0	0	4	0	0	0	10	12	1	8	0	1	0	5	8	0	2	0	5	1	2	9	0	0	2	2	5	0	1	0	1	4	0	9	0	11	114	10	0	4	2	0	7	0	4	3	6	0	3	23	13	3	0	4	2	2	2	0	0	0	125	0	1	15	63	1	0	48	1	9	3	2	0	1	5	11	0	18	7	4	11	5	18	6	0	1	1	0	34	1	1	4	2	12	0	3	0	0	5	0	0	71	0	42	24	0	0	3	0	1	7	0	0	41	2	3	2	7	0	0	0	0	3	0	1	0	3	1	12	3	3	0	1	8	10	12	2	8	5	1	4	1	0	5	16	14	0	0	9	9	2	0	0	7	1	0	0	2	6	2	2	0	0	0	8	0	0	0	0	12	1	1	0	0	0	0	0	0	0	5	0	0	0	13	21	4	1	2	0	4	2	0	1	0	0	3	3	0	0	1	0	3	0	0	5	10	0	1	0	18	1	10	1	1	10	0	2	1	1	4	1	3	11	10	19	0	0	3	4	6	13	7	0	0	0	0	7	1	1	1	1	7	0	0	0	1	0	20	0	4	21	40	4	16	0	0	45	0	7	22	0	2	6	2	5	0	1	0	11	6	8	5	1	0	1	6	10	0	0	0	0	0	3	0	5	3	4	0	0	0	0	0	0	22	5	1	1	11	1	0	0	0	0	1	0	0	0	4	0	0	14	0	4	10	6	1	10	0	0	0	18	2	0	2	0	16	3	4	0	0	14	0	5	14	14	1	0	15	0	2	0	1	3	7	0	1	0	0	1	1	1	1	0	5	4	0	10	6	0	4	0	0	0	1	0	0	17	13	6	1	0	9	2	9	1	0	4	8	6	15	0	0	0	0	7	0	3	26	1	0	1	0	6	5	0	0	0	1	0	3	1	2	0	2	0	0	0	1	2	50	2	17	4	5	6	0	2	0	9	2	4	0	3	0	1	2	0	4	9	6	5	31	0	0	0	0	0	0	3	2	0	3	1	2	1	0	0	0	5	1	20	1	6	16	0	0	7	11	1	0	0	0	1	0	16	3	44	6	0	10	4	0	2	0	9	8	0	3	11	0	0	1	3	3	0	1	1	5	61	113	0	1	9	13	18	13	12	8	40	21	23	32	8	33	10	35	15	8	10	40	28	35	21	43	43	2	30	1	0	3	2	6	0	0	0	2	0	1	0	37	0	0	0	0	19	0	1	4	4	8	1	47	4	0	0	16	3	15	1	10	7	0	13	3	1	7	2	0	13	8	16	6	14	10	2	11	1	7	0	9	7	6	2	2	7	22	3	7	0	4	28	13	18	27	4	16	42	22	46	0	19	0	1	22	27	24	8	10	7	21	0	0	0	2	9
PHYLLO16	12542	98	7	43	26	0	56	3	1	1	0	0	0	1	2	0	6	0	0	3	12	0	0	9	1	0	1	2	0	0	1	0	0	0	7	2	0	0	1	0	19	2	0	1	0	11	0	0	29	1	3	2	0	0	14	5	0	0	0	0	9	0	0	0	0	0	12	0	13	0	4	6	1	6	0	2	6	0	0	12	0	6	0	0	27	5	0	0	1	0	3	0	0	0	0	1	14	1	2	12	4	0	1	17	2	36	14	3	1	1	14	2	0	0	0	0	2	6	2	0	0	1	3	1	1	0	2	10	0	12	0	7	19	0	0	1	1	1	12	18	0	0	20	9	0	0	1	0	0	0	1	0	0	1	0	0	0	0	4	0	0	0	7	6	13	21	4	0	0	1	6	0	0	1	0	0	0	0	1	0	5	4	14	0	0	0	0	0	1	2	0	8	39	0	3	2	0	0	0	0	0	5	0	5	0	18	25	2	29	3	0	0	0	0	0	0	0	1	0	0	3	4	1	1	0	2	0	4	18	6	0	0	0	0	1	0	0	0	4	0	0	1	3	0	6	0	1	0	4	13	2	1	2	7	2	0	0	0	0	0	0	0	0	0	1	0	0	0	2	0	16	1	0	0	0	0	0	2	0	0	0	8	0	3	1	1	0	0	0	1	0	2	3	9	0	0	3	0	2	0	0	1	1	1	0	0	2	0	2	13	0	0	0	3	1	0	0	0	0	1	7	1	2	0	7	0	1	0	0	0	0	0	3	0	0	0	13	0	0	1	0	10	2	0	1	0	10	28	3	0	5	81	3	17	0	0	0	1	14	5	0	0	0	0	11	2	1	12	24	0	15	1	2	25	0	1	4	4	1	13	1	23	2	0	10	4	2	8	0	9	0	0	0	0	0	2	0	0	0	0	1	0	8	8	1	0	8	16	7	0	1	1	0	0	1	2	0	68	40	14	0	4	1	8	0	0	0	8	9	3	0	1	2	0	0	1	1	0	0	0	3	1	7	0	4	0	0	2	0	0	2	0	0	0	0	1	16	0	0	1	0	0	0	2	0	0	0	0	0	7	2	0	0	0	18	10	0	2	11	5	3	5	17	6	0	0	1	0	5	21	0	0	9	7	1	1	2	35	58	1	0	3	0	7	0	1	25	0	6	0	1	0	3	0	0	8	0	0	32	5	1	9	0	1	2	2	0	0	0	15	0	2	0	1	5	0	41	22	9	1	0	1	0	7	0	5	12	0	1	4	0	4	0	1	0	1	0	0	2	0	0	0	7	1	0	1	0	12	2	0	1	2	1	0	0	1	2	0	0	0	0	14	0	2	5	23	0	1	1	1	0	5	60	11	0	0	0	4	13	147	1	0	1	5	1	14	1	1	0	0	1	2	1	3	1	19	0	1	9	1	1	0	17	36	9	4	23	1	1	1	2	2	2	0	23	4	0	4	0	0	4	0	2	0	0	0	0	66	0	0	1	3	0	28	0	63	3	0	1	10	0	0	0	43	1	4	5	0	0	17	1	2	0	0	4	4	0	4	2	4	0	1	0	2	1	0	17	0	3	3	0	0	2	2	15	5	0	5	7	11	0	3	0	2	0	0	0	0	0	1	0	0	10	1	0	6	5	3	10	0	5	0	12	0	0	0	14	0	0	0	0	0	2	2	0	0	0	28	2	0	3	6	17	0	7	22	10	9	0	4	12	0	9	0	0	9	17	0	1	0	0	2	35	0	18	0	6	37	28	7	0	48	11	0	0	5	0	14	0	12	0	0	9	0	18	3	32	0	0	2	0	2	1	13	0	12	8	1	0	1	0	1	0	2	0	1	0	0	1	3	2	14	22	9	4	5	0	14	2	13	0	3	3	0	0	2	3	3	0	15	0	6	0	0	9	0	0	0	1	0	30	0	1	5	0	0	0	37	0	0	11	8	0	7	0	36	0	0	1	1	0	15	39	18	22	0	0	1	0	0	7	0	60	0	0	0	14	0	0	2	2	0	32	0	7	0	0	2	1	0	1	15	0	0	0	0	0	10	3	0	0	16	0	1	0	0	0	0	1	0	0	0	0	0	0	2	0	0	0	0	0	0	0	2	24	11	7	0	2	28	4	15	6	0	5	2	0	9	0	0	7	1	1	0	0	3	4	3	6	5	3	7	1	2	33	0	5	5	4	6	22	9	0	0	0	0	1	2	6	0	0	1	2	2	0	20	11	24	0	13	9	4	0	16	6	0	0	21	13	0	3	0	3	0	9	0	0	0	2	27	34	0	13	5	30	2	10	7	5	0	2	0	3	1	0	10	0	3	0	0	0	1	10	12	0	9	2	1	4	0	0	0	0	4	0	11	0	3	5	2	15	2	0	0	9	0	0	8	2	0	0	1	2	0	0	3	7	0	0	7	0	0	7	2	0	0	11	0	8	1	14	4	7	3	2	22	2	12	4	0	10	1	29	0	0	1	0	0	0	0	0	1	0	0	6	1	0	0	33	6	0	3	0	0	0	0	0	0	0	0	1	0	5	10	25	0	0	0	0	0	0	0	0	0	2	1	1	1	0	0	0	0	0	115	1	10	5	0	0	13	41	2	10	66	24	11	64	0	8	0	11	0	9	1	5	4	4	14	2	10	0	2	59	27	3	5	5	0	2	5	3	0	2	5	28	1	5	4	5	2	0	26	7	9	1	0	28	6	0	1	10	2	1	231	8	0	1	0	8	0	0	240	6	0	3	36	0	3	18	20	0	0	16	0	0	0	3	0	1	0	1	0	5	15	0	4	7	13	1	0	25	1	3	0	0	3	7	30	21	0	2	0	8	0	0	0	0	9	10	4	7	0	15	0	2	17	91	6	7	3	0	0	4	2	0	0	0	1	6	5	4	3	3	2	1	0	0	0	2	0	0	0	0	20	0	2	1	0	0	0	0	2	3	2	7	15	15	4	19	0	2	0	0	3	4	7	0	0	0	2	0	0	3	2	1	2	51	0	7	4	0	2	3	2	6	13	5	8	6	0	0	0	0	0	19	18	1	5	10	4	5	7	2	0	0	13	5	4	1	15	0	0	0	0	2	0	3	17	4	0	1	2	1	1	0	0	0	0	2	0	0	0	1	11	0	0	0	0	4	4	6	0	0	7	1	0	5	8	4	0	0	0	0	2	0	5	0	1	1	0	0	3	0	4	44	9	3	0	0	2	0	0	0	1	2	3	1	12	0	3	1	0	0	4	0	3	6	32	11	29	6	2	2	2	4	1	0	0	15	1	8	4	3	0	0	0	5	0	12	23	6	10	0	0	1	0	2	0	3	0	3	2	4	0	4	3	0	1	0	0	9	5	0	0	0	0	3	0	5	9	1	0	0	2	0	0	1	4	0	0	8	0	0	27	0	0	0	0	0	31	13	8	2	0	1	23	2	20	0	1	1	6	4	1	0	9	0	2	0	8	3	0	1	4	0	0	1	0	0	0	1	0	2	12	2	0	16	0	0	0	0	3	0	1	5	0	0	0	0	1	4	0	0	4	28	0	0	0	18	2	1	3	0	0	7	0	0	30	0	0	0	0	0	0	0	1	0	12	0	4	18	33	5	0	0	0	0	6	3	0	0	96	0	0	0	0	0	0	0	0	0	0	0	0	1	0	1	2	0	6	14	6	0	0	0	0	2	5	1	2	19	3	10	2	0	0	0	2	1	1	5	3	10	3	1	0	0	4	0	12	0	8	0	3	2	1	0	2	0	1	10	1	13	0	0	0	0	0	2	0	4	0	0	4	9	0	0	2	0	2	0	0	1	1	2	0	0	5	0	0	0	4	14	3	10	8	9	0	4	4	0	1	3	0	7	4	2	0	0	1	2	0	3	2	0	0	10	12	2	9	0	0	0	11	4	0	3	0	6	3	6	2	0	0	0	0	2	0	0	0	1	2	2	8	2	19	110	12	0	7	1	0	10	3	8	2	5	0	0	12	9	0	0	2	3	0	0	0	0	0	111	2	0	18	89	2	0	40	1	6	8	1	0	1	4	13	0	10	24	3	5	5	10	3	0	2	0	0	44	1	0	1	2	33	0	1	0	0	4	0	0	70	1	48	29	0	0	3	0	5	13	0	0	40	2	6	0	8	0	0	0	0	3	1	0	1	3	7	12	1	6	0	0	4	2	6	2	18	12	0	7	0	1	0	17	10	0	6	8	8	2	0	0	4	1	0	2	4	16	0	0	0	0	0	10	4	0	0	0	9	1	0	0	0	1	0	1	0	0	7	2	0	0	11	18	0	0	5	0	1	0	2	2	0	0	4	3	0	0	5	0	5	1	2	7	12	0	0	0	10	0	2	0	1	1	0	1	4	0	0	2	5	5	25	15	0	0	3	2	14	15	6	0	1	0	3	22	0	0	0	0	7	1	3	0	1	0	28	0	10	27	23	7	11	0	0	71	0	1	22	0	1	5	3	3	0	5	1	26	3	8	7	1	0	0	5	3	1	0	0	0	0	3	0	7	3	4	0	1	0	2	0	0	43	0	0	2	11	4	0	0	0	3	0	0	0	0	0	2	0	24	0	1	18	6	2	12	0	0	0	15	1	0	0	0	6	4	18	0	1	22	0	15	16	22	2	0	15	0	8	0	1	2	6	0	0	1	0	1	0	0	0	0	6	6	0	9	0	1	11	0	0	2	1	1	3	20	5	2	5	1	7	1	7	2	0	2	4	2	7	1	0	1	7	8	0	0	29	5	0	0	0	6	3	0	1	1	0	0	3	1	4	2	0	0	0	0	0	0	57	4	11	7	12	3	0	8	2	8	2	4	0	0	0	0	0	0	4	9	3	6	17	1	0	0	0	0	0	10	4	1	0	1	1	1	0	0	2	0	0	25	2	10	16	0	0	2	17	0	0	6	0	0	0	4	2	52	8	0	10	6	0	2	0	38	11	1	11	11	0	0	5	4	6	0	0	1	9	58	164	0	1	6	19	44	7	14	4	31	29	27	18	5	25	15	32	12	16	11	33	46	54	32	33	37	6	27	0	2	0	3	1	0	2	2	0	0	4	0	46	7	0	0	0	37	0	3	1	0	6	1	42	4	2	0	14	5	26	4	13	2	0	20	0	6	4	3	0	16	11	16	0	16	6	3	13	0	5	4	9	14	3	9	0	7	26	5	17	0	1	29	25	10	21	7	19	51	14	79	0	23	0	1	25	28	14	19	8	12	46	0	0	0	4	8
PHYLLO17	3181	12	1	11	7	0	22	1	0	0	0	0	1	0	0	0	1	0	0	2	2	0	0	0	0	1	0	0	0	0	3	0	0	0	0	0	0	0	0	0	1	2	0	1	0	0	0	0	3	0	0	0	1	0	5	8	0	0	0	0	3	0	0	2	0	0	1	0	4	0	0	3	0	2	0	0	1	0	0	5	0	0	0	0	12	0	0	0	0	0	0	0	0	0	0	0	5	0	1	4	2	0	0	3	5	12	4	0	0	0	5	0	0	0	0	0	0	2	0	3	0	0	2	0	1	0	0	0	0	0	0	4	7	0	0	0	3	0	2	7	0	0	1	5	0	0	0	0	0	2	0	0	0	0	0	0	0	0	0	0	0	0	0	4	2	1	0	0	2	7	1	0	0	0	0	0	0	0	0	1	0	1	1	0	0	0	0	0	0	1	0	3	2	0	0	0	0	0	0	0	0	2	0	1	0	5	6	1	3	2	0	0	2	0	0	1	1	0	1	0	2	0	0	0	0	0	0	0	3	1	0	0	0	1	0	0	0	0	1	0	0	0	1	0	0	0	0	3	0	3	1	1	1	2	1	0	0	0	0	0	0	0	0	0	0	0	0	0	0	4	4	0	0	0	0	0	0	0	0	0	0	0	0	2	0	0	0	0	0	0	0	1	0	1	0	0	0	0	1	0	0	0	0	1	0	0	0	0	0	1	0	0	2	1	0	0	0	0	0	0	2	0	0	0	0	0	0	0	0	0	0	0	0	0	2	0	4	0	0	0	0	3	0	0	0	0	2	8	4	0	0	15	2	5	0	0	0	0	3	1	0	0	0	2	4	0	0	2	3	0	2	0	1	21	0	0	1	0	1	6	0	8	0	0	0	0	0	2	0	0	0	0	0	0	0	2	0	0	0	0	0	0	0	1	0	0	0	6	3	0	1	0	1	0	0	2	0	17	9	6	0	6	0	2	0	0	0	2	10	2	0	0	0	0	0	0	0	0	0	0	1	0	0	0	1	0	0	0	0	0	0	0	0	0	0	0	4	0	0	1	0	0	0	1	0	0	0	0	0	2	0	0	0	0	5	4	0	0	0	1	0	1	5	0	0	0	0	0	6	7	0	0	0	0	0	0	0	8	16	4	0	1	0	2	1	1	2	0	1	0	0	0	0	0	0	2	0	0	4	6	0	4	0	0	0	3	0	1	0	3	0	0	0	0	0	0	7	9	0	0	0	0	0	2	0	0	3	0	0	5	0	0	0	0	0	0	0	0	0	0	0	0	1	0	1	0	0	1	0	0	1	0	0	0	0	0	0	0	0	0	1	6	0	0	0	4	0	0	0	0	0	0	15	4	0	0	0	0	3	42	0	0	3	0	0	1	0	1	0	0	0	0	1	1	3	10	0	0	0	0	0	0	2	15	2	0	4	0	0	0	1	0	0	0	3	5	1	1	0	0	3	0	4	1	0	0	0	23	0	0	0	1	0	1	0	16	0	0	1	0	0	3	0	7	0	0	0	0	0	1	0	2	0	0	2	0	1	0	0	0	0	0	0	0	0	0	0	0	0	0	0	0	0	0	1	2	0	0	2	1	0	1	0	0	0	0	0	0	0	0	0	0	2	0	0	0	1	0	0	0	0	0	1	0	0	0	0	0	0	0	0	0	2	1	0	0	0	9	2	0	2	5	2	0	1	9	2	2	0	0	1	0	1	3	1	6	4	0	0	0	0	0	12	0	3	1	0	16	4	0	1	5	1	0	0	0	0	3	0	4	0	0	5	0	2	0	13	0	0	0	0	2	2	7	1	3	5	1	0	0	0	0	0	0	0	4	0	0	0	1	0	1	2	1	0	1	0	3	1	3	0	2	1	0	0	0	1	1	0	0	0	1	0	0	3	0	0	0	0	0	10	3	0	3	0	0	0	7	0	0	0	1	0	1	0	15	0	0	0	0	2	5	8	9	6	0	0	0	0	0	0	0	14	0	0	0	4	0	0	0	0	0	10	0	0	1	0	0	1	0	1	4	0	0	0	0	0	0	2	1	0	7	0	0	0	0	0	0	0	0	0	0	0	0	0	0	0	2	2	0	0	2	0	0	1	0	2	0	0	5	0	5	1	0	0	0	0	1	0	0	1	0	0	0	0	0	0	1	0	0	5	3	0	0	10	0	3	1	0	0	3	2	0	0	1	0	0	1	0	2	0	0	1	0	0	2	3	6	0	6	0	0	1	10	0	0	0	4	3	0	1	0	0	0	2	0	0	0	2	10	2	0	6	1	9	1	1	2	2	0	0	0	0	1	0	4	1	1	0	0	1	1	3	1	0	1	0	0	1	0	0	0	0	0	1	2	0	0	1	6	3	0	0	0	1	0	0	0	0	0	0	0	0	0	0	1	2	0	0	0	0	0	1	0	1	0	0	0	0	0	1	0	2	1	1	4	1	3	0	0	0	0	4	0	0	0	1	1	0	0	0	0	0	0	2	1	0	0	2	2	0	0	0	0	0	0	0	1	0	0	0	0	1	0	12	0	0	0	0	0	0	0	0	0	0	0	0	0	0	0	2	0	0	24	1	3	1	0	0	2	10	0	7	14	6	0	5	0	0	0	1	0	0	0	0	1	1	1	3	4	0	0	10	6	2	0	1	0	1	1	0	0	1	0	2	0	0	2	1	0	1	11	0	0	0	0	2	8	0	0	2	0	0	57	0	0	0	0	0	0	0	47	4	0	0	15	0	0	0	0	0	0	4	0	0	0	0	0	1	0	0	0	3	2	0	1	5	4	0	0	7	0	3	0	0	0	3	12	3	0	0	0	2	0	0	0	0	4	1	0	0	0	4	0	1	4	14	3	0	0	0	0	2	1	0	0	1	0	2	1	0	0	0	0	0	0	0	0	0	0	0	0	0	2	0	0	1	0	0	2	0	0	0	0	3	4	2	0	6	0	0	0	0	0	0	0	1	0	0	0	0	0	1	0	0	1	6	0	0	0	0	0	0	0	2	3	1	0	1	0	0	0	0	0	0	6	0	2	0	1	1	0	1	0	0	2	0	0	0	3	0	0	1	0	0	0	4	2	0	0	0	0	0	0	0	0	0	0	0	0	0	0	0	5	0	0	0	0	0	0	5	0	1	0	0	0	1	0	1	0	0	0	0	0	0	3	0	0	0	0	0	0	0	2	12	1	15	0	0	0	0	0	0	0	0	1	0	2	0	0	0	0	0	1	0	0	2	12	1	4	0	0	0	0	5	0	0	0	5	1	0	3	3	2	0	0	0	0	3	6	0	7	0	0	0	0	0	0	2	0	0	0	0	0	1	3	0	0	0	0	2	1	0	0	0	0	0	0	4	4	0	0	3	1	0	2	1	1	0	0	0	0	0	6	0	0	0	0	3	5	2	2	0	0	0	6	0	6	0	0	0	0	5	0	0	1	1	0	1	0	0	0	0	0	0	0	0	0	0	0	1	0	0	3	1	0	5	0	0	0	0	1	0	0	1	0	1	0	0	2	0	0	0	1	8	0	0	0	1	0	0	3	0	0	3	0	0	16	0	1	0	0	0	0	0	0	0	2	0	0	1	12	0	0	0	0	0	0	0	0	0	29	0	0	0	0	0	0	0	0	0	0	0	0	0	0	0	0	0	1	1	1	0	0	0	0	3	0	0	0	4	1	3	0	0	0	0	0	0	0	0	1	3	1	2	0	0	1	0	2	0	2	0	2	0	0	0	2	0	0	2	3	0	1	0	0	0	1	0	0	1	0	0	1	1	0	0	3	0	0	0	0	0	0	0	0	0	1	0	0	0	2	4	2	4	1	12	0	2	0	1	0	0	0	0	0	1	1	1	0	0	0	3	0	0	0	4	0	0	1	0	0	0	2	0	0	4	0	0	0	0	0	0	0	0	0	0	0	0	0	0	0	0	2	3	2	27	10	0	1	0	0	1	1	1	0	0	1	0	3	0	1	0	1	0	2	1	0	0	0	22	0	0	4	16	0	2	17	0	0	1	0	1	0	3	11	0	9	4	2	0	4	4	0	0	0	1	1	6	2	1	1	0	5	0	1	1	1	4	0	0	22	0	9	3	1	0	4	0	1	4	0	0	7	1	0	0	2	0	0	0	0	1	0	1	0	2	0	1	0	0	0	5	1	1	2	0	1	1	0	0	0	1	0	2	4	0	1	2	1	1	0	0	0	0	0	1	0	0	0	0	0	0	0	4	0	0	0	0	2	0	0	0	0	0	0	0	0	0	1	1	0	0	7	6	0	0	2	0	0	0	0	0	0	0	1	2	0	0	0	1	1	0	0	5	6	0	2	1	2	0	1	1	1	5	2	0	4	0	3	0	0	2	6	6	0	0	3	0	1	1	0	0	0	0	0	10	0	0	0	0	1	0	2	1	0	0	11	0	0	8	10	2	4	0	0	13	0	0	3	0	2	1	0	1	0	1	0	6	5	4	3	0	0	0	0	4	0	0	0	0	1	1	0	0	2	3	1	0	2	1	0	0	16	0	2	2	1	1	0	0	0	0	0	0	0	0	2	0	0	1	0	0	2	2	0	4	0	0	0	2	0	0	0	0	2	0	3	0	0	5	0	0	6	9	2	0	2	0	0	0	0	0	0	0	0	0	1	0	2	0	0	0	1	0	0	4	0	0	4	0	0	0	0	0	0	7	2	1	2	0	5	0	1	1	0	0	2	1	2	1	0	0	2	3	0	0	3	0	0	0	0	1	1	0	0	0	0	0	0	1	1	0	0	0	0	1	0	0	5	0	1	1	0	1	0	1	2	0	2	0	0	0	0	0	0	0	2	1	1	1	9	0	0	0	0	0	0	2	1	0	0	0	0	0	0	0	0	0	1	5	0	1	1	0	0	1	1	0	0	6	1	1	0	6	0	5	2	0	3	9	0	0	0	24	2	0	0	6	0	1	0	0	8	1	0	0	0	10	28	0	3	0	1	4	7	1	1	5	3	4	4	1	8	6	11	5	2	3	9	14	17	15	10	11	3	19	1	2	0	2	2	0	1	0	0	0	7	1	13	6	0	0	0	5	0	0	0	2	0	0	9	1	0	0	4	5	4	1	1	1	0	5	1	0	3	0	0	4	3	6	0	3	2	1	1	0	0	0	1	6	0	0	0	0	13	0	3	0	0	4	2	0	11	0	18	17	4	21	0	2	0	0	9	13	16	5	1	7	2	0	0	0	4	5
PHYLLO18	2915	14	2	11	5	0	11	1	0	1	0	0	0	0	0	0	0	0	0	0	2	0	0	2	1	0	0	1	0	0	0	0	0	0	1	0	0	0	1	0	4	1	0	0	0	0	0	0	4	0	0	0	0	0	7	8	0	0	0	0	0	0	0	1	0	0	0	0	3	0	0	1	0	3	0	0	0	0	2	1	0	0	0	1	11	2	0	0	0	1	2	0	0	0	0	0	4	0	1	9	2	0	1	4	7	2	7	1	0	0	7	0	1	0	0	0	0	0	0	3	0	0	1	1	0	0	0	0	0	0	1	2	1	0	0	0	1	1	6	3	0	0	4	7	0	0	1	0	0	0	0	0	0	0	0	0	0	0	1	0	0	0	0	7	2	0	0	0	1	2	1	0	0	1	0	0	0	0	0	0	0	0	1	0	0	0	0	0	0	0	0	1	3	0	0	1	0	0	0	0	0	1	0	2	0	3	8	1	1	1	0	0	1	0	0	1	0	0	0	0	0	0	0	0	0	0	0	0	3	0	0	0	0	1	0	1	0	0	7	0	0	0	0	1	0	0	0	0	1	4	0	0	1	0	0	0	0	1	0	3	0	0	0	0	0	0	0	0	0	1	4	0	0	0	0	0	0	0	0	0	0	1	0	2	0	0	0	0	0	0	0	1	0	2	0	0	0	1	1	0	1	0	0	2	0	0	1	0	0	5	0	2	1	2	0	1	0	0	0	4	1	0	0	0	3	0	0	0	0	0	0	0	1	0	0	0	1	0	0	0	0	3	0	2	0	0	6	5	2	0	0	13	0	7	0	0	0	0	0	2	0	0	0	0	3	0	0	5	7	0	6	0	1	15	0	0	0	0	0	5	0	4	1	0	3	0	0	1	0	1	0	0	0	0	0	0	0	0	0	0	1	0	4	0	0	0	0	1	2	1	0	0	0	0	0	2	0	26	8	5	0	5	0	3	0	1	0	0	8	2	0	0	0	1	0	0	0	0	0	0	4	0	0	0	1	0	0	0	0	0	0	0	0	0	0	0	0	0	0	0	0	0	0	0	0	0	0	0	0	1	0	0	0	0	4	0	0	0	1	0	1	1	4	4	0	0	0	0	5	10	0	0	0	3	0	1	0	9	1	2	0	1	0	2	0	0	1	0	2	0	0	0	0	0	2	5	0	0	10	8	0	8	0	1	0	0	0	0	0	7	0	0	0	0	1	0	17	7	0	0	0	0	0	2	0	4	3	0	0	0	0	0	0	0	0	0	0	0	1	0	0	0	3	0	1	0	0	0	0	0	0	0	0	0	0	0	0	0	0	0	0	3	0	0	0	5	0	0	0	0	0	0	19	0	0	0	1	2	3	42	2	0	0	1	0	7	0	1	0	2	0	3	1	1	0	10	1	0	1	0	0	0	4	10	0	0	7	0	0	0	0	0	0	0	2	1	0	1	0	0	2	0	2	0	0	1	0	27	0	0	0	0	0	7	1	9	0	0	1	2	0	0	0	9	0	1	0	0	2	5	0	0	0	0	1	0	0	0	0	0	0	0	1	0	0	0	1	0	1	0	0	0	0	0	1	0	0	0	0	3	0	0	0	0	0	0	0	0	0	0	0	0	1	0	0	0	1	0	0	0	0	0	3	0	0	0	1	0	0	0	0	0	2	0	0	0	0	8	2	0	4	3	3	0	0	5	5	0	0	0	0	0	1	1	0	2	4	0	0	0	0	0	10	0	4	0	0	15	6	0	0	7	0	0	0	0	0	2	0	4	0	0	1	0	1	1	6	0	0	0	0	2	1	6	0	2	1	0	0	0	0	0	0	0	0	2	0	0	0	0	0	2	2	4	0	1	0	1	0	4	0	0	1	0	0	0	2	1	2	4	0	1	0	0	3	0	0	0	1	0	9	2	0	1	0	0	0	8	0	0	0	1	1	2	0	6	0	0	2	0	0	6	5	6	8	0	0	0	0	0	0	0	9	0	0	0	7	0	0	0	0	0	4	0	0	0	0	0	0	0	1	3	0	0	0	0	0	2	2	0	0	0	0	0	0	0	0	0	0	0	0	1	0	0	0	0	0	0	0	0	0	0	0	4	3	3	1	0	0	5	1	1	2	2	0	0	1	6	0	2	0	0	0	0	0	0	1	2	2	3	3	1	0	0	4	0	1	0	0	0	3	3	0	0	1	0	0	1	0	0	0	0	0	0	0	4	1	5	0	4	2	0	0	2	5	0	0	3	5	0	0	0	0	0	0	0	0	0	0	8	6	0	8	0	6	1	2	3	2	0	0	1	0	1	0	6	0	1	0	0	2	1	3	0	0	1	0	0	0	1	0	2	0	3	1	6	0	2	2	1	0	0	0	0	5	0	0	0	0	0	0	0	0	0	0	0	0	0	0	2	0	0	0	0	0	0	1	0	0	0	2	0	4	1	1	3	0	4	0	0	2	0	1	1	1	1	0	0	0	0	1	0	0	2	0	0	0	0	1	0	0	0	0	0	0	0	0	3	0	0	0	2	1	0	9	0	0	0	0	0	0	0	0	0	0	0	1	0	0	0	0	0	0	31	0	2	3	0	0	5	6	0	2	9	0	0	5	0	0	0	1	0	0	1	1	1	4	0	1	8	0	0	7	3	0	2	0	0	2	0	2	0	3	0	2	0	3	3	1	0	0	12	1	9	0	0	27	2	0	1	0	0	1	58	0	0	0	0	2	0	0	41	0	0	1	12	0	0	3	3	1	0	2	0	0	0	0	0	0	0	0	0	0	1	1	1	7	3	1	0	3	0	1	0	0	0	1	8	4	0	0	0	0	0	0	0	1	6	3	0	0	0	7	0	1	1	12	4	0	0	0	0	4	0	0	0	0	0	0	1	1	0	0	1	0	0	1	2	1	0	0	0	0	2	0	0	2	0	0	0	0	0	0	2	3	0	2	0	3	0	1	0	0	0	0	0	0	0	0	0	0	0	0	1	0	0	10	0	2	0	0	0	1	0	1	2	1	1	0	0	0	0	0	0	4	5	0	1	2	1	2	0	0	0	0	1	0	0	0	1	0	0	0	0	0	0	0	1	0	0	0	0	0	0	0	0	0	0	0	0	0	0	0	4	0	0	0	0	0	0	1	0	0	1	0	0	0	0	2	0	0	0	0	0	0	2	0	0	0	0	0	0	0	1	17	3	0	0	0	0	0	0	0	0	0	0	1	0	0	0	0	0	0	0	1	0	7	7	5	5	0	1	0	0	3	0	0	0	4	0	3	2	0	0	0	0	0	0	3	3	0	5	0	0	0	0	0	0	3	0	0	1	3	0	2	1	0	0	0	0	1	0	1	0	0	0	0	0	1	0	0	0	1	1	0	4	0	0	0	0	1	0	0	6	1	2	0	0	1	3	1	4	0	0	1	3	0	2	0	1	0	1	4	0	0	1	2	0	2	2	0	0	0	1	0	0	0	0	0	0	0	0	1	5	0	0	2	0	0	0	0	0	0	0	1	0	0	0	0	0	0	0	1	0	7	0	1	0	2	0	0	1	0	0	0	0	0	16	0	0	0	0	0	0	0	0	0	6	0	1	3	7	1	0	0	0	0	1	0	0	0	8	2	0	1	0	0	0	0	0	0	0	0	0	1	0	1	0	0	0	0	1	0	0	0	0	4	1	0	2	4	0	0	0	0	0	1	0	0	0	1	3	1	0	0	0	0	0	2	1	0	3	0	1	2	0	0	2	0	0	5	2	3	0	0	1	0	0	0	0	0	0	0	1	2	0	0	0	0	0	0	0	0	0	0	0	0	0	0	0	0	0	5	1	1	1	3	0	0	2	0	0	0	0	0	0	0	1	0	1	0	0	0	0	0	0	3	6	3	2	0	0	0	1	0	0	1	0	1	0	1	1	0	0	1	0	0	0	0	0	0	0	0	0	0	2	35	3	0	0	1	0	0	1	1	0	1	0	0	1	0	0	0	0	0	0	0	0	0	0	17	0	0	10	18	0	0	11	0	0	1	0	0	0	2	6	0	8	5	0	3	0	5	0	0	0	0	0	2	1	4	1	0	6	0	0	0	0	3	0	0	14	0	10	2	0	0	0	0	0	1	0	0	10	0	1	0	0	0	0	0	0	1	0	2	1	4	0	6	0	1	1	1	1	0	0	0	0	2	0	2	0	0	0	3	8	0	1	2	1	0	3	0	0	0	0	1	1	5	0	0	0	0	0	1	1	0	1	0	3	1	0	0	0	0	0	2	0	0	0	0	0	0	7	3	0	0	1	0	0	0	1	0	0	0	3	1	0	1	0	0	1	0	1	2	1	0	1	2	5	1	1	0	0	2	0	0	1	0	1	0	1	0	4	1	0	0	0	0	1	3	2	0	0	0	1	7	1	0	0	0	1	0	0	0	0	0	7	0	0	18	10	2	6	1	0	11	0	0	10	0	0	0	0	3	0	0	1	7	2	3	2	1	0	0	1	4	0	0	0	0	0	0	0	1	0	1	0	0	0	0	0	0	6	0	0	0	1	0	0	0	0	0	0	0	0	0	0	0	0	7	0	0	2	2	0	8	0	0	0	0	0	1	0	0	0	0	2	0	0	2	0	0	1	6	1	0	3	0	1	0	0	1	1	0	0	0	0	0	0	0	1	0	1	1	0	3	2	0	0	0	0	0	0	0	4	3	2	1	2	2	2	0	1	1	0	2	1	1	3	0	0	0	0	1	0	1	5	3	0	0	0	2	0	0	0	0	0	0	0	1	0	0	0	0	0	0	0	0	6	0	1	0	0	0	0	1	1	2	1	1	0	0	0	0	0	0	1	2	2	1	7	0	0	0	0	0	0	0	2	2	0	0	0	1	0	0	1	0	1	5	0	7	4	0	0	0	4	0	0	2	2	3	0	5	1	2	0	0	0	4	0	1	0	17	1	0	1	3	0	1	1	2	3	0	0	0	0	10	30	0	0	1	1	10	4	4	0	2	8	3	3	0	2	7	4	4	1	4	10	3	11	6	8	12	6	18	0	3	0	2	3	0	0	1	0	1	2	0	18	2	0	0	0	9	0	0	0	0	2	0	19	2	0	0	1	1	2	0	2	0	0	4	0	3	3	3	0	3	2	1	0	6	3	0	1	0	0	0	2	4	0	2	0	2	8	2	3	0	1	4	3	2	14	1	4	10	10	9	2	7	0	0	6	7	9	3	0	5	7	0	0	0	2	3
PHYLLO19	3498	32	6	15	6	0	10	0	0	1	0	0	0	0	1	0	0	0	0	0	1	0	0	0	0	0	0	0	0	0	2	0	0	0	3	0	0	0	0	0	1	0	0	1	0	1	0	1	6	0	0	0	1	0	7	3	0	0	0	0	2	0	0	0	2	1	2	0	2	0	1	5	0	1	2	0	0	0	0	2	2	0	0	0	5	1	0	0	0	0	1	0	0	0	0	0	10	0	0	3	1	0	0	6	2	9	1	0	0	0	9	0	0	0	0	0	0	0	0	3	0	0	1	0	0	0	0	0	0	0	0	5	3	0	0	0	1	0	2	8	0	1	2	2	0	3	0	0	0	4	0	0	1	0	0	0	0	0	0	0	0	0	0	1	2	2	1	1	1	3	2	0	0	0	0	0	0	0	0	0	0	0	3	0	0	0	0	0	0	2	0	1	6	0	0	1	0	0	0	0	1	0	0	3	0	7	6	0	7	6	0	0	0	0	1	0	0	0	5	0	1	1	1	0	0	1	1	0	2	2	2	0	1	1	0	0	0	0	1	1	0	0	0	1	1	0	0	0	0	4	2	0	1	2	0	1	0	0	0	2	0	0	1	1	1	0	0	0	0	1	8	0	0	0	0	0	0	0	0	2	0	5	0	1	0	0	0	0	0	0	0	0	0	0	3	0	1	0	0	0	0	0	0	0	0	0	0	0	0	1	0	0	0	1	0	1	0	0	0	1	2	1	0	0	1	0	0	0	1	0	0	0	0	0	0	0	4	1	0	3	0	1	0	0	0	0	2	6	0	1	1	21	6	5	0	0	0	0	5	3	1	0	0	2	7	0	1	5	4	0	0	0	1	21	0	0	0	0	0	5	0	4	2	0	4	0	3	2	0	0	0	0	0	0	0	0	0	0	0	0	1	0	3	0	1	0	0	3	1	1	0	0	0	1	0	0	0	22	7	1	0	4	1	2	0	0	0	3	2	3	0	0	2	0	0	0	0	0	0	0	0	0	1	1	2	0	0	0	0	0	0	0	0	0	0	0	3	0	0	0	0	0	0	0	0	0	0	2	0	4	0	0	0	0	1	0	0	0	1	0	0	1	4	4	0	0	0	0	5	7	0	0	3	4	0	0	0	10	21	0	0	2	0	4	0	0	4	0	2	0	1	0	0	0	0	1	0	0	12	11	0	1	1	0	0	1	0	0	0	3	1	1	0	0	0	0	4	9	1	0	0	1	0	1	0	1	2	2	1	0	0	0	0	0	0	0	1	0	1	0	0	0	2	0	1	0	0	1	0	0	0	0	0	0	0	0	0	0	0	0	0	1	0	0	0	4	0	1	1	1	0	1	22	2	0	0	0	2	2	48	2	0	1	3	0	6	1	3	0	0	0	2	1	2	0	10	0	3	3	1	0	0	5	13	0	2	1	1	0	0	1	0	0	0	1	1	0	1	1	0	2	0	0	0	0	0	0	17	0	0	0	1	0	11	0	23	0	0	0	4	0	1	0	11	0	1	1	0	0	6	1	1	0	0	1	0	3	0	1	0	0	0	0	0	0	1	1	0	0	0	0	0	2	0	7	2	0	0	5	1	0	1	0	0	1	0	0	0	0	0	0	0	4	0	0	0	0	2	2	0	3	0	9	0	1	0	6	0	0	0	0	0	1	0	0	0	0	4	1	0	0	2	5	0	1	4	2	5	0	0	1	0	1	1	1	3	2	0	0	0	0	0	4	0	1	0	0	13	4	0	0	16	6	0	0	0	0	0	0	1	0	2	0	0	3	0	9	0	0	0	0	2	0	2	0	1	1	0	1	0	0	0	0	0	1	0	0	0	0	2	2	2	8	3	0	0	0	3	0	7	0	0	0	0	0	0	2	3	0	2	2	0	0	0	7	0	0	0	0	0	9	2	0	0	1	0	0	12	0	0	1	1	0	4	0	6	0	1	1	2	0	7	6	12	6	0	0	0	0	0	2	0	24	0	0	0	4	0	1	0	0	0	6	0	1	0	0	1	0	0	0	1	0	0	0	0	0	0	1	0	0	3	0	0	0	0	0	0	0	0	0	0	0	0	0	0	0	0	0	0	0	0	0	0	5	3	0	0	1	5	1	1	3	0	1	0	0	5	0	0	2	2	0	0	0	0	0	2	1	1	1	2	0	1	4	0	0	5	3	4	8	3	0	3	0	0	1	0	0	3	0	0	3	0	0	9	4	3	0	8	1	0	0	6	1	0	0	2	11	0	1	1	2	0	1	0	0	0	0	22	8	0	4	0	5	0	1	1	3	1	0	0	1	1	0	5	0	1	0	0	2	0	5	3	0	1	0	0	0	0	0	0	1	2	0	2	0	0	2	6	7	0	0	0	2	0	1	0	0	0	0	1	1	0	0	2	1	0	0	2	0	1	1	2	0	0	2	0	1	0	0	1	1	1	1	0	0	1	1	0	0	0	5	2	0	3	0	0	0	0	0	0	0	0	0	0	0	0	13	2	0	2	0	0	0	0	0	1	2	5	0	0	4	3	6	0	0	0	0	0	0	0	0	0	0	0	3	1	0	0	0	0	0	50	0	1	1	0	0	1	5	0	1	14	4	4	10	0	0	0	5	1	1	3	3	2	0	0	0	4	0	1	13	8	0	1	3	0	0	1	1	0	4	0	5	0	2	3	0	0	0	2	1	11	0	1	12	41	0	0	1	0	1	43	0	0	0	0	2	0	0	49	4	0	0	19	0	0	6	6	0	0	1	2	0	0	0	0	0	0	3	0	1	2	0	2	8	4	2	0	4	0	4	0	1	0	3	7	4	0	0	0	5	0	0	0	0	6	0	1	3	0	5	1	2	2	22	10	3	0	0	0	1	0	0	1	0	0	2	1	0	0	0	0	0	0	1	0	1	0	0	2	0	1	0	0	2	0	0	0	0	0	3	2	4	9	0	3	3	0	0	0	0	1	0	1	0	0	0	0	0	0	0	1	0	4	4	0	1	0	0	0	2	2	0	2	2	2	3	0	0	0	0	0	6	3	0	9	3	0	4	1	3	0	0	1	3	3	0	5	0	0	0	0	1	0	1	4	1	0	0	0	0	0	0	0	0	0	0	0	0	0	0	6	0	2	0	1	1	1	3	0	0	3	3	0	0	2	0	0	0	0	0	0	0	0	0	0	0	1	0	0	0	0	17	2	2	0	0	0	0	0	0	0	0	0	1	1	2	1	0	0	0	0	0	0	1	6	2	6	0	1	0	1	1	0	0	0	1	0	0	0	0	0	0	0	0	0	0	3	0	2	0	0	0	0	0	0	1	0	0	0	1	0	0	0	0	0	0	0	4	0	0	0	0	0	2	0	1	2	0	0	0	1	2	2	0	1	0	0	4	1	0	3	0	0	4	0	1	10	3	0	0	0	0	2	1	7	0	0	0	0	1	0	1	4	0	0	0	0	0	0	0	1	0	0	0	0	0	0	0	0	0	0	0	0	2	0	0	2	0	1	0	0	0	0	0	0	0	0	4	0	0	0	11	0	0	0	4	0	0	1	0	0	0	0	0	9	0	0	0	0	0	0	0	0	0	4	0	1	5	3	0	1	0	0	0	2	1	0	0	17	0	0	0	0	0	0	0	0	0	0	0	0	0	0	2	1	0	3	1	0	0	0	0	0	0	0	0	1	10	1	2	0	0	0	0	1	1	0	0	4	0	0	0	0	0	1	0	1	0	3	1	1	0	1	0	0	1	0	7	3	1	0	0	0	0	0	0	1	0	0	0	0	1	1	0	0	1	0	0	0	0	0	0	0	0	1	0	0	0	0	2	1	9	0	1	0	0	1	0	0	0	0	4	0	0	0	0	0	1	2	2	1	0	0	0	5	1	2	0	0	0	2	1	0	1	0	2	0	0	4	0	0	0	0	2	0	0	2	0	1	0	0	0	3	52	7	0	1	0	0	7	0	0	0	0	0	0	2	8	1	0	0	2	0	2	0	0	0	28	1	0	12	10	1	1	14	1	1	1	3	1	0	1	5	0	8	0	0	1	0	2	3	0	1	0	0	9	1	3	2	0	8	0	0	0	0	1	0	0	15	0	13	9	0	0	4	0	0	1	0	0	3	2	4	1	2	0	0	0	0	0	0	0	0	3	1	5	0	0	0	0	1	0	4	0	0	3	0	3	0	0	0	7	4	0	0	0	2	1	0	0	1	0	0	1	1	1	0	2	1	0	0	2	0	0	2	0	3	2	1	0	0	0	3	0	0	0	0	2	0	0	3	4	0	0	0	0	0	0	0	1	0	0	2	0	0	0	0	0	1	0	5	3	1	0	0	0	8	0	0	2	3	1	0	1	1	0	1	0	0	4	9	3	0	0	2	0	5	5	5	0	3	0	0	6	1	0	0	0	0	0	1	0	0	0	20	0	3	10	8	3	2	0	0	21	0	1	9	0	0	1	0	3	0	1	2	7	6	2	3	3	0	0	2	0	0	0	0	0	0	0	0	3	0	0	1	0	0	0	0	0	7	1	1	0	8	1	2	0	0	0	0	0	0	0	2	0	0	4	0	1	0	6	0	2	0	0	0	1	0	0	0	0	1	0	6	0	0	2	0	2	2	8	1	0	5	0	1	0	0	0	0	0	0	0	0	0	0	0	0	0	0	5	0	0	0	0	4	0	1	0	0	0	3	3	0	0	1	0	1	0	2	0	0	0	3	2	6	0	1	1	0	2	0	0	9	1	0	0	0	6	1	0	0	0	1	0	1	1	0	0	0	0	1	0	0	0	10	0	1	0	1	0	0	1	0	6	1	2	0	0	0	0	0	0	0	1	1	0	4	0	0	0	0	0	1	1	0	0	2	0	5	0	0	0	1	1	1	10	3	4	4	0	0	1	1	0	0	0	0	0	0	3	4	4	1	0	2	5	1	0	0	7	0	1	5	1	0	0	0	0	0	0	0	0	4	13	36	0	1	2	6	6	7	2	3	6	2	2	3	4	4	8	9	1	0	1	8	12	18	3	12	12	5	12	0	1	0	0	1	0	2	1	0	0	4	0	14	1	0	1	0	5	0	0	1	0	0	1	13	0	0	0	10	1	1	1	1	4	1	3	0	0	1	0	0	3	0	2	0	2	4	0	2	0	1	0	3	9	0	1	1	0	9	3	6	0	0	6	5	2	14	0	12	9	5	16	0	3	0	1	3	7	12	2	0	5	4	0	0	1	2	3
PHYLLO20	1575	9	0	10	0	0	10	0	0	0	0	0	0	0	0	0	0	0	0	0	0	0	0	0	0	0	0	2	0	0	0	0	0	0	0	4	0	0	0	0	0	0	0	0	0	0	0	0	4	0	0	0	0	0	6	4	0	0	0	0	4	0	0	0	0	0	0	0	0	0	0	0	0	0	0	0	0	0	0	0	0	0	0	0	4	8	0	0	0	0	0	0	0	0	0	0	7	0	4	4	0	0	0	0	0	6	0	0	0	0	4	0	0	0	2	0	0	2	0	0	0	0	0	0	0	0	0	0	0	0	0	0	0	0	0	0	0	0	0	0	0	0	4	0	0	0	0	0	0	10	0	0	0	0	0	0	0	0	0	0	0	0	0	0	4	0	0	0	0	0	0	0	0	0	0	0	0	0	0	0	0	0	0	0	0	0	0	0	0	0	0	0	0	0	0	0	0	0	0	0	0	0	0	2	0	4	2	0	10	0	0	0	0	0	0	0	0	0	0	0	0	0	0	0	0	0	0	0	4	0	0	0	0	0	0	0	0	0	0	0	0	0	0	0	0	0	0	0	0	4	0	0	0	0	0	0	0	0	0	0	0	0	0	0	0	0	0	0	0	0	4	0	0	0	0	0	0	0	0	0	0	0	0	0	0	0	0	0	0	0	0	0	0	0	0	0	0	0	0	0	0	0	0	0	0	0	0	0	4	4	0	0	0	0	0	0	0	0	0	0	0	0	0	0	0	0	0	0	0	0	0	0	0	0	0	0	4	0	0	0	0	6	0	0	4	0	0	0	0	0	0	2	8	0	0	0	0	0	0	0	0	0	0	0	0	0	0	4	2	0	4	0	0	4	4	0	0	0	2	0	0	4	0	0	0	0	0	0	0	4	0	0	0	0	0	0	0	0	0	0	0	0	4	0	0	0	0	0	0	0	0	0	0	0	0	0	0	8	4	0	0	0	0	0	0	0	0	0	4	0	0	0	0	0	0	0	0	0	0	0	0	0	0	0	0	0	0	0	0	0	0	0	0	0	0	0	2	0	0	0	0	0	0	0	0	0	0	0	0	2	0	0	0	0	0	0	0	0	0	0	0	0	0	0	0	0	0	0	0	6	0	0	0	4	0	0	0	6	4	4	0	0	0	0	0	0	4	0	2	0	0	0	0	0	0	0	0	0	0	8	0	0	0	0	0	0	0	0	0	0	0	0	0	0	0	0	4	0	12	0	0	0	0	4	0	0	0	0	0	4	0	0	0	0	0	0	0	0	0	0	0	0	0	0	0	0	0	0	0	0	0	0	0	0	0	0	0	0	0	0	0	0	0	0	0	0	0	0	2	0	0	4	10	0	0	0	0	2	0	22	4	0	0	0	0	8	4	0	0	0	0	0	0	0	0	16	0	0	0	8	0	0	2	4	2	0	4	0	0	0	0	0	0	0	0	0	0	0	0	0	2	0	0	0	0	0	0	4	0	0	0	0	0	4	0	18	0	0	0	0	0	0	0	0	0	0	0	2	0	8	0	0	0	0	0	0	0	0	0	0	0	0	0	0	0	0	0	0	0	0	0	0	2	0	0	0	0	0	0	0	0	0	0	0	0	0	0	0	0	0	0	0	2	0	0	0	0	0	0	4	0	0	8	0	0	0	0	0	0	0	0	0	0	0	0	0	0	16	0	0	0	8	4	0	0	4	0	4	0	0	0	0	2	0	0	4	0	0	0	0	0	0	8	0	0	0	0	0	0	0	4	12	0	0	0	0	0	0	0	2	0	0	0	0	0	0	4	0	0	0	0	0	0	0	0	0	0	0	0	0	0	0	0	0	0	0	0	0	0	0	0	0	0	0	0	2	0	0	0	4	0	0	0	0	0	0	2	0	0	0	0	0	0	0	4	0	0	0	4	0	4	0	0	0	0	0	0	8	0	0	0	4	0	0	0	8	0	0	0	0	0	0	0	2	8	0	0	0	0	0	4	0	8	0	0	0	0	0	0	0	0	0	0	0	0	0	0	0	0	0	0	0	0	0	0	0	0	0	0	0	0	0	0	0	0	0	0	0	0	0	0	0	0	0	0	0	0	0	0	0	0	0	0	0	0	0	4	0	4	8	0	0	0	0	0	0	0	0	0	0	2	0	0	0	0	0	0	0	0	4	0	0	0	0	0	0	0	0	0	4	4	0	0	0	0	0	0	0	0	0	0	0	0	0	0	0	0	4	0	0	0	0	0	8	0	0	0	8	0	0	4	0	0	0	0	0	0	0	0	0	0	0	0	2	2	0	4	0	0	0	0	0	0	4	0	0	0	0	0	0	0	0	4	2	0	0	0	0	0	0	0	0	0	0	0	0	0	0	6	0	4	0	0	0	0	0	0	0	0	0	0	0	0	0	0	0	2	0	0	2	0	0	0	0	0	0	0	0	0	0	0	0	0	0	0	0	0	8	0	0	0	0	0	0	0	0	0	0	0	0	0	0	0	0	0	0	0	0	8	0	0	0	0	0	0	0	0	0	0	0	0	0	0	0	14	0	0	0	0	0	0	0	0	0	0	0	0	6	0	0	0	0	0	4	0	0	4	0	0	0	4	0	0	4	0	0	4	0	0	0	4	0	4	0	4	0	0	0	0	0	0	0	10	0	0	4	0	0	0	0	0	0	0	0	4	0	0	0	6	0	0	2	0	4	0	0	14	30	0	0	0	0	0	26	0	0	0	0	0	0	0	26	0	0	0	4	0	0	16	0	0	0	4	0	0	0	0	0	0	0	0	0	0	2	0	4	0	4	0	0	0	0	0	0	0	0	0	6	0	0	0	0	0	0	0	0	0	0	0	4	0	0	4	0	0	0	4	4	0	0	0	0	0	0	0	0	0	0	0	0	0	0	0	0	0	0	0	0	0	0	0	0	0	0	0	0	0	0	0	0	0	0	0	0	0	4	0	0	4	0	0	0	0	0	0	0	0	0	0	0	0	0	0	0	0	0	4	0	0	0	0	0	4	0	0	0	2	0	0	0	0	0	0	0	6	0	0	0	0	0	0	0	4	0	0	2	4	0	0	0	0	0	0	0	0	0	0	4	0	0	0	0	0	0	0	0	0	0	0	0	0	0	0	0	4	0	0	0	0	0	0	0	0	0	0	0	0	0	0	0	0	0	0	0	0	0	0	0	0	0	0	0	0	0	0	4	0	0	0	0	0	0	0	0	0	0	0	0	0	0	0	0	0	2	4	0	0	0	4	0	0	0	0	0	0	0	0	0	0	0	0	0	0	0	0	0	0	0	0	0	0	4	0	0	0	0	0	0	0	0	0	0	0	0	4	0	0	0	0	0	0	0	0	0	0	0	0	0	0	0	0	0	0	0	0	0	0	0	0	0	8	0	0	4	0	0	0	0	0	12	0	0	0	0	0	8	0	0	4	0	0	0	0	0	0	4	0	0	0	0	0	0	0	0	0	0	0	0	0	0	0	0	0	0	0	0	6	0	0	2	0	0	0	0	0	0	0	0	0	0	0	0	0	0	10	0	0	0	0	0	0	0	2	0	0	0	0	0	0	0	0	0	2	0	0	0	0	0	0	2	8	0	0	4	0	0	0	0	0	0	0	12	0	0	0	0	0	0	0	0	0	0	0	0	0	0	0	0	0	0	0	0	0	0	0	0	0	0	0	0	0	0	0	0	0	0	0	0	0	0	0	0	0	0	0	0	0	0	0	4	0	2	0	2	0	0	2	0	0	0	0	0	4	0	0	0	0	2	0	4	4	0	0	2	6	0	0	0	0	0	0	0	0	0	0	0	0	0	0	0	0	0	0	0	4	0	0	0	0	0	0	0	0	0	0	0	0	0	0	0	0	0	0	0	0	0	0	4	0	6	0	0	0	0	0	0	0	0	0	0	0	0	0	0	0	0	0	0	0	0	0	0	0	0	4	2	20	10	0	0	0	0	4	0	0	0	0	0	0	4	12	0	0	0	0	0	0	0	0	0	10	0	0	6	0	0	0	10	0	0	0	0	6	0	4	0	0	0	4	0	0	0	0	0	0	0	0	0	16	0	0	0	0	0	0	0	0	0	0	0	0	4	0	10	0	0	0	0	0	0	0	2	0	0	0	0	0	4	0	0	0	0	0	0	0	0	0	0	16	0	0	0	0	0	0	0	0	0	0	0	6	0	0	0	0	0	0	0	0	0	0	0	0	0	0	0	0	0	4	0	0	0	0	0	0	0	0	0	0	0	0	0	0	0	0	0	0	0	0	0	0	0	0	0	0	0	0	0	0	0	0	0	0	0	0	0	0	0	0	0	0	4	0	0	0	0	0	0	0	0	0	0	0	0	0	2	0	0	0	0	0	0	4	0	0	0	0	2	0	0	2	0	0	0	0	0	8	0	0	0	0	4	0	0	0	0	0	10	0	0	6	0	0	0	0	0	4	0	0	4	0	0	4	0	0	0	0	0	4	0	4	0	0	0	0	0	0	0	0	0	0	0	0	0	0	0	0	0	0	0	0	0	0	0	0	0	0	4	0	0	0	0	0	0	0	0	0	0	0	0	0	0	0	4	0	4	4	0	0	0	4	0	0	0	0	0	0	4	0	0	4	0	0	0	0	0	0	0	0	0	0	0	0	4	0	0	0	0	0	0	0	0	0	0	0	0	4	0	0	4	0	0	0	0	0	0	4	0	0	0	0	0	0	0	0	0	0	2	0	0	0	0	0	0	8	0	0	4	0	0	0	0	2	0	0	0	0	0	0	0	2	0	0	0	0	0	0	0	0	2	0	0	0	0	0	0	0	0	0	0	4	0	0	0	0	0	0	0	0	4	4	4	0	0	0	0	0	0	0	0	0	0	4	2	0	0	0	0	0	0	0	0	0	4	0	0	0	0	0	0	0	0	0	0	0	0	0	0	0	0	0	4	0	0	0	0	0	0	0	0	0	0	0	0	0	0	0	0	8	4	0	4	0	0	0	4	0	0	10	0	0	0	0	0	0	0	0	2	2	4	0	8	8	0	4	8	4	0	0	4	0	0	0	0	0	0	0	0	0	4	0	0	0	0	8	0	0	0	0	0	0	2	0	0	0	0	0	1	0	4	0	0	0	0	0	8	0	0	0	0	0	0	0	4	0	0	0	0	0	4	8	0	0	0	0	4	0	0	0	0	4	0	0	4	8	0	2	0	0	0	0	0	0	0	10	0	0	0	0	4	0	0	0	2	4
PHYLLO21	13910	115	5	32	42	0	54	3	0	1	0	0	0	0	1	0	2	0	2	3	14	0	0	5	1	0	0	3	0	0	3	0	2	1	7	8	0	1	0	2	17	1	0	0	2	0	2	1	29	0	0	8	0	0	22	18	0	0	0	0	11	0	0	2	2	0	13	2	12	0	1	0	1	15	0	1	12	0	0	11	4	10	0	0	29	6	0	5	0	2	6	1	0	0	0	3	8	0	0	11	24	0	0	20	6	45	10	1	1	0	24	0	0	0	1	0	3	2	4	4	0	1	4	4	0	0	2	6	0	7	3	17	13	0	0	1	3	2	9	18	0	1	11	8	0	0	2	0	0	4	0	1	0	0	0	1	0	0	1	0	1	0	0	20	4	12	7	0	0	2	30	0	1	1	0	0	0	0	1	0	0	5	23	0	0	0	0	0	0	0	2	3	62	0	0	0	6	0	0	0	0	5	0	9	0	5	23	2	54	5	3	1	0	0	0	0	0	0	1	0	1	2	1	1	0	0	0	2	17	0	0	0	0	0	0	0	0	0	12	1	0	0	2	0	3	5	0	1	0	10	3	0	1	6	0	0	0	0	0	3	1	0	0	0	12	0	0	0	0	1	29	1	0	0	0	0	0	0	0	1	0	2	0	2	0	0	0	0	0	1	0	0	1	2	0	0	1	0	1	0	1	0	0	0	0	0	2	0	5	18	0	0	1	0	0	5	0	0	0	2	4	0	1	0	7	0	1	0	0	3	0	0	5	0	0	0	15	2	0	1	2	4	0	0	1	0	13	26	15	2	0	76	7	25	0	0	0	0	11	10	0	1	0	0	20	0	4	21	22	1	22	4	7	36	3	3	1	5	0	19	4	21	9	0	5	2	1	10	0	3	0	0	0	0	2	1	0	0	0	0	1	0	16	9	1	0	2	12	3	0	0	0	5	0	0	2	2	57	38	5	1	13	1	5	0	0	1	6	8	3	0	0	7	0	0	0	0	0	0	1	2	4	0	1	5	0	0	0	2	0	3	3	1	0	0	0	14	0	0	3	0	0	0	1	0	0	0	0	0	7	1	0	5	2	12	11	0	0	10	2	0	1	10	6	0	3	0	1	12	17	0	0	5	6	0	0	1	20	25	1	0	0	0	5	0	0	17	1	1	0	0	0	4	0	0	1	0	0	44	19	0	20	0	0	4	3	4	0	0	16	2	0	0	0	3	0	22	20	18	0	0	0	1	8	0	12	11	0	0	7	0	2	2	0	2	2	0	0	0	0	0	5	13	0	0	0	0	18	0	0	0	0	0	0	0	0	0	0	0	0	0	17	0	2	12	12	0	2	0	2	2	5	129	19	0	0	4	6	6	148	6	0	4	6	0	31	3	0	2	1	5	2	5	3	1	54	0	0	4	2	0	0	15	44	13	6	23	2	0	0	2	0	0	0	14	7	0	4	0	0	5	0	0	1	2	0	0	89	0	2	4	4	0	32	2	67	2	0	0	16	1	1	0	53	2	2	3	3	0	8	2	0	0	1	6	5	3	2	3	0	0	1	0	0	3	3	11	0	7	1	3	0	4	1	21	11	0	1	3	8	0	6	0	2	0	0	0	0	9	0	0	0	17	4	1	9	8	10	4	0	4	0	10	0	1	0	17	0	0	0	0	0	2	14	1	0	0	35	4	0	4	6	8	0	4	20	9	6	1	1	5	0	8	3	2	20	11	0	0	0	0	0	45	0	24	0	0	45	29	0	0	94	21	0	0	3	0	6	0	17	0	7	15	0	27	4	29	0	0	4	0	11	2	23	2	7	7	0	0	3	0	0	0	1	1	1	0	0	0	0	4	7	7	9	1	3	2	11	5	29	0	2	14	1	0	3	8	9	3	10	0	1	0	0	19	0	0	0	2	0	33	6	2	6	0	0	0	14	5	0	1	5	2	5	2	20	0	0	5	3	1	17	24	38	29	0	1	0	0	1	25	0	50	1	0	0	19	0	0	0	3	0	15	2	4	0	0	0	1	0	1	15	0	0	0	0	0	10	3	0	0	7	0	1	0	0	5	1	2	0	0	0	0	0	0	3	0	0	0	2	0	0	0	3	14	11	8	1	0	17	7	9	6	0	2	1	4	14	2	3	3	2	2	0	2	3	3	5	3	15	8	15	0	4	43	8	17	11	6	2	26	13	0	1	0	8	4	7	6	4	0	0	0	0	0	21	11	7	0	20	11	10	4	23	12	2	0	21	13	0	10	0	12	0	1	0	0	0	3	36	31	0	25	0	36	5	4	12	1	0	0	0	3	1	0	10	2	4	0	1	1	4	13	15	0	11	1	0	4	0	0	0	1	9	0	19	0	2	11	18	13	4	0	1	10	0	0	4	0	0	0	5	2	0	0	8	6	0	0	10	0	0	2	10	0	1	9	2	2	3	10	3	5	10	3	18	6	5	12	0	6	2	20	11	2	3	2	5	4	0	0	0	0	0	4	1	0	0	69	6	0	2	0	0	2	0	1	3	11	0	1	0	6	5	21	2	0	0	0	5	0	0	1	0	1	0	3	7	2	0	1	0	0	132	0	11	5	0	0	9	27	0	16	70	21	5	41	0	8	0	9	1	5	3	8	1	2	5	9	18	2	2	58	29	2	4	6	0	4	14	7	0	5	5	15	0	6	7	0	11	0	36	10	25	0	0	12	29	1	0	7	0	6	200	2	0	0	2	1	0	0	242	4	0	1	36	1	4	14	14	0	0	17	0	3	0	1	0	0	0	0	0	4	5	4	7	7	23	2	0	28	1	9	0	1	3	24	38	26	1	0	0	3	0	1	0	0	5	8	8	2	0	15	1	4	34	93	13	7	1	0	1	12	1	2	0	0	4	9	4	3	2	0	0	0	3	4	0	8	1	0	0	0	25	0	0	0	0	2	0	0	1	2	9	13	34	16	6	38	0	11	2	0	8	5	3	0	2	2	0	0	1	3	7	1	2	55	0	1	3	0	0	11	6	1	15	11	9	0	0	0	1	0	0	25	26	11	7	5	2	9	7	6	2	0	8	0	5	0	11	0	0	0	0	5	1	4	14	6	4	4	0	0	0	1	0	1	0	1	3	0	0	1	17	2	0	1	0	6	6	4	0	1	3	1	0	10	13	10	0	0	0	2	1	1	10	1	0	1	0	0	0	0	3	51	9	4	0	0	1	0	0	0	1	0	5	0	4	0	9	0	0	0	5	2	0	9	42	8	32	5	2	0	6	5	3	2	0	6	0	2	3	1	0	0	0	0	3	3	15	0	19	2	0	0	0	0	0	4	0	0	0	1	1	2	0	0	0	1	2	9	0	0	3	0	0	0	0	1	7	1	0	3	1	0	8	4	10	0	1	11	0	0	21	0	5	1	1	3	55	16	17	0	0	0	21	1	23	0	0	0	4	12	0	0	9	2	1	8	2	1	0	0	8	1	0	1	0	0	0	2	0	5	8	1	0	23	0	0	0	0	6	2	0	2	0	0	0	0	1	13	0	1	1	58	0	0	0	25	1	1	2	0	0	5	0	0	49	2	1	2	0	1	0	1	0	0	10	0	8	6	17	3	0	0	1	0	1	2	0	0	67	0	0	0	0	0	0	0	0	0	0	0	0	2	0	9	0	0	5	20	1	1	0	0	0	8	3	5	11	16	6	17	0	0	0	0	2	2	0	2	8	11	2	4	0	0	4	0	20	2	9	0	3	5	0	0	2	0	0	28	5	22	0	1	1	0	1	0	0	0	0	2	2	10	0	0	3	0	12	1	2	0	0	1	4	0	4	0	0	2	6	20	4	14	6	7	0	5	3	6	1	0	0	3	6	1	1	2	4	1	1	11	4	0	0	7	16	2	9	0	0	0	12	0	0	1	0	11	1	6	9	3	0	1	0	2	0	0	0	1	1	0	5	0	16	139	22	0	9	3	0	42	2	10	7	2	0	1	10	26	2	0	4	4	6	3	0	0	0	115	3	0	14	83	1	1	63	6	17	8	1	2	0	10	15	1	27	13	2	21	4	14	6	1	0	8	0	50	0	1	3	3	14	0	8	4	1	7	2	0	96	1	52	30	0	0	3	0	4	10	0	0	23	1	1	0	4	0	0	0	0	3	4	0	0	5	1	22	0	2	1	1	12	6	15	0	11	8	2	6	0	0	3	16	7	0	0	5	12	3	1	0	4	0	1	6	4	13	2	5	1	0	0	10	2	0	0	0	5	2	0	0	0	1	0	2	0	3	4	2	1	0	13	23	0	1	3	0	3	0	1	1	0	0	0	3	0	0	0	0	6	0	2	7	13	0	0	0	26	0	5	1	0	2	0	1	3	0	3	1	0	10	24	9	0	0	11	1	11	28	3	0	0	2	1	27	1	1	2	0	8	0	4	0	0	0	20	0	13	39	27	1	12	0	0	64	0	1	34	0	0	13	1	9	1	9	0	22	9	16	8	1	0	0	1	3	0	0	2	0	0	16	0	3	2	6	0	0	0	0	0	1	43	1	0	2	19	1	1	0	0	4	1	0	0	0	9	0	0	18	0	1	12	14	3	9	0	0	0	7	2	0	4	0	4	0	18	0	0	11	0	4	9	24	0	0	16	0	6	0	0	3	7	0	0	4	0	0	0	0	0	0	9	6	2	16	3	1	23	1	1	2	2	1	0	18	5	2	8	0	11	1	9	0	0	2	5	4	13	0	1	4	8	9	0	0	23	2	0	1	0	3	2	3	1	3	0	0	3	4	5	0	0	0	2	1	0	0	50	6	14	7	5	4	0	11	5	15	6	5	0	0	0	1	0	0	2	18	7	7	24	0	0	0	0	0	0	6	2	0	0	0	6	2	1	0	2	6	0	12	3	9	13	0	0	7	13	0	0	2	0	0	0	15	0	46	10	1	7	9	0	0	0	18	9	2	7	7	0	0	0	3	7	0	0	0	9	39	152	0	8	11	15	31	23	7	0	33	21	20	28	24	32	10	36	11	11	15	27	40	42	25	39	51	4	39	1	1	0	1	4	0	0	9	0	2	6	1	51	1	0	0	0	30	0	0	2	0	5	0	43	7	2	0	10	12	5	5	17	8	0	20	2	4	9	2	0	12	7	8	0	33	7	1	16	1	1	0	13	15	2	3	0	13	25	7	17	0	4	23	30	25	26	5	27	54	20	97	0	16	0	0	12	26	24	7	7	20	33	0	0	0	2	10
PHYLLO22	9931	61	13	17	34	0	23	5	0	0	0	0	0	0	0	0	3	0	0	1	1	0	0	3	0	0	0	2	0	0	1	0	0	0	5	5	0	0	0	0	4	0	0	0	0	1	0	0	18	0	2	1	0	0	14	14	0	0	0	0	13	0	0	0	0	0	4	0	12	0	4	2	0	1	1	1	7	0	1	11	1	9	0	0	13	1	0	0	1	2	4	0	0	0	0	1	10	0	1	10	12	0	1	9	2	24	20	2	3	0	6	2	0	1	0	0	5	1	3	1	0	0	2	0	5	0	2	1	1	1	5	5	14	0	0	0	1	3	6	14	0	2	5	7	0	0	0	0	2	1	0	1	1	0	0	0	0	0	5	0	0	0	0	13	7	11	9	0	1	4	6	1	0	4	0	0	1	2	0	0	0	0	1	0	0	0	0	0	0	0	1	2	31	0	2	0	1	0	0	0	0	5	0	3	0	11	20	1	35	5	0	0	0	0	0	1	0	0	0	0	0	2	0	0	0	2	0	0	6	1	0	0	2	1	0	0	0	0	2	0	0	0	2	0	3	0	0	0	0	2	3	0	2	3	1	0	0	0	0	1	0	0	0	0	3	0	0	0	0	3	13	0	0	0	0	0	0	0	1	0	0	4	0	3	0	1	0	0	0	0	0	0	0	2	0	0	3	1	1	0	0	0	0	0	0	1	1	0	0	8	0	1	0	1	0	0	0	0	0	1	4	0	0	0	0	0	0	0	2	0	0	0	2	0	0	0	5	0	0	0	1	8	0	0	0	0	16	7	11	0	0	55	11	21	0	1	1	1	8	3	0	3	0	0	8	0	9	23	12	0	12	0	5	31	0	0	0	2	0	10	0	9	2	0	2	0	0	8	0	1	0	2	0	0	0	1	0	0	0	0	0	0	15	10	0	0	3	7	6	0	0	0	0	0	0	3	0	54	23	9	2	3	2	1	0	0	0	1	2	0	0	0	3	0	0	0	0	0	0	0	1	4	0	2	6	0	0	1	0	0	2	0	0	0	0	2	8	1	0	2	3	0	0	0	0	0	0	0	0	8	2	0	0	0	13	6	0	1	7	2	1	0	6	7	0	1	2	1	2	11	0	0	5	3	0	5	2	17	34	0	0	1	0	3	2	0	6	0	1	0	0	0	0	0	0	1	0	0	24	6	0	6	0	0	3	1	0	0	0	11	0	0	0	1	4	0	18	8	15	0	0	1	0	6	0	9	17	0	7	7	0	2	0	0	0	0	0	0	1	0	0	0	5	2	0	0	0	16	0	0	0	0	0	0	0	0	0	0	0	0	0	6	0	2	1	26	0	3	0	3	0	3	49	7	0	0	1	0	6	98	6	0	1	6	0	15	8	4	0	0	0	0	1	1	0	24	0	0	4	8	0	0	15	19	11	6	12	1	0	0	0	0	0	0	11	5	0	9	1	2	4	0	0	6	1	0	0	62	0	0	0	3	2	15	0	44	1	0	0	7	0	0	1	18	2	2	0	0	0	23	0	3	0	1	3	3	1	2	1	1	0	1	0	0	0	0	9	0	3	1	1	2	2	1	14	6	0	3	6	5	2	3	0	1	0	2	0	1	3	2	0	0	8	4	0	8	5	3	3	3	3	0	11	0	1	0	8	0	0	0	1	0	4	4	0	0	1	27	7	0	2	3	3	0	5	30	3	5	0	0	3	2	6	0	0	22	11	0	0	0	0	0	42	0	14	0	0	39	32	0	3	58	30	0	1	3	1	9	1	17	0	3	2	0	19	3	9	0	0	0	0	10	0	7	0	5	3	1	0	0	0	1	0	1	0	0	0	0	0	2	2	3	9	4	5	0	3	5	0	7	0	3	0	4	0	0	1	14	0	12	0	0	0	0	17	0	0	3	4	0	35	2	2	3	0	0	0	9	0	0	4	3	0	5	1	31	0	1	3	0	0	14	19	16	10	0	0	0	0	0	0	0	52	0	0	0	7	2	4	0	0	0	14	1	10	1	0	1	0	0	1	10	0	0	0	0	0	9	0	0	0	3	1	0	0	0	0	0	1	0	0	0	0	1	0	0	0	0	0	0	0	0	0	3	14	4	7	0	0	16	13	22	5	0	2	6	3	11	1	0	4	2	1	0	1	0	1	6	1	5	0	12	0	1	11	0	2	3	6	4	9	10	0	0	1	1	3	2	3	0	1	0	0	0	0	9	2	6	0	23	5	2	0	17	10	0	0	15	9	4	10	4	3	0	5	0	1	0	3	17	25	0	17	1	26	5	2	14	3	1	0	1	0	2	0	15	3	1	0	1	0	3	17	6	1	9	8	0	6	0	0	3	0	3	3	10	0	1	6	10	9	1	0	3	6	1	3	4	1	0	0	1	1	0	0	8	3	0	0	4	0	0	1	1	0	0	7	0	1	1	7	2	1	6	3	12	3	7	1	0	6	3	23	4	0	0	0	1	7	0	0	3	0	0	0	1	0	0	65	10	0	1	0	0	0	0	0	2	0	0	2	3	6	3	22	0	3	3	2	0	1	0	3	2	1	0	1	3	0	0	2	0	0	53	0	11	7	0	0	22	14	1	7	29	31	2	27	3	11	0	12	1	2	1	8	1	2	13	1	30	0	1	30	25	2	0	2	0	4	0	4	0	3	10	9	0	5	3	2	8	0	44	6	13	0	0	1	33	0	0	4	2	0	257	3	0	2	0	4	1	0	162	2	0	2	35	0	4	8	14	0	0	13	0	1	0	0	0	0	0	0	0	4	10	0	8	2	15	1	0	14	0	4	0	0	3	11	28	12	2	0	0	4	0	3	1	0	8	3	5	1	0	22	0	4	11	61	6	3	1	0	0	2	0	0	0	0	4	0	7	6	4	2	0	0	0	3	0	2	0	0	0	0	9	0	0	1	0	0	0	0	1	1	5	2	33	7	4	30	0	2	1	0	5	0	5	4	0	0	0	0	1	7	1	3	2	47	2	2	2	0	2	20	2	7	28	6	3	2	0	0	0	2	0	14	5	0	6	1	2	20	4	3	2	0	7	1	2	0	4	0	0	1	0	3	0	6	6	3	0	0	0	2	0	2	0	0	0	0	0	0	0	0	18	0	6	0	1	7	4	2	0	1	6	3	0	2	14	8	0	0	0	0	0	0	13	1	0	0	0	0	1	0	5	22	13	3	0	0	2	0	0	0	0	0	3	3	0	0	2	0	0	0	3	3	0	5	22	2	7	3	0	2	3	2	0	1	0	8	0	3	2	5	2	0	1	0	0	2	20	1	2	0	0	0	0	2	0	0	0	0	0	2	0	2	0	0	0	0	1	10	0	0	0	0	0	0	0	0	9	2	0	4	0	1	7	0	4	0	0	6	0	0	17	0	1	0	0	1	34	9	13	0	0	0	18	0	22	6	0	0	2	1	0	1	4	1	0	1	0	0	0	4	1	0	0	1	0	0	0	2	0	3	2	2	1	11	0	0	0	0	7	1	0	0	0	0	0	0	1	6	0	3	0	20	0	0	0	13	0	0	6	0	0	1	1	0	35	0	1	0	0	0	0	0	0	0	4	1	1	13	10	0	2	1	0	0	1	4	0	0	82	0	0	0	0	0	0	0	0	0	1	0	0	0	0	7	0	0	4	17	4	0	0	0	0	8	4	0	2	15	9	9	0	0	0	0	2	4	2	0	3	16	0	5	0	0	4	0	14	0	6	0	5	2	0	3	2	0	1	15	4	9	0	0	0	0	0	0	1	0	0	1	1	4	0	0	2	0	0	0	1	1	1	0	0	0	3	0	0	0	1	15	5	3	4	9	0	0	2	2	3	0	0	3	15	0	2	0	1	0	0	3	5	0	0	4	10	4	8	0	0	0	4	0	0	1	0	5	1	2	1	2	0	0	2	0	0	0	0	2	1	0	3	0	17	96	14	0	6	0	1	5	0	4	4	10	0	0	2	9	2	0	2	3	1	0	0	0	0	91	0	0	6	67	2	1	26	2	2	7	0	0	0	11	19	0	22	16	4	12	4	10	0	0	3	1	0	47	0	3	0	7	20	0	8	2	3	9	1	0	87	0	35	52	1	0	1	0	2	27	0	0	30	0	4	0	1	0	0	0	0	1	0	0	0	5	0	12	0	1	0	1	6	2	7	0	8	2	0	13	1	0	2	18	9	0	1	14	4	2	1	0	2	0	0	1	5	1	2	2	0	0	0	9	2	0	0	0	3	4	0	0	0	0	0	0	0	1	1	0	0	0	3	22	2	0	7	0	0	1	1	0	0	0	10	1	0	0	0	0	1	0	1	8	6	2	4	0	18	0	4	0	1	1	1	0	3	1	8	0	2	13	11	8	1	0	5	2	7	9	12	0	2	0	0	13	0	0	5	0	3	2	3	0	0	0	21	0	9	12	43	2	7	1	1	52	0	3	26	0	1	4	0	3	0	0	0	11	8	7	7	0	0	0	5	4	1	1	1	0	0	3	0	1	2	3	1	0	1	0	0	0	40	0	0	1	17	1	0	0	0	0	0	0	2	4	0	0	0	16	0	0	16	10	6	12	1	0	0	5	1	0	0	0	7	2	18	0	0	4	0	3	31	19	1	0	14	0	10	0	0	2	0	0	0	1	0	0	0	0	0	0	2	7	0	9	5	1	12	0	0	2	3	0	0	10	6	4	5	0	5	0	7	0	0	1	7	0	16	0	0	0	2	6	0	0	12	2	0	6	0	1	0	0	1	0	0	1	1	0	7	0	0	0	0	0	0	0	28	0	2	7	8	8	0	10	6	5	0	7	0	0	4	2	2	0	0	7	6	6	22	0	0	0	0	0	0	2	0	2	0	0	4	2	0	1	1	0	0	16	5	9	8	0	0	6	8	0	0	1	1	0	0	9	0	42	9	0	5	4	0	0	0	3	4	2	9	10	0	0	0	1	3	0	0	0	6	33	97	0	3	5	13	26	12	6	4	28	17	14	27	24	31	22	24	16	6	9	32	32	35	16	33	31	10	24	0	0	0	3	0	0	0	0	1	1	8	0	25	3	0	0	2	32	0	1	4	2	3	0	21	8	2	0	22	4	13	1	11	5	0	9	0	1	7	0	0	12	15	7	0	18	12	3	5	2	5	0	11	7	1	0	0	5	14	7	13	0	0	12	30	13	18	6	32	25	14	83	0	13	0	0	4	26	12	9	4	11	23	3	1	0	0	9
PHYLLO23	53986	463	30	123	106	1	196	15	2	8	3	14	0	0	4	0	6	0	2	4	21	1	0	32	3	0	0	3	0	0	34	0	0	0	45	12	2	3	1	0	18	1	0	4	3	21	1	5	85	1	1	8	0	4	51	64	0	1	0	7	26	1	1	1	11	0	51	4	47	0	6	15	0	28	0	1	49	0	1	66	5	28	0	2	109	39	4	3	0	1	36	0	1	0	0	10	135	1	25	48	34	0	4	105	4	117	34	2	20	0	66	3	0	0	1	0	8	4	5	6	1	9	16	3	14	0	3	3	0	5	4	54	87	22	3	5	12	5	51	110	0	3	67	33	0	0	1	0	2	23	0	5	2	3	1	0	2	2	7	0	3	0	3	65	38	60	50	0	0	6	64	0	1	1	2	3	1	5	3	0	10	9	101	0	0	0	0	0	3	1	3	23	197	1	4	0	0	0	0	10	0	19	1	15	0	79	92	12	189	5	5	2	0	0	0	0	2	2	5	0	12	10	27	4	0	1	0	7	61	10	0	0	2	2	15	1	0	0	23	0	5	5	3	0	15	0	3	0	2	25	17	0	17	18	0	4	0	0	1	20	2	1	0	0	9	14	2	0	0	3	83	9	2	0	1	0	0	1	0	0	0	14	0	3	0	0	0	0	0	7	2	5	16	4	2	0	15	2	13	0	1	3	1	3	0	0	5	0	8	53	1	1	1	5	0	13	0	0	0	0	27	13	1	0	25	0	2	2	1	0	1	0	15	0	0	0	60	3	1	1	1	53	0	0	3	0	45	142	40	4	0	373	16	76	0	0	3	7	69	19	2	0	0	0	73	1	6	82	75	1	45	2	6	94	0	2	5	46	1	95	4	133	4	0	44	2	20	49	0	10	2	6	0	0	1	5	0	0	2	0	0	1	51	27	5	1	8	51	25	9	0	1	5	0	5	3	17	252	179	36	3	31	2	16	0	0	0	85	12	0	1	2	13	1	0	0	0	4	1	1	8	17	1	2	21	1	0	9	1	0	11	13	0	0	2	0	61	2	0	30	0	0	0	0	1	0	0	0	0	18	1	0	3	2	41	52	2	2	26	9	2	23	102	30	0	1	0	1	41	106	0	0	50	26	3	8	2	125	162	10	1	3	0	28	8	1	69	0	17	0	1	0	25	0	0	36	0	1	153	55	5	16	5	3	9	3	5	3	0	56	11	0	2	7	32	0	130	153	82	0	2	2	0	18	1	36	57	1	8	19	0	18	0	0	1	3	3	0	4	0	0	8	28	0	0	0	0	66	6	0	0	4	0	1	0	14	2	0	0	2	0	86	0	3	45	46	0	4	1	5	3	19	356	28	0	0	9	49	69	545	44	2	28	49	0	115	28	0	0	3	2	6	4	7	0	174	0	1	42	19	4	0	49	173	22	35	65	1	0	0	2	2	20	1	48	17	0	26	0	0	18	0	1	4	1	0	0	367	2	1	0	12	0	119	10	294	1	0	5	14	0	2	0	164	17	12	6	9	0	66	7	3	4	1	43	19	1	10	19	17	0	7	1	13	6	0	49	0	23	6	6	4	28	11	62	22	0	2	35	33	0	30	0	12	0	0	1	0	24	1	1	1	41	7	0	34	15	11	35	6	16	0	54	0	4	1	53	0	2	2	0	5	32	32	0	0	0	162	6	0	23	48	59	0	41	95	52	44	1	11	26	1	30	4	2	73	37	0	1	0	1	1	168	0	63	0	9	214	81	9	4	261	55	0	0	11	1	32	0	75	0	11	35	0	50	12	105	0	0	15	0	32	1	95	6	73	30	3	2	2	1	2	8	5	2	15	0	1	2	7	9	48	33	46	12	18	2	52	3	65	0	7	20	1	0	2	18	20	15	61	0	2	0	2	102	0	0	4	5	0	160	7	0	37	0	0	0	110	0	0	32	18	2	20	2	120	0	1	11	5	3	78	211	96	96	4	0	2	0	2	43	0	278	0	0	0	85	0	2	1	4	0	112	3	29	2	0	0	0	0	24	65	3	0	0	0	0	43	7	0	0	39	1	1	1	2	2	0	1	1	0	0	1	0	2	0	0	3	0	10	0	3	0	10	92	36	41	0	15	108	46	54	25	3	11	18	6	89	3	0	13	0	0	1	1	3	10	23	40	61	35	45	0	2	88	14	21	24	17	29	62	73	2	6	1	2	12	11	5	10	3	3	1	4	4	75	24	54	0	103	22	0	1	93	33	0	2	112	46	0	24	2	24	1	29	0	0	0	8	199	105	0	84	13	113	40	14	29	11	0	2	12	5	2	0	77	4	2	0	0	5	1	47	24	0	35	8	13	24	1	1	1	10	16	11	51	0	33	43	41	70	5	0	10	33	0	10	6	1	0	0	24	4	1	0	26	12	0	4	27	0	0	31	31	0	3	41	7	15	8	61	8	16	9	9	72	9	33	16	5	21	15	93	11	2	7	0	2	5	0	0	4	4	1	29	1	0	0	180	11	0	6	11	0	0	0	0	4	9	0	16	15	55	57	61	0	0	1	1	0	0	0	0	0	0	1	2	30	0	0	0	2	2	436	0	28	36	0	0	46	102	0	42	182	104	55	112	0	36	0	53	1	9	2	51	20	17	30	27	69	4	8	210	123	9	21	10	0	11	44	16	0	44	20	67	1	44	21	3	24	2	144	19	62	1	0	12	24	1	1	24	16	3	873	13	0	1	3	5	2	0	866	18	0	5	139	1	5	45	57	1	3	102	0	5	0	2	0	0	0	3	0	30	29	13	39	31	110	8	0	51	9	26	3	4	13	48	93	71	1	0	0	43	0	0	2	0	61	39	30	24	1	86	2	7	70	297	23	25	2	0	0	35	5	0	7	0	12	22	36	10	34	0	0	7	1	14	7	8	2	1	0	2	50	1	0	2	5	3	0	2	2	5	29	49	57	54	13	144	2	7	2	0	24	16	20	4	1	4	2	1	0	16	14	3	8	240	5	21	5	1	28	52	11	25	79	33	24	3	1	1	0	0	0	74	69	0	67	24	15	21	20	7	5	0	38	4	17	0	47	0	1	0	0	6	0	8	77	9	5	2	0	0	3	12	0	1	0	5	6	0	0	0	55	7	3	0	2	24	33	50	0	2	23	9	0	28	29	15	0	2	0	2	9	0	35	1	0	0	1	0	0	0	11	197	41	7	0	2	1	1	0	0	7	1	14	10	38	0	5	0	7	0	28	5	0	42	127	39	87	13	7	6	32	7	5	1	0	72	3	14	8	12	3	0	0	4	1	34	72	2	62	1	1	0	1	0	0	7	0	11	1	3	1	13	3	0	1	5	0	33	1	2	5	0	1	2	2	4	32	9	5	16	12	0	26	1	28	0	0	36	1	12	81	0	8	4	0	7	183	24	49	3	6	2	95	1	72	5	0	0	25	13	0	4	59	10	2	11	35	10	0	2	17	3	0	2	0	0	1	9	0	10	31	4	3	106	1	1	6	0	19	21	1	8	0	1	0	1	3	18	0	0	0	126	0	0	0	61	10	3	21	1	1	34	0	0	146	0	0	2	0	0	0	0	0	0	46	0	14	57	100	12	2	0	0	0	15	8	0	1	387	3	0	2	0	0	0	0	4	0	10	0	1	0	0	5	5	2	27	49	15	0	0	7	5	11	9	3	12	91	25	55	2	0	2	0	4	7	1	21	48	24	15	24	1	0	16	5	70	0	70	5	29	18	23	3	5	0	6	62	8	26	1	4	0	0	5	14	2	5	1	12	68	54	10	0	4	3	6	2	10	2	7	1	4	0	11	0	1	0	26	71	9	47	37	42	0	10	12	2	9	5	0	23	22	4	1	2	17	0	2	22	12	1	2	24	69	14	36	0	0	0	45	13	0	10	0	32	7	17	19	6	1	11	3	7	0	3	0	3	12	19	19	20	39	598	98	0	11	2	0	59	3	30	12	12	0	6	53	85	13	0	10	15	3	1	0	3	0	400	0	0	104	260	11	3	233	4	17	57	3	11	0	32	91	0	90	56	2	42	38	25	26	3	9	29	3	141	36	6	7	16	97	1	17	2	0	4	0	0	337	3	185	122	1	0	10	0	14	29	0	0	115	10	24	2	28	4	0	0	3	9	3	1	1	19	4	43	1	16	1	5	50	27	34	6	67	39	3	35	0	0	19	106	82	5	11	21	60	1	0	0	12	0	0	1	32	39	9	7	5	0	0	34	4	0	1	0	26	10	3	0	3	2	2	0	0	0	22	15	0	0	26	88	8	2	3	0	0	10	2	9	0	0	15	4	1	0	5	0	18	0	2	38	55	0	3	2	72	0	13	4	1	16	12	1	28	3	4	2	7	42	92	24	0	1	24	7	81	93	38	0	3	1	5	100	5	0	5	1	43	0	11	1	3	0	131	2	33	124	162	29	57	10	0	277	3	9	138	2	1	32	6	45	11	11	0	103	35	85	22	5	0	0	38	32	0	0	1	1	0	18	1	20	16	19	0	0	0	0	0	1	203	4	12	3	66	0	1	0	2	1	0	0	0	0	12	0	0	83	2	1	83	46	5	45	0	0	1	35	23	0	1	1	48	12	108	1	0	61	0	9	90	65	8	0	82	0	24	1	2	23	13	0	2	6	1	0	3	5	0	1	23	47	1	28	11	2	67	0	16	0	12	0	4	56	21	37	15	2	63	2	37	5	0	15	13	5	38	0	0	4	17	80	0	3	105	8	0	0	0	43	7	0	5	0	0	1	29	1	15	16	5	1	7	14	0	0	239	5	34	29	27	8	2	33	5	36	9	20	0	1	1	4	0	2	32	31	14	43	66	0	1	3	0	1	0	28	9	1	11	1	12	7	8	2	4	14	1	74	26	39	43	0	0	8	48	1	0	8	2	1	1	58	10	222	38	0	40	79	2	9	1	128	37	4	29	41	1	2	13	5	15	0	1	8	51	217	523	0	19	28	78	160	75	54	2	131	95	73	110	70	116	73	144	65	29	61	136	220	214	106	172	180	19	136	0	5	0	14	26	2	4	7	0	1	25	0	205	34	0	0	0	126	0	7	6	2	28	4	163	56	1	0	88	23	47	22	64	25	0	102	15	33	32	39	0	40	28	38	0	80	54	5	68	7	10	1	59	91	18	11	1	36	120	19	67	2	3	70	95	49	83	38	118	184	66	307	4	59	2	1	52	139	121	51	69	59	94	1	1	0	20	24
PHYLLO24	11321	99	13	35	32	0	37	4	0	0	0	1	0	1	1	0	1	0	1	2	7	0	0	4	0	0	0	4	0	0	1	0	0	0	12	6	0	0	0	0	12	0	1	1	0	7	0	3	15	0	0	2	0	0	16	7	0	0	0	1	7	0	1	2	5	0	13	0	9	1	3	4	0	3	0	1	17	0	0	15	0	8	0	1	25	4	0	4	0	0	3	0	0	0	0	0	10	0	3	7	11	0	1	23	2	20	12	1	2	1	20	1	0	1	0	0	6	5	4	2	2	0	0	3	7	0	3	4	0	4	0	21	9	0	1	0	3	0	9	14	0	0	12	3	0	0	0	0	0	1	0	0	0	0	0	0	0	0	0	0	2	0	2	25	19	16	10	0	0	0	11	0	0	0	0	0	0	1	0	0	3	0	17	0	0	0	0	0	0	0	0	2	51	0	0	0	0	0	0	1	0	4	0	5	0	9	18	0	31	3	0	0	0	0	1	0	0	0	0	2	1	1	2	0	0	0	0	0	5	2	0	0	0	0	1	0	0	0	3	0	0	0	3	0	7	0	0	0	0	5	2	0	1	1	0	2	0	0	1	2	0	0	0	0	1	8	0	0	0	0	19	1	0	0	0	0	0	0	0	0	0	2	0	0	0	0	0	0	0	0	0	0	8	0	0	0	2	0	0	2	0	0	0	0	0	2	0	0	7	15	1	0	0	0	0	7	0	0	0	2	4	0	0	0	5	0	0	0	2	0	0	0	2	0	0	0	4	6	0	0	2	7	1	0	1	0	8	32	4	0	0	75	12	16	0	0	0	0	8	6	0	0	1	0	11	1	1	11	17	0	18	0	4	50	0	1	1	10	0	13	6	12	8	0	12	0	1	7	0	1	0	0	0	0	0	0	0	0	0	0	0	0	6	3	4	0	3	8	10	4	0	0	3	0	1	0	0	49	40	5	5	5	2	0	0	0	0	13	2	2	0	0	5	0	0	0	0	0	0	0	1	3	4	0	1	0	1	3	0	0	0	0	0	0	0	0	10	0	0	7	0	0	0	0	0	0	0	0	0	5	6	0	0	0	8	12	0	5	2	5	0	1	15	7	0	0	0	0	6	13	0	0	5	2	0	3	1	22	39	1	0	1	0	9	1	0	6	0	3	0	0	0	3	0	0	4	0	0	32	11	1	4	0	0	10	0	3	2	0	21	2	0	1	1	0	0	31	19	20	0	0	0	0	2	0	7	17	0	2	2	2	0	0	0	0	1	1	0	1	0	0	0	5	1	0	0	0	12	0	0	0	0	3	0	0	1	1	1	0	0	0	12	0	0	7	23	0	0	0	3	0	10	46	11	0	0	1	7	11	90	10	0	6	7	0	35	8	0	0	4	1	0	5	0	0	35	0	0	9	2	1	0	14	33	14	6	15	0	1	0	0	1	0	0	5	1	1	1	0	0	1	0	2	5	0	0	0	55	0	0	0	4	0	33	5	47	0	0	0	18	0	2	0	35	3	1	6	1	0	19	0	0	1	0	2	6	1	2	4	4	0	4	4	2	4	2	10	0	5	1	2	0	8	0	12	4	0	3	6	8	0	1	0	2	0	0	0	0	4	0	0	0	8	1	0	6	4	2	2	1	3	0	7	0	0	0	12	0	1	0	0	1	9	5	0	0	0	21	5	0	3	13	11	0	8	7	7	5	1	5	3	0	6	0	1	13	11	0	0	0	1	0	36	0	12	0	2	62	20	3	0	59	15	0	0	2	0	9	0	21	0	1	2	0	16	4	17	0	0	1	1	5	0	10	3	9	5	1	1	5	0	0	0	1	3	0	0	0	0	0	1	1	8	5	5	4	0	13	4	9	0	4	2	1	0	3	0	4	1	13	0	0	0	2	22	0	0	1	0	0	32	1	0	8	0	0	0	26	1	0	8	3	0	5	0	19	0	0	3	0	0	13	22	26	28	0	0	0	1	0	10	0	84	0	0	0	16	0	1	0	0	0	23	0	5	0	0	0	0	0	3	15	0	0	0	0	0	9	0	0	0	6	0	0	0	0	1	0	0	0	0	0	0	0	0	0	0	0	0	4	0	0	0	4	23	0	0	0	1	22	3	14	6	0	3	4	1	18	4	0	7	1	2	0	2	1	3	1	4	7	4	7	0	2	18	1	8	10	11	0	20	21	0	3	0	1	5	2	4	2	0	0	2	0	0	20	2	15	0	24	4	0	0	16	1	0	0	12	8	0	9	0	3	0	1	0	0	0	8	58	26	0	21	1	22	9	0	4	6	0	1	0	0	0	0	23	4	0	0	0	0	3	16	12	0	8	6	1	10	0	0	2	7	3	0	11	0	3	4	14	19	2	0	3	6	4	0	4	0	0	0	5	0	0	0	3	4	0	0	8	0	0	9	3	0	4	15	0	2	4	4	7	5	7	3	20	3	10	9	0	6	1	22	5	0	2	2	2	0	0	1	2	2	0	9	2	0	0	84	5	0	5	0	0	0	0	0	1	1	0	5	8	15	11	10	0	0	2	0	0	0	0	1	0	0	0	1	9	0	0	0	0	1	109	0	7	10	0	0	9	31	0	5	62	17	11	40	0	3	0	11	2	6	1	5	2	3	5	7	12	0	4	31	30	5	9	2	0	1	4	4	0	2	6	2	0	13	2	0	3	0	12	10	9	0	0	0	5	0	0	8	6	6	170	9	0	1	6	2	1	0	161	0	1	1	25	0	3	13	12	0	2	16	0	9	0	0	0	1	1	1	0	6	7	3	11	8	33	3	0	14	1	6	2	1	9	15	19	21	0	0	0	5	0	0	0	0	6	7	3	3	0	12	1	2	24	48	9	4	2	1	4	11	2	0	0	0	8	5	5	4	6	0	0	0	0	4	1	6	0	0	0	0	11	0	0	0	0	1	0	0	3	3	6	5	22	7	3	24	0	6	1	0	17	7	7	0	1	0	0	0	0	8	1	1	4	16	3	0	0	0	2	11	0	3	11	7	10	4	0	0	0	1	0	18	6	2	18	3	3	9	10	4	5	0	7	3	2	0	11	0	0	0	0	2	0	0	12	2	2	0	0	0	0	2	0	0	0	0	1	0	0	0	15	0	2	0	2	6	5	5	0	1	11	5	0	4	6	4	0	0	0	1	0	0	7	0	0	0	0	0	0	0	0	58	9	0	0	0	0	0	0	0	0	0	2	8	10	0	3	0	0	0	4	0	0	6	25	5	35	1	0	12	12	0	1	0	0	7	0	4	1	0	0	0	0	0	4	0	20	0	5	0	0	0	0	0	0	2	0	0	0	1	2	6	1	0	0	3	0	33	1	2	4	0	0	0	1	1	10	1	0	3	3	0	8	0	6	1	0	10	0	4	7	0	2	1	0	1	23	4	5	0	0	1	12	0	26	1	0	0	6	1	0	0	9	1	0	4	7	0	0	1	7	0	0	0	0	0	0	2	0	0	10	0	0	19	0	0	0	0	1	2	0	6	0	1	0	0	0	2	0	0	0	33	0	0	0	24	2	4	7	0	0	3	0	0	29	0	0	1	0	0	0	0	0	0	12	0	6	14	15	3	0	0	1	0	3	1	4	0	48	0	0	0	0	0	0	0	0	0	1	0	0	0	0	9	0	0	5	7	1	1	0	0	1	1	0	0	6	20	2	12	0	0	2	0	0	3	0	0	8	9	2	10	0	0	7	0	12	0	16	2	7	3	2	3	0	0	0	14	4	6	0	0	0	0	0	7	1	0	1	5	11	9	0	0	1	0	0	0	0	4	1	0	0	1	5	0	0	0	3	19	1	13	4	11	0	1	1	5	2	0	0	2	4	2	0	1	2	0	0	4	4	0	0	8	13	1	7	0	0	0	3	1	0	1	0	6	0	1	8	1	0	1	0	4	0	1	0	1	0	5	2	3	9	101	6	0	3	5	0	13	0	9	4	0	0	4	16	26	1	0	7	0	2	2	2	0	0	98	0	0	25	47	7	0	67	4	3	6	2	1	0	20	19	0	12	10	2	10	3	11	5	0	3	6	0	23	2	1	0	1	16	0	3	2	1	1	0	0	65	0	47	35	1	0	1	0	1	7	0	0	24	0	5	0	1	0	0	0	0	5	0	0	0	4	0	16	1	0	2	0	12	14	11	1	12	13	0	3	0	1	2	28	12	1	0	3	18	0	0	0	0	1	0	0	4	10	0	4	0	0	0	5	1	0	0	0	2	3	2	0	0	0	0	0	0	0	2	1	0	0	2	21	0	0	0	0	1	1	3	2	1	0	7	9	0	0	2	0	9	0	0	6	11	0	1	0	21	0	3	0	1	8	4	0	6	1	0	0	3	14	28	6	0	0	7	1	20	23	6	0	2	0	3	9	1	0	2	0	12	0	1	1	4	0	15	0	7	35	40	2	11	0	0	59	0	2	22	0	0	12	1	5	1	3	0	16	13	23	6	1	0	0	3	11	1	0	0	0	0	8	1	3	2	4	1	0	0	2	0	0	28	1	3	2	14	0	0	0	1	0	0	0	2	0	12	0	0	7	0	6	12	7	2	8	2	0	0	7	1	0	1	0	5	0	20	0	0	12	0	2	23	15	1	0	13	0	2	0	2	3	4	0	0	0	0	0	0	4	0	0	3	15	0	9	2	0	12	0	4	6	7	0	3	19	3	1	2	0	6	0	10	1	0	4	5	0	10	0	0	0	1	12	0	0	20	5	0	0	0	5	1	0	0	0	0	0	3	0	4	1	0	0	2	1	0	0	61	5	4	7	9	9	0	5	3	6	1	5	0	0	0	0	0	0	6	11	5	3	15	0	0	0	0	0	0	4	5	0	1	0	4	4	0	0	3	8	3	15	3	3	11	0	0	0	8	0	1	3	0	0	0	8	7	43	4	0	17	11	0	2	0	14	5	5	7	6	0	0	2	5	1	0	0	2	8	41	114	0	3	7	10	19	14	7	32	25	16	12	30	16	13	10	22	12	3	15	31	49	36	13	31	37	7	37	0	0	0	3	1	0	1	4	1	0	4	0	40	3	0	0	0	15	0	1	1	0	6	0	43	8	3	0	15	5	11	6	14	5	1	33	3	0	7	0	0	14	7	3	0	11	10	1	7	0	0	0	12	16	6	2	1	7	29	4	15	0	0	14	23	12	17	6	23	46	13	57	1	9	0	1	13	24	13	15	6	14	20	0	3	0	3	9
PHYLLO25	37587	280	29	97	67	1	151	11	0	4	4	9	0	0	2	0	11	1	2	5	32	0	0	15	3	0	0	10	0	3	19	1	0	1	24	17	1	1	1	0	21	1	0	1	0	18	6	5	60	1	6	7	0	1	51	60	0	0	0	4	16	2	1	6	10	4	35	1	36	2	6	18	3	24	0	1	25	1	0	46	6	14	0	3	59	20	0	7	7	6	20	0	0	0	0	5	68	0	6	27	28	0	2	71	5	97	28	1	11	2	57	0	1	0	0	2	7	16	4	11	1	4	7	5	8	0	2	3	0	2	5	36	49	3	1	7	8	6	26	49	0	2	26	20	0	0	1	0	0	8	0	1	1	0	0	0	1	2	9	2	1	0	14	54	45	40	13	0	0	6	31	0	0	0	0	2	0	7	0	0	9	7	46	1	0	2	0	0	1	0	4	13	118	0	2	0	2	0	0	6	0	14	1	13	0	42	56	5	99	12	0	0	2	0	2	0	1	2	4	3	7	7	5	3	0	5	0	5	61	7	1	0	2	0	2	0	0	0	13	0	4	1	9	3	19	1	0	0	0	15	13	0	8	20	0	2	0	0	7	13	0	0	5	0	12	2	0	0	0	4	72	10	1	1	1	0	2	0	2	1	1	23	0	13	1	1	0	0	1	1	0	4	20	7	2	0	8	0	17	0	0	6	0	2	0	1	0	0	7	35	0	2	0	4	1	10	0	0	0	2	11	4	1	1	10	0	3	0	1	0	0	1	4	0	0	0	34	2	0	5	3	30	0	0	1	2	47	74	26	5	9	258	19	52	1	0	1	6	31	15	1	1	0	1	51	0	5	43	71	0	59	0	5	107	0	2	8	16	1	58	11	113	5	1	27	0	19	38	0	6	4	2	1	0	2	4	1	2	4	1	2	2	45	19	14	0	5	36	34	6	0	2	10	0	3	1	2	161	124	35	6	25	4	13	0	0	0	17	13	5	1	0	13	0	0	0	0	0	0	0	3	7	3	1	14	0	0	4	0	0	8	6	0	0	0	0	36	3	0	9	0	2	0	1	0	1	0	0	0	19	2	2	0	1	27	36	1	10	17	8	0	10	43	19	0	0	1	2	17	54	1	0	24	14	3	8	8	62	131	3	0	1	0	9	3	0	30	0	14	1	1	0	8	0	3	19	0	0	121	26	0	21	3	3	15	4	8	4	0	37	11	0	1	1	14	0	89	67	41	0	0	1	0	17	0	15	30	0	13	11	0	8	2	0	0	2	4	1	11	2	0	4	29	3	2	0	0	26	1	0	0	1	0	0	0	5	0	0	0	0	0	49	0	1	28	40	0	3	2	18	0	18	183	29	1	0	8	14	32	368	28	0	7	16	0	74	9	2	1	9	11	4	5	11	0	119	0	0	14	14	2	0	40	121	21	17	51	0	1	0	4	0	0	0	21	10	0	12	0	0	4	0	4	8	0	0	0	262	1	3	4	3	0	84	4	229	2	0	0	19	0	1	0	148	5	5	7	5	0	41	11	4	0	3	19	14	1	11	17	6	0	8	6	6	7	6	26	0	13	9	4	7	39	5	51	19	0	13	15	14	1	17	0	4	0	0	0	0	11	4	1	1	24	5	0	21	4	18	16	6	21	0	26	0	3	0	46	0	3	2	3	4	24	16	0	3	0	72	5	0	15	32	46	0	20	67	33	19	1	7	15	0	19	11	1	68	35	0	1	0	2	1	129	0	61	0	8	132	62	15	1	174	32	1	2	25	0	15	1	39	1	6	37	1	42	15	52	1	0	10	0	15	2	59	1	39	27	2	3	4	1	0	3	3	3	2	0	0	0	5	6	30	23	26	4	14	2	32	4	47	0	4	14	2	0	5	18	68	4	52	0	4	2	3	69	0	0	2	8	1	63	1	2	25	0	0	0	62	3	1	8	14	2	20	0	81	2	0	21	5	1	34	82	96	81	1	2	1	0	0	50	0	185	0	0	0	38	1	2	1	2	0	70	2	11	1	0	1	0	0	11	35	0	1	0	0	0	18	11	0	1	36	0	8	0	0	0	0	4	1	0	1	0	2	0	0	0	0	0	3	0	0	0	8	45	27	19	0	14	55	22	29	19	0	4	7	5	57	5	0	11	7	0	0	5	7	3	13	27	21	26	38	0	5	97	4	20	24	17	7	64	57	1	2	1	3	8	10	9	3	1	1	0	2	3	54	17	41	0	83	21	0	0	43	21	1	0	49	32	2	29	0	13	2	9	1	0	1	14	96	75	0	44	10	90	25	20	23	9	0	6	2	9	2	0	40	2	0	0	0	8	2	34	42	0	31	8	7	16	1	1	1	11	11	11	29	1	15	26	46	52	12	1	5	25	0	5	7	1	0	0	9	2	1	2	12	13	1	3	12	0	0	27	14	0	7	23	2	8	4	32	13	12	10	13	58	4	31	12	5	18	13	68	6	5	9	0	9	9	0	1	7	3	0	20	0	0	0	156	16	0	8	2	1	0	0	0	0	15	0	6	7	36	18	55	0	3	0	0	3	2	2	1	0	0	1	1	26	0	0	0	1	1	403	0	29	41	0	0	38	79	0	31	168	98	30	80	0	28	0	33	0	17	1	34	6	15	29	5	54	0	7	126	77	7	16	14	2	8	31	8	0	10	12	30	3	43	17	2	15	2	78	11	79	2	4	1	15	2	0	19	25	9	568	7	0	3	1	6	2	0	590	17	0	5	108	1	8	35	33	3	5	37	0	10	0	3	0	0	1	3	0	18	26	5	19	29	78	6	0	34	2	17	0	3	15	28	85	55	3	0	0	10	0	1	3	1	39	29	18	4	0	41	7	10	53	195	37	27	5	0	0	24	5	0	2	0	14	18	19	13	11	0	1	7	4	13	4	12	0	0	0	4	38	0	2	5	1	3	0	0	0	6	22	30	73	20	17	65	0	19	0	0	17	13	17	2	2	0	3	5	2	14	32	5	7	65	3	10	7	0	25	21	15	17	40	25	29	2	1	0	0	2	0	63	24	5	36	15	8	15	12	13	2	0	19	7	14	0	24	0	1	0	1	10	0	2	41	11	5	2	2	2	1	6	0	0	0	5	2	0	0	0	44	6	6	0	1	22	17	25	0	1	22	16	0	13	18	38	1	2	0	0	11	1	25	2	0	0	0	2	2	0	8	137	27	8	0	1	5	1	0	0	1	0	3	1	35	0	6	0	3	0	8	5	0	33	73	21	88	7	8	9	42	8	6	1	0	37	3	13	13	6	4	0	0	1	0	29	58	5	40	0	2	0	3	1	0	14	0	2	4	2	2	15	2	1	4	4	0	34	0	1	9	1	0	8	1	11	30	10	5	10	10	0	21	0	25	0	0	40	1	7	49	0	14	2	0	8	133	24	42	4	4	3	68	0	81	2	0	0	11	17	1	4	38	6	2	11	20	3	0	1	9	0	1	0	3	0	2	8	0	3	19	4	2	80	2	1	1	1	8	8	1	7	0	0	0	0	4	24	0	5	4	100	0	0	0	46	5	1	17	1	1	13	0	0	133	0	4	2	1	0	0	0	1	0	34	0	25	35	69	6	1	0	0	2	9	8	0	0	199	2	0	0	0	1	0	1	3	0	1	1	0	3	0	19	1	1	12	40	8	1	1	0	0	5	13	11	12	78	17	33	0	0	1	1	7	4	1	6	32	18	5	14	0	1	15	6	61	0	24	2	27	12	5	7	7	0	4	23	8	32	0	0	0	0	3	5	7	4	0	2	25	24	1	0	4	2	7	6	0	2	2	1	1	0	6	0	2	0	16	34	6	25	21	19	2	3	12	7	5	0	0	18	2	5	3	5	12	2	2	22	17	0	1	20	37	17	28	0	0	0	25	6	0	10	0	22	6	12	22	3	0	5	1	3	0	1	0	2	9	5	6	15	43	382	46	1	17	10	1	46	5	28	13	10	0	3	34	60	12	0	20	12	5	13	3	1	0	282	1	0	73	205	5	2	208	8	13	29	4	3	0	41	72	0	75	42	5	25	25	33	18	1	6	15	0	57	15	9	5	9	72	0	10	0	0	12	0	0	245	2	165	97	2	0	5	0	8	26	0	0	136	9	8	0	20	3	0	1	0	7	2	1	0	18	5	61	4	2	6	2	29	18	28	4	34	23	4	15	0	2	17	73	53	2	8	15	45	3	2	2	2	0	0	2	12	41	4	12	3	0	0	22	5	0	1	1	20	8	5	1	0	0	0	0	0	1	1	4	0	0	25	56	3	4	2	0	0	3	3	7	0	0	22	11	0	0	3	0	14	0	3	26	34	0	12	1	45	2	11	1	5	15	5	0	16	2	5	8	4	32	55	16	0	4	21	6	50	48	20	1	1	0	6	48	2	0	1	0	43	0	8	0	3	0	73	2	31	78	64	12	31	6	1	188	0	4	68	0	2	32	15	28	9	5	2	70	33	62	15	14	0	1	15	18	0	0	0	2	0	18	1	14	19	16	2	0	1	4	0	0	140	20	9	3	51	2	1	1	3	2	1	0	5	1	32	0	0	43	0	4	30	40	1	38	0	0	0	31	9	0	0	1	34	11	55	0	0	51	0	14	70	45	3	1	60	0	14	1	2	12	15	0	1	5	0	0	5	1	0	0	15	22	0	34	7	2	37	0	2	1	4	0	10	54	19	10	10	0	37	4	23	5	0	5	27	4	21	0	0	4	16	22	0	0	77	14	0	0	0	19	8	0	0	2	2	2	5	3	8	3	1	0	7	6	0	0	166	3	25	12	27	8	0	32	12	14	11	11	2	0	1	7	1	0	28	37	23	19	64	1	0	0	0	1	1	10	6	0	3	9	15	1	1	0	4	14	1	46	13	31	41	1	1	15	37	1	0	15	1	1	3	45	5	171	27	0	29	37	0	13	0	82	24	8	19	40	0	1	10	4	19	0	1	1	25	158	349	0	13	21	55	96	41	28	32	80	69	53	50	54	67	41	80	58	34	35	108	142	143	60	134	105	20	125	0	1	0	10	11	1	2	7	0	4	21	0	131	27	0	0	2	78	0	4	5	6	36	5	113	30	3	3	51	14	37	11	28	19	0	64	6	11	40	8	0	42	25	22	0	52	35	1	31	8	9	1	48	32	11	12	4	11	100	19	41	0	11	49	40	27	83	18	71	133	49	214	1	31	0	3	58	116	66	48	14	48	78	1	3	0	9	26
PHYLLO26	32173	184	24	88	65	5	113	9	1	7	0	8	0	0	2	0	6	0	0	1	30	1	0	23	0	0	0	1	0	2	25	0	0	0	12	3	0	1	3	0	13	0	0	1	0	7	0	1	84	0	0	0	0	8	42	34	0	0	1	7	7	0	1	4	8	4	25	3	28	0	6	9	0	19	0	5	14	0	3	30	5	3	2	0	69	19	0	1	0	6	10	0	0	2	1	6	106	0	12	31	20	2	2	83	11	75	33	6	12	0	71	0	0	0	1	1	7	0	2	4	0	6	8	5	14	0	0	2	0	11	1	28	63	8	0	8	11	7	26	68	1	2	28	22	0	2	2	0	0	8	0	0	0	0	0	0	8	0	4	0	1	2	1	23	29	31	11	0	2	7	19	0	0	3	0	0	0	1	0	0	2	2	19	0	0	0	0	1	0	2	2	11	75	2	4	0	0	4	1	3	0	10	0	12	0	28	60	6	81	7	0	0	0	0	2	3	1	2	5	4	16	2	10	8	0	2	0	10	35	7	0	0	1	2	12	0	1	0	18	1	0	1	1	0	13	0	0	0	1	19	14	0	0	10	3	1	0	0	0	7	1	0	0	1	2	11	2	0	0	2	39	4	3	0	0	3	1	1	0	1	0	8	1	12	0	4	1	0	0	3	3	4	8	6	0	0	4	0	5	0	0	1	1	2	0	2	2	0	5	15	1	1	1	0	0	16	1	1	2	8	14	9	5	0	13	0	1	5	1	0	1	2	2	0	0	0	39	1	0	6	0	18	5	0	2	0	28	87	14	0	4	194	10	32	1	0	1	0	27	7	0	1	0	3	54	0	8	33	52	0	33	1	6	68	0	0	15	19	2	51	1	68	0	0	22	3	8	27	2	12	1	4	0	1	1	0	0	0	0	0	0	2	19	6	0	0	5	48	40	5	1	4	0	0	8	7	7	151	116	32	11	33	4	14	0	0	0	51	26	4	0	0	18	2	1	0	1	0	0	0	11	2	4	7	14	0	0	9	0	0	1	2	0	0	0	0	18	0	0	12	1	0	0	0	0	0	3	0	1	21	2	0	0	0	29	26	2	4	19	6	3	16	57	9	0	1	0	0	29	58	0	4	15	17	1	0	1	89	91	6	0	2	0	27	3	1	38	3	14	1	2	0	7	1	2	28	0	0	85	38	1	22	0	3	3	3	2	8	0	34	5	1	0	6	13	0	112	62	33	0	0	4	1	18	0	17	41	0	2	19	1	5	0	0	0	1	0	0	5	0	0	0	31	3	0	0	0	35	3	0	0	1	0	0	0	17	1	0	0	0	0	38	1	4	9	27	2	1	0	8	0	13	147	13	0	2	1	14	52	370	23	0	13	14	0	77	18	5	3	2	2	1	3	10	0	107	0	1	13	6	2	1	14	98	13	18	40	6	0	0	4	0	10	0	26	7	0	10	1	1	11	0	6	7	0	0	1	211	0	2	0	3	1	71	7	127	0	1	3	21	0	1	0	147	20	10	9	6	0	32	6	9	10	0	23	9	2	2	11	0	0	1	5	6	1	1	38	3	5	0	1	0	7	0	46	11	0	5	13	18	0	14	1	5	0	3	0	0	7	4	1	1	31	1	0	3	9	0	18	3	3	1	18	1	2	0	24	0	0	0	1	1	28	9	0	2	1	79	7	0	13	27	38	0	15	71	37	29	3	10	8	2	21	2	7	34	26	0	0	0	2	3	113	0	41	0	6	119	53	18	3	151	17	0	0	3	1	15	1	44	0	6	13	0	7	1	64	0	0	14	0	5	9	78	0	32	25	9	2	0	3	0	0	0	0	7	0	0	0	2	0	18	32	39	1	13	6	39	2	41	0	3	11	0	1	4	20	14	4	28	0	2	0	3	56	2	2	3	7	2	116	8	0	12	2	0	0	68	1	0	9	12	2	8	1	78	0	0	6	0	5	44	156	80	71	2	2	0	0	0	12	0	157	0	0	1	28	0	2	0	0	0	110	0	18	0	0	1	2	0	6	22	0	0	1	0	0	27	9	1	0	22	3	0	0	0	0	0	1	0	1	0	0	0	0	2	0	1	0	0	2	0	1	8	46	33	27	0	2	61	15	18	23	0	6	1	1	46	0	4	14	0	0	1	1	3	15	17	17	22	50	12	2	3	123	6	12	8	14	19	40	30	0	6	3	0	10	20	1	5	0	1	4	5	0	41	24	42	0	53	7	4	2	64	23	0	2	61	45	1	19	0	12	2	10	0	0	0	6	127	50	0	59	12	102	14	13	17	10	2	1	3	1	3	1	58	7	6	0	0	16	0	41	5	0	10	0	11	6	3	6	1	2	8	3	28	0	8	19	36	29	0	1	2	23	0	3	3	2	0	1	12	0	0	0	5	6	0	0	15	1	0	18	5	0	0	26	5	21	0	34	7	10	9	12	50	0	26	10	3	11	7	58	2	0	6	0	2	0	0	0	0	1	0	7	6	0	0	68	3	0	4	4	1	2	0	0	9	3	0	0	3	34	18	51	0	0	0	0	0	0	0	1	0	1	0	5	16	0	0	0	2	2	260	0	13	20	0	3	40	59	0	36	114	43	19	98	0	17	0	34	1	9	5	27	7	12	22	6	35	5	2	104	70	1	12	16	0	15	7	9	0	11	3	30	0	37	22	2	8	2	78	24	49	0	0	19	15	0	3	13	1	6	505	3	0	1	2	5	0	2	551	12	0	1	74	1	0	22	25	1	3	51	1	3	1	2	0	4	0	0	0	21	17	11	13	37	57	6	0	28	2	13	2	3	3	26	99	46	0	1	0	13	0	1	4	0	45	32	10	15	0	50	2	6	27	167	11	11	1	0	0	29	2	0	6	0	9	10	5	5	11	1	0	4	2	5	7	5	0	0	0	0	34	0	0	1	0	0	0	1	2	5	13	23	34	22	3	45	0	6	2	1	5	12	4	5	3	2	0	0	0	12	9	2	6	56	0	2	3	0	15	16	1	18	18	20	22	1	0	0	0	0	0	25	46	0	18	6	14	17	6	3	2	0	23	8	0	0	13	0	0	0	0	1	0	1	57	0	3	1	0	1	1	1	1	0	2	0	4	0	0	0	27	2	0	0	0	4	15	29	0	7	10	8	0	20	11	19	1	2	0	5	6	0	8	2	0	0	0	0	9	0	13	200	43	6	0	0	0	2	0	0	7	1	10	7	34	0	0	0	3	0	32	1	0	34	119	31	37	14	8	4	16	13	5	0	0	37	4	13	4	11	1	0	0	4	2	22	23	2	23	0	1	0	5	3	0	8	0	6	2	4	3	8	4	0	0	1	0	12	2	1	2	0	0	0	2	4	33	4	0	4	4	0	14	2	21	0	0	27	3	1	61	0	2	6	3	12	120	15	16	1	0	5	70	1	50	2	1	0	26	9	0	0	33	1	5	2	22	0	0	1	5	1	0	1	0	0	0	10	2	6	32	1	0	58	0	0	9	2	2	8	2	10	0	1	1	0	2	3	2	2	1	96	1	0	1	30	1	3	25	0	0	18	0	0	98	0	1	0	0	0	0	0	0	0	56	0	12	26	54	1	9	0	0	0	6	3	0	0	196	5	0	2	0	0	0	1	0	1	6	0	1	2	0	1	0	0	21	14	17	0	0	6	2	7	7	1	6	34	11	21	0	1	1	0	0	0	5	12	31	29	2	15	0	0	7	6	20	0	39	5	23	10	2	0	3	0	5	34	6	6	0	2	0	0	0	9	0	6	0	4	31	20	6	0	2	1	0	1	0	2	7	2	3	0	10	0	0	0	34	66	11	61	24	44	0	11	14	2	4	4	1	6	4	0	4	0	4	1	1	5	7	0	1	19	57	8	24	0	1	0	26	1	0	7	1	17	2	9	13	4	0	2	0	2	1	2	0	0	4	4	11	9	21	313	64	0	16	2	0	53	1	7	1	11	0	0	28	36	3	0	7	3	1	0	2	0	0	196	0	0	43	163	5	8	158	2	6	39	1	3	3	27	46	0	37	34	3	36	27	24	19	0	8	12	0	53	9	4	7	7	50	0	10	1	1	6	1	0	179	0	142	50	1	0	17	1	4	18	0	0	97	12	14	0	13	2	0	0	2	6	3	0	0	21	1	19	0	6	1	3	17	11	10	5	46	20	3	15	0	2	7	65	39	8	8	12	32	4	1	0	6	4	0	1	20	25	2	0	1	1	1	25	8	0	4	1	18	4	3	0	2	0	0	1	0	0	5	12	2	0	26	50	3	1	3	0	2	3	2	7	0	1	8	2	0	0	3	0	15	0	4	21	28	0	2	0	49	0	4	4	2	21	5	1	23	0	7	3	16	21	37	18	0	0	18	6	36	38	15	1	0	0	4	61	1	0	0	0	18	3	7	0	4	0	90	4	19	82	66	16	23	7	0	194	0	1	97	0	2	19	9	22	6	5	3	47	39	33	19	9	0	1	14	16	0	0	1	5	0	11	1	12	4	10	1	0	3	0	0	0	93	1	3	5	24	3	0	0	1	4	0	1	1	0	6	0	0	60	0	0	35	24	2	26	0	1	0	26	9	3	0	0	36	4	54	0	1	43	0	2	66	44	9	0	34	0	16	0	0	14	11	1	0	0	2	0	3	5	1	1	9	27	0	13	5	5	32	0	4	1	0	1	0	42	6	26	6	2	34	3	19	0	2	8	6	6	15	1	0	3	14	16	0	1	47	0	0	1	0	23	7	1	2	1	5	0	15	9	3	4	4	0	0	8	0	0	110	0	29	10	18	5	0	18	6	14	7	11	1	0	0	3	0	0	28	43	9	10	51	0	0	0	0	2	1	15	7	0	2	1	10	1	2	0	2	10	0	32	12	8	38	0	2	9	39	0	0	8	0	1	0	34	5	112	14	0	54	61	1	7	0	121	26	0	18	43	0	2	17	2	27	0	1	0	39	108	364	0	12	7	49	72	38	30	2	99	74	41	63	37	89	54	97	42	17	35	66	120	129	77	91	119	34	122	0	4	0	18	21	0	5	4	1	5	25	0	164	22	0	0	0	80	1	0	0	0	5	10	114	21	1	0	43	20	28	6	21	11	0	57	2	19	12	21	0	46	11	26	0	55	31	9	28	3	6	1	46	49	10	3	3	6	80	10	37	0	13	60	87	5	60	31	78	129	67	183	6	41	1	9	52	93	88	28	20	61	71	0	9	0	13	31
PHYLLO27	24728	170	19	67	79	0	87	15	0	4	1	1	0	0	3	0	10	5	4	5	8	0	0	4	4	0	0	2	2	1	12	0	1	0	18	10	1	0	0	0	13	1	0	6	0	4	0	1	32	0	2	0	1	1	42	19	0	0	0	0	14	0	1	2	3	2	11	2	23	0	3	11	0	19	0	0	10	0	2	28	2	8	0	2	36	7	0	0	1	3	9	0	0	0	0	0	50	0	4	25	26	0	1	43	5	59	41	2	9	0	47	1	0	4	0	0	6	6	9	7	0	2	5	1	6	2	0	8	0	9	3	21	27	3	0	5	6	3	12	35	0	0	12	15	1	2	1	0	0	6	0	1	0	0	0	0	4	0	0	0	2	0	9	20	35	35	10	0	2	4	16	0	0	2	0	0	2	0	0	0	0	1	13	0	0	1	0	0	0	0	1	9	64	0	0	0	0	3	0	1	0	5	0	16	0	32	38	2	75	5	0	0	1	0	4	1	0	1	4	9	0	0	5	6	1	3	1	1	13	5	2	0	0	1	2	0	0	1	5	0	2	0	0	0	9	1	0	2	0	20	5	0	0	3	0	0	0	2	0	2	0	0	1	0	9	1	0	0	0	3	31	4	0	0	0	1	0	0	0	0	0	6	1	1	1	3	0	0	1	1	2	3	7	5	0	0	3	1	9	0	0	1	0	0	0	0	3	1	6	21	0	5	0	1	1	6	1	2	0	9	8	1	3	0	15	0	0	0	0	0	0	0	4	0	0	0	23	5	1	4	1	8	4	0	1	0	33	58	14	1	4	164	22	39	0	0	1	0	17	8	0	0	0	3	39	1	17	24	29	0	31	4	9	85	0	1	6	4	3	37	2	72	1	0	16	3	2	15	0	11	1	0	1	0	5	5	0	2	0	0	0	0	16	7	2	0	3	33	23	2	2	6	2	0	0	7	1	110	103	22	8	29	16	16	3	0	0	15	13	4	0	1	5	0	0	0	0	0	0	0	11	4	1	2	9	0	0	3	0	0	0	1	0	0	0	0	5	0	1	1	1	1	0	0	0	0	0	0	0	15	7	0	1	2	31	20	2	1	7	7	5	9	29	5	0	1	0	1	21	43	0	2	6	8	2	5	3	62	82	5	0	4	1	8	3	0	15	0	5	0	0	0	3	0	1	20	1	0	81	23	1	20	2	3	7	6	4	3	0	19	1	1	0	1	10	0	53	31	15	0	0	4	0	11	0	5	12	0	2	14	0	3	1	0	0	2	3	0	4	0	0	3	24	6	2	0	0	13	3	1	0	4	1	0	0	8	0	0	1	1	0	31	0	1	9	29	0	1	0	17	1	11	87	25	0	0	1	3	18	253	11	0	14	9	0	57	3	1	0	4	1	5	6	13	0	114	0	3	8	5	1	0	9	60	21	8	33	0	1	0	0	0	1	0	21	9	0	4	0	5	12	0	3	33	0	0	0	161	0	4	0	12	5	51	9	141	7	0	6	25	0	6	0	91	8	3	2	6	0	54	2	10	2	1	10	6	2	7	3	7	0	4	10	8	6	0	12	0	1	3	0	4	5	5	36	4	0	2	13	10	4	6	2	1	1	0	0	0	6	6	1	1	3	4	0	11	6	11	15	3	12	3	27	0	0	0	13	0	6	0	0	2	6	13	0	0	0	43	9	0	8	30	17	0	11	44	22	25	0	7	8	1	19	8	2	27	21	0	0	1	0	0	108	0	24	0	7	99	47	9	4	127	19	0	1	11	0	23	0	41	1	3	5	0	21	10	54	0	0	4	0	2	4	28	2	26	8	3	4	1	0	0	4	5	0	3	0	0	0	2	2	18	12	11	1	5	4	20	9	33	0	4	8	3	0	2	23	35	7	22	0	0	0	1	32	0	0	4	3	0	67	6	1	15	1	0	0	49	0	0	9	4	4	7	1	72	0	0	13	1	2	30	66	62	54	0	6	1	0	0	21	0	89	0	0	0	29	0	0	0	0	0	39	4	11	0	0	5	0	0	4	17	0	0	1	3	0	12	9	0	0	11	0	0	0	0	1	0	1	0	0	0	0	0	0	1	1	2	0	5	0	1	0	6	37	18	11	0	1	34	21	26	20	1	4	2	2	23	1	8	7	13	0	1	4	4	5	11	13	19	18	5	3	4	64	2	14	20	3	9	34	20	0	1	1	1	1	9	4	2	0	0	1	1	2	48	31	20	0	60	6	3	3	45	14	0	0	38	36	1	14	0	5	1	8	0	0	0	2	95	90	0	37	4	43	16	8	25	8	0	4	0	0	1	0	35	6	1	0	0	6	11	31	7	0	11	0	2	12	3	1	6	11	14	10	28	0	8	14	35	36	5	2	0	18	0	0	5	0	0	1	6	1	6	0	12	6	0	0	6	0	0	10	5	0	4	17	3	14	2	18	6	17	10	18	34	4	21	18	1	13	7	43	10	1	2	0	9	1	0	4	4	3	6	7	5	1	0	188	13	0	9	0	0	0	0	6	6	4	2	3	1	18	5	37	0	0	0	0	3	0	0	0	0	0	0	4	17	1	0	0	0	0	238	0	24	22	1	1	28	44	0	22	102	33	5	51	2	7	0	20	1	8	4	18	15	12	14	18	45	1	2	88	66	7	9	5	0	10	3	5	0	3	7	25	0	30	15	4	4	0	46	14	25	0	0	4	15	0	2	12	8	5	434	3	2	0	2	21	0	0	409	11	0	4	64	0	2	29	43	0	1	24	0	9	0	1	8	1	0	3	0	12	12	3	9	38	35	6	1	30	5	9	0	0	6	18	53	21	0	0	0	12	0	2	3	0	14	13	3	7	1	36	9	10	24	112	25	4	4	0	3	10	0	0	1	0	4	3	4	11	10	7	4	0	0	4	0	4	4	0	0	1	18	0	1	3	1	0	0	0	0	16	21	18	51	12	6	29	0	13	0	0	11	3	5	2	2	0	0	1	0	18	6	2	7	33	0	2	6	1	8	6	2	4	13	8	14	5	0	0	0	0	1	37	17	7	29	12	4	13	3	16	3	0	20	3	3	1	12	0	1	0	0	5	0	4	29	14	0	0	0	0	0	5	0	0	1	1	0	1	2	0	27	0	1	0	2	10	13	6	0	0	12	16	0	6	10	5	1	1	2	2	6	0	16	4	0	0	0	0	9	0	5	128	38	6	0	0	12	0	1	1	0	2	7	24	30	0	1	0	0	0	6	2	0	40	56	24	54	19	1	16	25	16	3	3	0	37	0	12	7	3	2	0	0	1	1	11	29	0	22	2	2	0	0	1	0	11	1	0	0	0	2	9	2	0	0	3	0	59	0	1	14	0	0	1	0	2	19	8	1	12	0	0	23	1	10	6	1	11	1	4	50	0	7	7	4	14	58	20	34	0	0	3	29	1	46	6	0	2	15	12	0	2	26	16	2	7	8	0	0	1	15	1	0	1	0	0	0	1	0	8	11	2	1	39	0	1	0	0	2	5	0	17	0	2	1	2	4	6	0	1	1	52	0	0	0	22	6	9	7	0	0	15	0	0	58	1	1	0	0	0	0	0	0	0	34	0	17	11	45	2	7	0	7	0	3	2	0	0	115	1	0	2	0	0	0	0	0	0	0	0	0	0	0	7	0	0	2	13	10	0	0	0	0	18	2	0	12	41	17	16	0	0	1	0	6	1	3	3	6	14	0	9	0	1	11	2	36	0	10	0	7	10	0	0	9	0	7	24	5	10	0	3	2	0	1	0	1	7	0	1	8	14	0	0	0	1	4	0	2	5	0	0	2	0	6	0	5	0	13	21	8	46	14	32	0	5	13	1	0	1	0	5	1	2	7	3	6	0	0	8	9	0	0	15	27	11	17	0	0	0	8	7	0	6	1	13	2	2	11	5	0	4	0	2	0	3	0	0	1	3	15	3	18	258	44	3	8	4	0	3	3	14	15	0	0	0	22	15	7	0	5	9	2	1	1	0	0	193	0	0	31	165	0	9	118	9	11	13	3	1	1	36	28	0	55	22	8	26	9	33	7	2	7	5	1	48	8	3	3	6	32	0	2	1	0	7	0	0	135	0	54	57	0	0	23	1	7	27	0	0	67	13	7	0	12	0	0	3	0	2	0	1	0	15	7	62	2	3	2	2	19	13	17	0	26	8	0	14	2	2	1	33	19	6	11	8	19	2	0	1	7	3	0	1	7	22	5	2	1	0	0	14	5	1	4	0	27	5	16	0	0	4	2	0	1	13	4	2	0	0	29	48	0	1	8	0	1	6	2	3	5	0	11	3	0	0	0	0	19	2	6	23	29	0	1	2	40	6	9	0	10	18	2	2	3	1	11	1	5	17	28	23	0	1	30	6	17	26	10	0	0	0	4	30	1	0	0	1	25	8	4	2	2	1	58	1	11	53	50	21	38	0	0	114	0	0	53	0	2	14	0	17	0	11	0	43	28	27	10	7	2	0	13	11	1	0	0	0	1	8	3	16	8	28	0	0	1	2	1	0	81	4	2	0	18	0	0	1	1	0	1	0	0	0	13	1	0	32	1	1	17	15	1	31	3	0	0	9	4	1	0	0	26	4	27	0	0	29	1	4	45	27	4	0	29	0	7	0	2	10	11	0	0	1	0	0	1	8	0	0	11	24	2	28	3	2	28	0	1	5	2	0	2	41	4	5	5	0	22	2	18	0	0	4	23	2	9	4	0	3	10	13	1	2	40	9	0	6	0	13	16	1	2	5	1	2	1	2	0	0	1	0	1	1	0	2	90	9	9	9	15	16	0	8	4	10	8	14	0	4	0	2	1	0	19	53	10	14	26	0	1	0	0	0	0	27	7	6	0	1	7	3	9	3	5	27	3	30	14	15	26	0	1	7	28	1	1	12	4	2	0	14	7	79	10	0	25	50	0	4	0	99	12	4	14	27	0	3	3	1	18	0	0	0	17	87	237	0	5	8	50	58	33	21	2	67	48	39	47	15	59	39	57	26	20	27	72	75	100	52	78	76	22	86	1	4	0	5	6	0	1	14	2	3	13	1	68	11	0	0	0	59	0	5	5	2	6	1	102	20	19	0	44	14	13	8	15	18	0	44	1	4	25	5	0	16	7	26	0	23	21	5	22	2	15	11	16	30	7	1	3	9	78	12	14	1	6	43	47	2	39	13	65	81	40	130	0	23	1	6	25	56	50	21	13	30	65	0	3	0	8	31
PHYLLO28	39211	238	30	97	63	0	166	8	1	10	1	11	0	0	1	0	7	0	0	2	31	0	0	10	1	0	0	1	0	2	19	0	0	0	15	3	1	4	13	0	23	2	0	5	0	8	2	3	66	0	3	0	0	0	53	52	0	0	0	7	15	0	0	5	9	8	30	1	28	1	12	30	1	23	0	0	23	0	2	44	0	8	0	0	55	26	0	3	1	5	28	0	0	0	0	7	120	2	15	41	35	1	0	101	19	74	40	7	16	3	73	1	1	3	0	0	3	5	5	11	2	2	11	3	22	0	0	1	0	1	1	58	30	14	1	7	13	8	29	86	0	0	36	28	0	1	0	2	0	12	0	0	0	0	0	0	0	2	2	0	0	3	2	33	20	31	10	0	4	2	27	0	0	0	0	0	2	0	0	0	6	5	32	0	0	0	0	1	1	2	4	22	126	0	1	0	0	0	0	4	0	13	0	11	0	53	87	2	91	8	0	3	1	0	10	0	0	0	15	1	9	8	19	3	0	3	0	2	42	14	0	1	3	2	11	0	0	0	29	0	0	1	7	2	20	0	3	0	0	18	9	0	1	20	1	3	1	0	0	9	2	1	1	0	8	15	1	0	0	0	46	9	1	0	0	0	0	0	2	1	0	11	1	7	0	8	0	1	1	3	6	4	21	9	2	0	16	2	5	2	2	1	0	2	0	3	2	0	5	32	0	4	1	2	1	20	0	0	0	8	13	2	0	0	23	1	2	0	3	0	0	0	1	0	0	0	44	4	1	2	0	9	5	0	0	0	48	127	19	0	2	288	17	62	0	0	0	2	33	5	4	1	0	0	65	1	12	47	43	1	32	4	8	72	0	1	12	42	1	70	9	90	3	0	34	4	7	26	0	9	0	6	0	0	4	3	0	0	0	0	4	0	30	11	1	0	6	39	47	0	0	2	4	0	12	18	3	141	176	42	4	22	7	21	3	0	0	64	17	4	3	0	13	0	0	0	3	0	0	0	17	0	1	4	21	0	0	9	0	0	6	0	1	1	0	0	12	0	0	9	0	0	0	0	0	1	8	0	0	19	3	0	0	0	27	36	1	3	15	5	5	8	85	10	0	2	0	2	44	89	0	2	28	21	2	3	2	72	114	5	0	5	0	24	5	1	42	0	17	1	1	0	10	0	1	46	1	0	130	37	2	37	2	11	0	1	10	5	1	37	6	1	0	5	6	2	111	88	35	0	0	2	1	9	0	15	32	0	2	9	0	9	0	0	0	0	0	0	2	0	1	2	29	1	2	0	1	41	2	0	0	1	2	0	1	15	0	0	0	0	0	46	0	1	3	46	0	1	0	12	0	14	211	20	0	0	2	29	48	433	17	0	21	20	0	104	26	4	5	4	11	6	6	24	0	172	0	7	15	7	1	0	17	150	16	11	67	0	3	1	0	2	7	0	30	11	0	17	0	0	13	0	6	10	1	0	2	340	0	0	4	9	0	80	0	204	0	0	1	21	0	4	0	149	9	8	13	7	0	46	7	3	3	2	30	18	5	6	14	1	0	2	2	4	0	2	37	2	6	5	0	2	11	1	47	7	0	3	6	21	0	25	0	9	2	0	0	0	6	1	2	2	25	1	0	12	7	0	13	4	4	2	35	1	2	1	29	0	0	0	0	0	19	8	0	1	1	119	26	0	10	27	55	1	21	68	42	38	0	14	4	0	30	2	3	60	49	0	3	0	0	3	124	1	54	0	10	142	69	10	1	109	18	0	0	5	1	29	0	52	1	6	22	0	18	5	65	0	0	3	0	7	5	83	0	36	20	16	4	1	0	0	1	1	0	12	0	0	0	0	1	17	14	25	3	15	5	33	4	32	0	1	21	3	0	11	22	13	2	42	0	3	0	3	78	1	1	7	7	0	88	8	1	33	5	1	1	120	0	0	11	28	0	8	3	114	0	1	9	0	0	49	136	54	67	1	3	1	0	0	22	0	199	0	2	0	54	3	0	2	0	0	125	1	22	0	1	0	1	1	16	36	0	0	0	3	0	37	7	0	0	15	2	0	0	3	0	0	3	0	0	0	0	0	0	1	0	2	0	0	0	4	2	9	51	30	14	0	3	77	29	35	13	4	4	8	1	49	2	2	13	0	0	1	0	2	24	23	21	31	51	14	2	17	126	8	15	17	16	9	55	42	0	10	0	9	9	18	0	5	0	3	4	4	7	54	34	48	1	66	8	1	1	56	17	0	1	57	37	2	17	1	7	0	27	2	0	0	6	180	60	2	67	16	77	13	8	14	10	5	2	2	5	0	0	62	2	5	0	0	8	6	39	6	0	17	2	11	17	0	2	0	12	9	6	51	0	17	17	26	53	1	0	3	22	0	8	6	1	0	0	4	0	1	0	12	17	0	1	13	1	0	19	10	0	1	27	4	8	0	36	6	22	11	8	52	8	31	15	3	26	9	74	6	1	3	2	3	2	0	0	7	8	2	8	3	0	0	47	7	0	5	9	0	0	0	0	12	2	0	0	7	20	21	60	1	0	0	0	6	0	0	0	0	0	1	11	27	1	0	0	4	5	355	0	15	21	0	0	42	71	0	23	114	81	21	96	0	23	0	52	0	15	9	21	23	21	26	8	65	2	4	139	77	2	13	25	0	10	16	17	0	6	6	44	0	69	21	8	6	0	97	17	57	0	3	10	22	0	2	23	5	2	612	10	0	1	5	11	0	1	693	11	0	2	93	0	0	18	36	1	0	48	0	3	0	1	0	0	1	0	0	17	24	17	34	58	52	9	0	56	2	25	8	14	3	22	93	39	0	0	0	18	2	1	2	0	65	48	14	13	0	62	2	10	37	165	36	20	5	0	0	24	2	0	13	2	9	28	11	5	9	0	0	0	4	9	0	4	0	0	1	0	71	0	0	4	0	3	1	0	1	3	12	28	39	15	11	87	0	14	0	0	8	22	12	4	1	2	1	0	1	15	13	0	5	171	7	16	1	0	14	21	2	7	41	31	20	4	0	3	0	0	0	42	33	0	44	18	12	23	13	2	0	0	20	10	2	0	18	0	0	0	0	8	1	3	56	7	2	0	1	1	0	0	0	2	0	0	1	0	0	2	38	1	3	3	0	28	13	38	0	1	13	7	0	13	11	17	2	1	0	0	6	1	11	0	0	4	0	0	7	1	10	155	32	14	0	1	1	0	0	0	8	0	14	9	67	0	3	0	4	1	10	1	2	36	88	49	78	24	20	3	23	24	3	2	1	71	0	12	7	10	3	0	0	3	0	32	44	0	43	1	0	0	5	6	0	8	0	6	1	1	3	6	6	1	0	0	0	14	1	1	4	0	0	0	2	4	57	4	0	15	5	0	20	2	21	0	0	40	0	10	110	1	0	5	4	11	92	24	34	5	0	4	60	4	85	0	1	0	11	8	2	5	27	2	0	9	22	3	0	1	4	3	0	1	0	0	1	7	0	11	37	3	2	59	0	0	4	3	4	6	1	3	4	0	1	0	3	5	0	0	1	74	1	0	0	47	0	0	23	1	1	25	0	0	104	0	0	0	0	0	0	0	0	1	33	0	20	24	78	0	0	0	0	0	14	13	0	0	220	1	0	2	0	0	0	2	0	0	4	0	0	2	0	1	0	0	28	37	11	0	1	8	1	15	8	0	10	55	12	37	1	0	0	1	7	0	2	6	24	19	11	10	0	0	12	3	30	0	62	12	21	11	12	5	5	0	11	54	4	3	0	1	0	1	6	15	0	3	0	6	43	37	8	1	5	3	0	3	3	3	9	5	3	0	6	1	1	0	41	67	9	53	19	58	1	8	12	1	6	1	0	14	0	3	3	0	5	3	0	17	5	0	2	42	39	6	27	0	0	0	39	4	2	4	6	16	3	14	18	10	0	4	0	5	0	4	1	0	6	11	19	14	29	373	65	0	11	8	0	54	2	12	6	17	0	1	42	75	4	0	11	8	8	0	0	1	0	301	0	0	65	241	5	4	158	10	7	40	5	5	2	40	75	0	78	29	4	15	38	41	10	0	11	17	0	58	30	13	1	7	69	0	6	0	0	11	0	1	242	3	179	84	4	0	27	0	8	24	0	0	85	4	16	0	21	2	2	2	1	2	1	1	0	14	0	19	5	12	0	1	23	3	17	2	57	21	1	13	1	0	3	66	36	0	8	11	41	7	0	0	5	1	0	10	32	57	0	0	0	0	0	23	7	0	1	0	34	19	1	0	0	1	2	3	0	0	1	12	3	1	43	59	1	4	8	0	3	3	2	8	0	0	22	0	0	0	5	0	18	0	2	20	38	0	1	2	59	0	8	4	6	18	5	3	25	1	5	5	7	28	71	28	0	2	20	4	56	65	20	0	0	0	0	82	1	1	1	0	44	5	6	1	4	0	72	0	29	83	71	20	40	4	1	163	0	0	116	0	1	18	11	36	18	6	4	66	38	53	24	3	0	2	23	35	0	0	0	0	0	21	0	13	17	14	3	0	2	5	0	1	142	9	6	7	27	6	0	0	1	1	0	0	1	1	15	1	0	69	2	3	44	30	5	40	2	0	0	20	18	1	0	1	34	7	65	0	0	43	0	10	54	65	18	0	65	0	13	0	0	16	16	0	0	2	4	0	2	1	0	1	16	51	4	16	2	1	32	0	9	3	5	0	2	65	4	22	11	3	57	3	18	0	0	11	11	3	30	1	0	2	27	22	0	4	75	0	0	2	0	26	10	4	5	4	0	0	18	19	4	14	1	0	11	17	0	0	136	7	20	20	16	9	0	40	17	18	13	8	1	2	0	5	3	0	9	35	16	14	68	0	0	0	0	0	0	30	12	2	8	1	8	2	5	3	13	16	1	45	16	23	41	0	3	4	38	4	0	7	4	2	0	53	2	118	14	0	94	58	1	6	0	156	16	0	19	55	0	1	15	4	19	0	0	1	17	164	415	0	18	11	61	105	55	26	11	97	80	55	83	42	106	40	138	52	21	57	98	157	176	61	127	136	20	159	0	4	0	15	13	7	1	9	0	3	23	1	179	26	1	0	0	120	0	8	3	4	4	7	157	39	2	0	31	12	42	12	27	12	0	61	2	23	32	25	1	43	18	29	0	55	41	3	33	2	4	7	37	57	6	10	5	13	98	18	65	2	17	53	65	11	82	44	76	158	45	253	0	48	1	8	45	93	103	40	16	82	68	0	3	0	8	43
PHYLLO29	4884	29	2	30	11	1	24	3	0	1	1	0	0	0	1	0	3	0	0	1	1	1	0	0	0	0	0	0	0	0	2	0	0	0	1	1	0	0	1	0	2	0	0	1	0	4	0	0	17	0	0	0	1	0	5	5	0	0	0	0	1	0	0	1	2	0	1	0	6	0	1	7	0	4	0	1	1	0	0	6	3	1	0	0	5	8	0	1	0	0	1	0	0	0	0	0	9	0	0	6	1	0	1	4	5	17	4	3	2	0	10	0	0	0	0	0	2	0	0	2	0	2	0	2	4	0	0	0	0	1	0	4	10	0	0	1	2	2	1	6	0	0	1	7	0	0	0	2	1	5	0	0	0	0	0	0	0	1	0	0	0	0	0	3	6	7	0	0	0	3	3	0	0	0	0	0	1	0	0	0	0	1	1	0	0	0	0	0	0	0	0	3	15	0	0	0	0	0	0	0	0	3	0	0	0	5	13	0	15	1	0	0	0	0	1	1	0	0	0	1	2	0	2	0	0	2	0	2	4	3	0	0	1	1	3	0	0	0	5	0	0	0	1	0	3	0	0	0	0	6	0	0	1	3	1	0	0	0	0	0	0	0	0	0	3	0	0	1	0	0	5	0	1	0	0	0	0	0	0	0	0	1	0	2	0	0	0	0	0	0	0	0	1	0	1	0	0	1	0	0	1	0	0	1	0	0	0	0	0	2	0	0	0	0	0	1	1	0	0	2	3	0	3	0	3	0	0	0	0	0	0	0	0	0	0	0	10	0	0	1	0	1	0	1	0	0	8	12	0	1	0	32	1	7	0	0	0	0	3	0	0	0	0	1	8	0	1	6	4	0	10	1	1	20	0	0	0	3	0	6	1	11	1	0	2	2	0	4	0	1	0	0	0	0	0	0	0	1	2	0	0	0	1	3	0	0	2	2	4	1	0	0	0	0	0	1	0	30	25	7	3	3	0	7	0	0	0	1	4	3	1	0	1	1	0	0	0	0	0	0	2	1	0	0	1	0	0	0	0	0	0	0	0	0	0	0	2	0	0	0	0	0	0	0	0	1	0	0	0	7	0	0	0	0	2	8	0	0	5	0	6	2	11	3	0	0	0	1	2	6	0	0	6	0	1	0	0	11	21	1	0	0	0	1	1	1	6	0	2	0	0	0	3	0	0	1	0	0	19	8	2	8	0	1	1	1	0	1	0	3	0	0	1	0	0	0	13	5	3	0	0	1	0	2	0	2	5	0	0	1	1	0	0	0	0	0	0	0	0	0	0	0	7	6	0	0	0	2	1	0	0	0	0	0	1	2	0	0	0	0	0	5	0	0	0	9	1	0	0	1	0	0	19	1	0	0	0	4	5	60	3	0	2	0	0	11	0	1	1	0	1	1	1	5	0	12	0	0	0	1	3	0	1	12	2	0	12	0	0	0	0	0	0	1	5	3	0	2	0	0	8	0	0	1	0	0	1	21	0	0	0	0	0	4	0	25	0	0	0	6	0	1	0	12	0	1	0	2	1	2	0	1	0	0	4	0	3	1	0	1	0	0	0	3	0	0	2	0	0	1	0	0	1	0	9	0	2	0	2	4	0	0	0	0	0	0	0	0	1	1	2	2	7	0	0	1	0	1	1	0	0	0	1	0	0	0	6	0	0	0	0	0	0	1	0	1	1	12	1	0	0	2	2	1	3	13	6	3	0	0	1	0	5	0	1	5	4	0	0	0	0	0	19	0	5	0	7	17	19	2	0	15	3	0	0	2	0	1	0	11	1	0	0	0	0	0	10	0	0	0	0	3	1	11	0	4	2	0	0	0	0	0	0	0	0	0	0	0	0	0	3	2	5	2	1	1	2	0	0	5	0	1	1	1	0	1	1	0	0	11	0	0	0	1	6	0	0	0	1	0	11	0	0	3	0	0	0	6	0	0	0	0	0	1	2	7	0	0	1	0	1	7	10	7	15	5	1	0	0	0	8	0	19	0	0	0	5	0	2	0	0	0	9	0	2	0	0	0	0	0	1	8	0	0	0	0	0	0	4	0	0	4	0	0	0	0	0	0	1	0	0	0	0	0	0	0	0	0	0	1	0	0	0	1	6	1	0	0	0	13	1	3	3	2	0	0	0	7	0	0	3	0	0	1	0	0	2	3	3	4	5	2	0	0	9	0	0	4	2	0	2	4	0	0	0	0	0	3	0	0	0	0	2	1	0	8	5	3	0	14	1	2	0	10	4	0	0	10	5	0	2	1	1	0	2	0	0	0	2	14	11	0	10	2	9	2	3	2	3	2	0	0	0	1	0	7	0	1	0	0	3	0	5	1	0	3	0	3	0	0	0	0	2	1	1	10	0	0	8	3	8	1	0	1	4	0	0	0	0	1	0	3	2	1	0	0	0	0	0	0	0	0	2	3	0	0	3	0	1	0	4	3	5	1	1	3	2	1	1	1	1	0	7	0	0	0	0	0	0	0	0	0	1	0	1	1	0	1	8	5	0	0	0	0	0	0	0	1	1	0	2	2	5	3	9	0	0	0	0	0	0	0	1	0	0	0	2	0	0	1	0	2	0	29	0	3	1	0	0	5	8	0	6	10	3	2	12	0	4	0	7	0	5	2	4	1	3	0	1	6	0	1	27	10	0	1	1	0	4	4	1	0	1	0	9	0	3	1	0	0	1	8	3	2	0	0	1	15	0	1	1	0	1	79	0	0	0	0	0	0	0	95	4	0	0	18	0	0	3	3	0	0	7	0	0	0	0	0	0	0	0	0	2	3	0	0	13	6	1	0	5	0	2	1	0	0	0	8	8	0	0	1	4	0	1	0	0	3	7	2	1	1	9	0	0	5	28	8	2	1	0	0	2	0	0	0	0	1	3	1	0	0	0	0	0	0	1	0	0	0	0	0	0	4	0	0	3	0	0	0	1	0	0	1	2	3	8	3	4	0	0	0	0	1	3	1	0	0	0	0	0	0	1	0	0	0	8	0	1	0	1	2	3	1	1	2	4	2	0	0	0	1	0	0	5	9	0	4	3	0	2	0	0	1	0	3	3	0	0	3	0	0	0	0	0	0	1	9	0	0	0	0	0	0	0	0	1	0	0	0	0	0	0	8	0	0	0	0	1	3	5	0	0	2	0	0	3	0	1	0	1	0	0	2	0	1	0	0	0	0	0	0	0	3	21	7	1	0	0	1	0	0	0	0	0	0	0	4	0	0	0	1	0	0	1	0	3	14	3	9	5	2	0	1	6	1	0	0	5	0	0	1	0	0	0	0	0	1	2	7	2	9	1	0	0	0	1	0	6	0	0	0	0	1	2	2	0	0	0	0	2	0	0	0	0	0	0	0	0	2	1	0	4	2	0	5	0	4	0	0	1	0	0	14	0	0	0	1	4	11	2	7	0	0	0	12	0	15	0	0	0	1	1	0	0	1	3	0	0	0	0	1	0	2	1	0	1	0	0	0	2	0	2	4	1	0	5	0	0	3	0	0	0	0	3	1	0	0	0	0	1	0	0	1	11	0	0	0	2	0	0	2	0	0	1	0	0	22	0	0	0	0	0	0	0	0	0	6	0	6	2	7	0	0	0	0	0	0	0	0	0	18	0	0	1	0	0	0	0	0	0	0	0	0	0	0	0	0	0	0	2	5	0	0	0	0	3	0	0	4	4	3	9	0	0	1	0	0	0	1	0	1	3	3	3	0	0	1	0	0	0	4	0	4	5	2	1	1	0	1	3	0	0	0	1	1	0	0	0	0	1	0	0	2	3	0	0	1	0	0	0	0	0	2	0	1	0	2	0	0	0	3	3	2	3	0	5	0	1	1	1	1	2	0	1	2	1	0	0	0	0	0	2	0	0	0	4	10	2	1	0	0	0	0	1	0	1	1	0	1	0	3	1	0	1	0	1	0	0	0	0	4	0	1	0	4	53	15	0	0	3	0	2	0	2	3	2	0	1	4	9	2	0	0	0	1	0	0	0	0	39	0	0	9	26	0	0	16	3	1	6	0	1	0	6	6	0	6	2	2	4	3	6	0	0	1	0	1	6	2	1	1	0	7	0	1	0	0	3	0	0	39	0	24	16	0	0	5	0	2	4	0	0	11	2	2	0	3	0	0	0	1	1	0	0	0	8	0	1	0	3	0	1	2	0	2	0	9	2	0	6	0	1	0	15	5	0	0	0	3	0	0	0	0	0	0	2	2	5	0	0	1	0	0	0	4	0	0	2	8	0	0	0	0	0	0	0	0	0	0	2	0	0	7	9	1	0	1	0	1	0	1	0	0	0	3	0	0	0	0	0	4	0	1	2	8	0	0	0	8	0	2	0	0	1	1	0	2	1	2	1	0	4	9	5	0	0	2	0	5	3	2	0	1	0	0	7	0	0	0	1	3	3	0	0	0	0	12	0	2	12	16	3	4	0	0	21	0	0	14	0	1	5	0	0	0	0	1	20	11	3	1	2	0	0	0	4	0	0	0	0	0	2	0	2	1	3	1	0	2	1	0	0	18	4	0	2	0	2	0	0	1	1	0	0	0	0	1	0	0	5	0	0	8	4	0	2	0	0	0	5	1	0	0	0	5	0	4	0	0	2	0	1	10	6	1	0	4	0	0	0	0	0	5	0	1	1	0	0	0	0	0	0	4	3	0	0	0	2	7	0	0	0	1	0	2	6	4	0	1	0	5	0	2	1	0	1	4	1	0	0	0	0	1	8	0	0	8	0	0	0	0	0	2	1	0	0	0	0	2	0	0	2	0	0	0	1	0	0	4	3	2	3	2	0	0	3	0	1	0	0	0	0	0	0	1	0	1	6	6	2	3	0	0	0	1	0	0	1	0	1	1	0	3	0	3	0	0	4	0	4	1	3	10	0	0	3	8	0	0	2	2	3	0	5	0	9	4	0	4	7	0	3	0	21	4	0	1	7	0	0	1	0	3	0	0	0	3	25	45	0	2	2	6	3	5	2	1	13	13	9	8	2	12	10	21	5	6	9	18	16	18	7	10	24	5	19	0	2	0	3	1	0	1	1	0	3	2	0	22	1	0	0	0	15	0	0	3	0	3	0	23	8	0	0	4	1	4	2	4	1	0	8	2	0	2	0	0	8	1	11	0	5	4	1	2	3	2	0	6	12	0	1	0	6	14	0	3	1	5	7	14	0	5	5	19	13	7	27	0	5	0	1	8	19	12	4	1	12	12	0	0	0	2	8
