Sample_ID	Total	7 transmembrane receptor (rhodopsin family) (PF00001)	7 transmembrane receptor (Secretin family) (PF00002)	7 transmembrane sweet-taste receptor of 3 GCPR (PF00003)	ATPase family associated with various cellular activities (AAA) (PF00004)	ABC transporter (PF00005)	ATP synthase alpha/beta family, nucleotide-binding domain (PF00006)	EGF-like domain (PF00008)	Elongation factor Tu GTP binding domain (PF00009)	Helix-loop-helix DNA-binding domain (PF00010)	Hsp20/alpha crystallin family (PF00011)	Hsp70 protein (PF00012)	KH domain (PF00013)	Kunitz/Bovine pancreatic trypsin inhibitor domain (PF00014)	Methyl-accepting chemotaxis protein (MCP) signalling domain (PF00015)	Ribulose bisphosphate carboxylase large chain, catalytic domain (PF00016)	SH2 domain (PF00017)	SH3 domain (PF00018)	TNFR/NGFR cysteine-rich region (PF00020)	Actin (PF00022)	Ankyrin repeat (PF00023)	PAN domain (PF00024)	ADP-ribosylation factor family (PF00025)	Eukaryotic aspartyl protease (PF00026)	Cyclic nucleotide-binding domain (PF00027)	Cadherin domain (PF00028)	Beta/Gamma crystallin (PF00030)	Cytochrome b(C-terminal)/b6/petD (PF00032)	Cytochrome b(N-terminal)/b6/petB (PF00033)	Cytochrome c (PF00034)	Double-stranded RNA binding motif (PF00035)	EF hand (PF00036)	4Fe-4S binding domain (PF00037)	Fibronectin type III domain (PF00041)	Globin (PF00042)	Glutathione S-transferase, C-terminal domain (PF00043)	Glyceraldehyde 3-phosphate dehydrogenase, NAD binding domain (PF00044)	Hemopexin (PF00045)	Homeobox domain (PF00046)	Kazal-type serine protease inhibitor domain (PF00050)	Kringle domain (PF00051)	PF00052	Laminin EGF-like (Domains III and V) (PF00053)	Laminin G domain (PF00054)	lactate/malate dehydrogenase, NAD binding domain (PF00056)	Low-density lipoprotein receptor domain class A (PF00057)	Low-density lipoprotein receptor repeat class B (PF00058)	Lectin C-type domain (PF00059)	Ligand-gated ion channel (PF00060)	Myosin head (motor domain) (PF00063)	Neuraminidase (PF00064)	LNR domain (PF00066)	Cytochrome P450 (PF00067)	Protein kinase domain (PF00069)	Pyridine nucleotide-disulphide oxidoreductase (PF00070)	Ras family (PF00071)	Response regulator receiver domain (PF00072)	RNase H (PF00075)	RNA recognition motif. (a.k.a. RRM, RBD, or RNP domain) (PF00076)	Retroviral aspartyl protease (PF00077)	Reverse transcriptase (RNA-dependent DNA polymerase) (PF00078)	Serpin (serine protease inhibitor) (PF00079)	Copper/zinc superoxide dismutase (SODC) (PF00080)	Iron/manganese superoxide dismutases, alpha-hairpin domain (PF00081)	Subtilase family (PF00082)	Sugar (and other) transporter (PF00083)	Sushi domain (SCR repeat) (PF00084)	Thioredoxin (PF00085)	Trypsin (PF00089)	Thrombospondin type 1 domain (PF00090)	Tubulin/FtsZ family, GTPase domain (PF00091)	von Willebrand factor type A domain (PF00092)	von Willebrand factor type C domain (PF00093)	PF00094	Zinc finger, C2H2 type (PF00096)	Zinc finger, C3HC4 type (RING finger) (PF00097)	Zinc knuckle (PF00098)	Zona pellucida-like domain (PF00100)	Ribulose bisphosphate carboxylase, small chain (PF00101)	Protein-tyrosine phosphatase (PF00102)	Ligand-binding domain of nuclear hormone receptor (PF00104)	Zinc finger, C4 type (two domains) (PF00105)	short chain dehydrogenase (PF00106)	Zinc-binding dehydrogenase (PF00107)	Thiolase, N-terminal domain (PF00108)	Beta-ketoacyl synthase, N-terminal domain (PF00109)	wnt family (PF00110)	2Fe-2S iron-sulfur cluster binding domain (PF00111)	Papain family cysteine protease (PF00112)	Enolase, C-terminal TIM barrel domain (PF00113)	Pilin (bacterial filament) (PF00114)	Cytochrome C and Quinol oxidase polypeptide I (PF00115)	Cytochrome C oxidase subunit II, periplasmic domain (PF00116)	Glutamine amidotransferase class-I (PF00117)	TCP-1/cpn60 chaperonin family (PF00118)	ATP synthase A chain (PF00119)	Glutamine synthetase, catalytic domain (PF00120)	Triosephosphate isomerase (PF00121)	E1-E2 ATPase (PF00122)	Photosynthetic reaction centre protein (PF00124)	Core histone H2A/H2B/H3/H4 (PF00125)	Bacterial regulatory helix-turn-helix protein, lysR family (PF00126)	Copper binding proteins, plastocyanin/azurin family (PF00127)	Alpha amylase, catalytic domain (PF00128)	Phorbol esters/diacylglycerol binding domain (C1 domain) (PF00130)	Bacterial transferase hexapeptide (six repeats) (PF00132)	tRNA synthetases class I (I, L, M and V) (PF00133)	Cyclin, N-terminal domain (PF00134)	Carboxylesterase family (PF00135)	DNA polymerase family B (PF00136)	ATP synthase subunit C (PF00137)	Legume lectin domain (PF00139)	Sigma-70 factor, region 1.2 (PF00140)	Peroxidase (PF00141)	4Fe-4S iron sulfur cluster binding proteins, NifH/frxC family (PF00142)	Beta-lactamase (PF00144)	C-5 cytosine-specific DNA methylase (PF00145)	NADH dehydrogenase (PF00146)	Fibrinogen beta and gamma chains, C-terminal globular domain (PF00147)	Nitrogenase component 1 type Oxidoreductase (PF00148)	Calcineurin-like phosphoesterase (PF00149)	Cellulase (glycosyl hydrolase family 5) (PF00150)	tRNA synthetases class II (D, K and N) (PF00152)	Mitochondrial carrier protein (PF00153)	recA bacterial DNA recombination protein (PF00154)	Aminotransferase class I and II (PF00155)	Phosphoribosyl transferase domain (PF00156)	Sigma-54 interaction domain (PF00158)	Cyclophilin type peptidyl-prolyl cis-trans isomerase/CLD (PF00160)	Phosphoglycerate kinase (PF00162)	Ribosomal protein S4/S9 N-terminal domain (PF00163)	Ribosomal protein S12/S23 (PF00164)	Bacterial regulatory helix-turn-helix proteins, AraC family (PF00165)	Chaperonin 10 Kd subunit (PF00166)	C2 domain (PF00168)	PH domain (PF00169)	bZIP transcription factor (PF00170)	Aldehyde dehydrogenase family (PF00171)	Fungal Zn(2)-Cys(6) binuclear cluster domain (PF00172)	Cytochrome b5-like Heme/Steroid binding domain (PF00173)	Oxidoreductase molybdopterin binding domain (PF00174)	Oxidoreductase NAD-binding domain (PF00175)	SNF2 family N-terminal domain (PF00176)	Ribosomal protein S7p/S5e (PF00177)	Ubiquitin-conjugating enzyme (PF00179)	Isocitrate/isopropylmalate dehydrogenase (PF00180)	Ribosomal Proteins L2, RNA binding domain (PF00181)	Chitinase class I (PF00182)	Hsp90 protein (PF00183)	Aspartate/ornithine carbamoyltransferase, Asp/Orn binding domain (PF00185)	Dihydrofolate reductase (PF00186)	Chitin recognition protein (PF00187)	Cysteine-rich secretory protein family (PF00188)	Ribosomal protein S3, C-terminal domain (PF00189)	Cupin (PF00190)	Annexin (PF00191)	Eukaryotic-type carbonic anhydrase (PF00194)	Chalcone and stilbene synthases, N-terminal domain (PF00195)	Bacterial regulatory proteins, luxR family (PF00196)	2-oxoacid dehydrogenases acyltransferase (catalytic domain) (PF00198)	Catalase (PF00199)	Disintegrin (PF00200)	UDP-glucoronosyl and UDP-glucosyl transferase (PF00201)	Aminotransferase class-III (PF00202)	Ribosomal protein S19 (PF00203)	DNA gyrase B (PF00204)	Thiamine pyrophosphate enzyme, central domain (PF00205)	Lyase (PF00206)	Alpha-2-macroglobulin family (PF00207)	Glutamate/Leucine/Phenylalanine/Valine dehydrogenase (PF00208)	Sodium:neurotransmitter symporter family (PF00209)	Ferritin-like domain (PF00210)	Adenylate and Guanylate cyclase catalytic domain (PF00211)	ATP synthase delta (OSCP) subunit (PF00213)	Orotidine 5'-phosphate decarboxylase / HUMPS family (PF00215)	Bacterial DNA-binding protein (PF00216)	ATP:guanido phosphotransferase, C-terminal catalytic domain (PF00217)	Indole-3-glycerol phosphate synthase (PF00218)	Aromatic amino acid lyase (PF00221)	Photosystem I psaA/psaB protein (PF00223)	Pyruvate kinase, barrel domain (PF00224)	Kinesin motor domain (PF00225)	DnaJ domain (PF00226)	Proteasome subunit (PF00227)	Major intrinsic protein (PF00230)	ATP synthase (PF00231)	Glycosyl hydrolase family 1 (PF00232)	3'5'-cyclic nucleotide phosphodiesterase (PF00233)	Profilin (PF00235)	Ribosomal protein L22p/L17e (PF00237)	Ribosomal protein L14p/L23e (PF00238)	Resolvase, N terminal domain (PF00239)	Ubiquitin family (PF00240)	Cofilin/tropomyosin-type actin-binding protein (PF00241)	14-3-3 protein (PF00244)	Alkaline phosphatase (PF00245)	Zinc carboxypeptidase (PF00246)	Aldo/keto reductase family (PF00248)	Myb-like DNA-binding domain (PF00249)	Fork head domain (PF00250)	Glycosyl hydrolases family 32 N-terminal domain (PF00251)	Ribosomal protein L16p/L10e (PF00252)	Ribosomal protein S14p/S29e (PF00253)	FKBP-type peptidyl-prolyl cis-trans isomerase (PF00254)	Glutathione peroxidase (PF00255)	Flavodoxin (PF00258)	Calreticulin family (PF00262)	PF00263	Common central domain of tyrosinase (PF00264)	Thymidine kinase (PF00265)	Aminotransferase class-V (PF00266)	Gram-negative porin (PF00267)	Ribonucleotide reductase, small chain (PF00268)	Small, acid-soluble spore proteins, alpha/beta type (PF00269)	DEAD/DEAH box helicase (PF00270)	Helicase conserved C-terminal domain (PF00271)	Fructose-bisphosphate aldolase class-I (PF00274)	EPSP synthase (3-phosphoshikimate 1-carboxyvinyltransferase) (PF00275)	Ribosomal protein L23 (PF00276)	Pyridoxal-dependent decarboxylase, C-terminal sheet domain (PF00278)	Ribosomal protein L5 (PF00281)	Pyridoxal-dependent decarboxylase conserved domain (PF00282)	Citrate synthase (PF00285)	GHMP kinases N terminal domain (PF00288)	Carbamoyl-phosphate synthase L chain, N-terminal domain (PF00289)	Tryptophan synthase alpha chain (PF00290)	Pyridoxal-phosphate dependent enzyme (PF00291)	NUDIX domain (PF00293)	pfkB family carbohydrate kinase (PF00294)	Glycosyl hydrolases family 28 (PF00295)	Luciferase-like monooxygenase (PF00296)	Ribosomal protein L3 (PF00297)	Ribosomal protein L11, RNA binding domain (PF00298)	Histidine phosphatase superfamily (branch 1) (PF00300)	Rubredoxin (PF00301)	Chloramphenicol acetyltransferase (PF00302)	Thymidylate synthase (PF00303)	Lipoxygenase (PF00305)	ATP synthase alpha/beta chain, C terminal domain (PF00306)	Calponin homology (CH) domain (PF00307)	Bacterial dnaA  protein (PF00308)	PF00309	Glutamine amidotransferases class-II (PF00310)	Phosphoenolpyruvate carboxylase (PF00311)	Ribosomal protein S15 (PF00312)	'Cold-shock' DNA-binding domain (PF00313)	Thaumatin family (PF00314)	Fructose-1-6-bisphosphatase (PF00316)	Ribonucleotide reductase, all-alpha domain (PF00317)	Ribosomal protein S2 (PF00318)	SRF-type transcription factor (DNA-binding and dimerisation domain) (PF00319)	GATA zinc finger (PF00320)	Amino acid permease (PF00324)	Bacterial regulatory proteins, crp family (PF00325)	Prolyl oligopeptidase family (PF00326)	Ribosomal protein L30p/L7e (PF00327)	Histidine phosphatase superfamily (branch 2) (PF00328)	Respiratory-chain NADH dehydrogenase, 30 Kd subunit (PF00329)	Aconitase family (aconitate hydratase) (PF00330)	Glycosyl hydrolase family 10 (PF00331)	Glycosyl hydrolases family 17 (PF00332)	Ribosomal protein S5, N-terminal domain (PF00333)	Nucleoside diphosphate kinase (PF00334)	Tetraspanin family (PF00335)	Ribosomal protein S10p/S20e (PF00338)	Arrestin (or S-antigen), N-terminal domain (PF00339)	Phosphoglucose isomerase (PF00342)	Carbohydrate phosphorylase (PF00343)	SecY translocase (PF00344)	Pili and flagellar-assembly chaperone, PapD N-terminal domain (PF00345)	Respiratory-chain NADH dehydrogenase, 49 Kd subunit (PF00346)	Ribosomal protein L6 (PF00347)	Polyprenyl synthetase (PF00348)	Hexokinase (PF00349)	Dynamin family (PF00350)	Biopterin-dependent aromatic amino acid hydroxylase (PF00351)	Transcription factor TFIID (or TATA-binding protein, TBP) (PF00352)	Hemolysin-type calcium-binding repeat (2 copies) (PF00353)	Pentaxin family (PF00354)	Rieske [2Fe-2S] domain (PF00355)	Bacterial regulatory proteins, lacI family (PF00356)	phosphoenolpyruvate-dependent sugar phosphotransferase system, EIIA 1 (PF00358)	Phosphoenolpyruvate-dependent sugar phosphotransferase system, EIIA 2 (PF00359)	Phytochrome region (PF00360)	NADH-Ubiquinone/plastoquinone (complex I), various chains (PF00361)	Biotin-requiring enzyme (PF00364)	Phosphofructokinase (PF00365)	Ribosomal protein S17 (PF00366)	phosphotransferase system, EIIB (PF00367)	Hydroxymethylglutaryl-coenzyme A reductase (PF00368)	FGGY family of carbohydrate kinases, N-terminal domain (PF00370)	Hemocyanin, copper containing domain (PF00372)	FERM central domain (PF00373)	Nickel-dependent hydrogenase (PF00374)	Sodium:dicarboxylate symporter family (PF00375)	MerR family regulatory protein (PF00376)	Enoyl-CoA hydratase/isomerase family (PF00378)	PF00379	Ribosomal protein S9/S16 (PF00380)	PTS HPr component phosphorylation site (PF00381)	Transcription factor TFIIB repeat (PF00382)	Cytidine and deoxycytidylate deaminase zinc-binding region (PF00383)	Molybdopterin oxidoreductase (PF00384)	Chromo (CHRromatin Organisation MOdifier) domain (PF00385)	C1q domain (PF00386)	Phosphatidylinositol-specific phospholipase C, Y domain (PF00387)	Phosphatidylinositol-specific phospholipase C, X domain (PF00388)	D-isomer specific 2-hydroxyacid dehydrogenase, catalytic domain (PF00389)	Malic enzyme, N-terminal domain (PF00390)	PEP-utilising enzyme, mobile domain (PF00391)	Bacterial regulatory proteins, gntR family (PF00392)	6-phosphogluconate dehydrogenase, C-terminal domain (PF00393)	Multicopper oxidase (PF00394)	S-layer homology domain (PF00395)	WW domain (PF00397)	Ribosomal RNA adenine dimethylase (PF00398)	PF00399	WD domain, G-beta repeat (PF00400)	ATP synthase, Delta/Epsilon chain, long alpha-helix domain (PF00401)	Heavy-metal-associated domain (PF00403)	Dockerin type I repeat (PF00404)	Phosphoglucomutase/phosphomannomutase, C-terminal domain (PF00408)	Ribosomal protein S8 (PF00410)	Ribosomal protein S11 (PF00411)	LIM domain (PF00412)	Matrixin (PF00413)	Regulator of chromosome condensation (RCC1) repeat (PF00415)	Ribosomal protein S13/S18 (PF00416)	Fimbrial protein (PF00419)	NADH-ubiquinone/plastoquinone oxidoreductase chain 4L (PF00420)	Photosystem II protein (PF00421)	chorismate binding enzyme (PF00425)	Phycobilisome Linker polypeptide (PF00427)	60s Acidic ribosomal protein (PF00428)	ATP synthase B/B' CF(0) (PF00430)	CUB domain (PF00431)	Prenyltransferase and squalene oxidase repeat (PF00432)	Protein kinase C terminal domain (PF00433)	Spectrin repeat (PF00435)	Single-strand binding protein family (PF00436)	Type II/IV secretion system protein (PF00437)	S-adenosylmethionine synthetase, N-terminal domain (PF00438)	Bromodomain (PF00439)	Bacterial regulatory proteins, tetR family (PF00440)	Acyl-CoA dehydrogenase, C-terminal domain (PF00441)	Ubiquitin carboxyl-terminal hydrolase (PF00443)	Ribonuclease T2 family (PF00445)	HSF-type DNA-binding (PF00447)	SRP54-type protein, GTPase domain (PF00448)	Urease alpha-subunit, N-terminal domain (PF00449)	Serine carboxypeptidase (PF00450)	Ribosomal protein L20 (PF00453)	Phosphatidylinositol 3- and 4-kinase (PF00454)	PF00455	Transketolase, thiamine diphosphate binding domain (PF00456)	Glycosyl hydrolases family 11 (PF00457)	Inositol monophosphatase family (PF00459)	Flagella basal body rod protein (PF00460)	Glutaredoxin (PF00462)	Isocitrate lyase family (PF00463)	Serine hydroxymethyltransferase (PF00464)	Iron-containing alcohol dehydrogenase (PF00465)	Ribosomal protein L10 (PF00466)	KOW motif (PF00467)	Ribosomal protein L34 (PF00468)	Ribosomal protein L33 (PF00471)	RF-1 domain (PF00472)	Sodium:solute symporter family (PF00474)	Imidazoleglycerol-phosphate dehydratase (PF00475)	DNA polymerase family A (PF00476)	PF00477	IMP dehydrogenase / GMP reductase domain (PF00478)	Glucose-6-phosphate dehydrogenase, NAD binding domain (PF00479)	ROK family (PF00480)	Protein phosphatase 2C (PF00481)	Type II secretion system (T2SS), protein F (PF00482)	Nucleotidyl transferase (PF00483)	Carbonic anhydrase (PF00484)	Phosphoribulokinase / Uridine kinase family (PF00485)	Transcriptional regulatory protein, C terminal (PF00486)	PF00487	MutS domain V (PF00488)	Delta-aminolevulinic acid dehydratase (PF00490)	Arginase family (PF00491)	MCM2/3/5 family (PF00493)	Squalene/phytoene synthase (PF00494)	Bacterial extracellular solute-binding proteins, family 5 Middle (PF00496)	Bacterial extracellular solute-binding proteins, family 3 (PF00497)	FHA domain (PF00498)	NADH-ubiquinone/plastoquinone oxidoreductase chain 6 (PF00499)	AMP-binding enzyme (PF00501)	Phycobilisome protein (PF00502)	G-protein alpha subunit (PF00503)	HMG (high mobility group) box (PF00505)	Influenza virus nucleoprotein (PF00506)	NADH-ubiquinone/plastoquinone oxidoreductase, chain 3 (PF00507)	Haemagglutinin (PF00509)	Cytochrome c oxidase subunit III (PF00510)	His Kinase A (phospho-acceptor) domain (PF00512)	Armadillo/beta-catenin-like repeat (PF00514)	Tetratricopeptide repeat (PF00515)	Ion transport protein (PF00520)	DNA gyrase/topoisomerase IV, subunit A (PF00521)	Fusion glycoprotein F0 (PF00523)	Binding-protein-dependent transport system inner membrane component (PF00528)	HlyD family secretion protein (PF00529)	Scavenger receptor cysteine-rich domain (PF00530)	Death domain (PF00531)	Periplasmic binding proteins and sugar binding domain of LacI family (PF00532)	BRCA1 C Terminus (BRCT) domain (PF00533)	Glycosyl transferases group 1 (PF00534)	Glycosyl transferase family 2 (PF00535)	SAM domain (Sterile alpha motif) (PF00536)	linker histone H1 and H5 family (PF00538)	Ribosomal protein L7/L12 C-terminal domain (PF00542)	Nitrogen regulatory protein P-II (PF00543)	Pectate lyase (PF00544)	ribonuclease (PF00545)	Urease, gamma subunit (PF00547)	CoA-ligase (PF00549)	Phosphopantetheine attachment site (PF00550)	Formyl transferase (PF00551)	Cellulose binding domain (PF00553)	Antenna complex alpha/beta subunit (PF00556)	Metallopeptidase family M24 (PF00557)	Leucine Rich Repeat (PF00560)	alpha/beta hydrolase fold (PF00561)	RNA polymerase Rpb2, domain 6 (PF00562)	EAL domain (PF00563)	PB1 domain (PF00564)	Staphylococcal nuclease homologue (PF00565)	Rab-GTPase-TBC domain (PF00566)	Tudor domain (PF00567)	WH1 domain (PF00568)	Zinc finger, ZZ type (PF00569)	HRDC domain (PF00570)	CBS domain (PF00571)	Ribosomal protein L13 (PF00572)	Ribosomal protein L4/L1 family (PF00573)	Clp protease (PF00574)	S1 RNA binding domain (PF00575)	HIUase/Transthyretin family (PF00576)	Outer membrane usher protein (PF00577)	AhpC/TSA family (PF00578)	tRNA synthetases class I (W and Y) (PF00579)	UvrD/REP helicase N-terminal domain (PF00580)	Rhodanese-like domain (PF00581)	Universal stress protein family (PF00582)	Acetyltransferase (GNAT) family (PF00583)	SecE/Sec61-gamma subunits of protein translocation complex (PF00584)	C-terminal regulatory domain of Threonine dehydratase (PF00585)	AIR synthase related protein, N-terminal domain (PF00586)	tRNA synthetase class II core domain (G, H, P, S and T) (PF00587)	SpoU rRNA Methylase family (PF00588)	Phage integrase family (PF00589)	Tetrapyrrole (Corrin/Porphyrin) Methylases (PF00590)	Glycosyl transferase family, a/b domain (PF00591)	TonB dependent receptor (PF00593)	PDZ domain (Also known as DHR or GLGF) (PF00595)	Class II Aldolase and Adducin N-terminal domain (PF00596)	Influenza Matrix protein (M1) (PF00598)	Influenza Matrix protein (M2) (PF00599)	Influenza non-structural protein (NS1) (PF00600)	Influenza non-structural protein (NS2) (PF00601)	Influenza RNA-dependent RNA polymerase subunit PB1 (PF00602)	Influenza RNA-dependent RNA polymerase subunit PA (PF00603)	Influenza RNA-dependent RNA polymerase subunit PB2 (PF00604)	PF00609	Domain found in Dishevelled, Egl-10, and Pleckstrin (DEP) (PF00610)	Fes/CIP4, and EFC/F-BAR homology domain (PF00611)	IQ calmodulin-binding motif (PF00612)	Phosphoinositide 3-kinase family, accessory domain (PIK domain) (PF00613)	Phospholipase D Active site motif (PF00614)	Regulator of G protein signaling domain (PF00615)	GTPase-activator protein for Ras-like GTPase (PF00616)	RasGEF domain (PF00617)	RasGEF N-terminal motif (PF00618)	RhoGAP domain (PF00620)	RhoGEF domain (PF00621)	SPRY domain (PF00622)	RNA polymerase Rpb1, domain 2 (PF00623)	Guanylate kinase (PF00625)	Gelsolin repeat (PF00626)	UBA/TS-N domain (PF00627)	PHD-finger (PF00628)	MAM domain (PF00629)	Filamin/ABP280 repeat (PF00630)	GGL domain (PF00631)	HECT-domain (ubiquitin-transferase) (PF00632)	Helix-hairpin-helix motif (PF00633)	MSP (Major sperm protein) domain (PF00635)	Ribonuclease III domain (PF00636)	Region in Clathrin and VPS (PF00637)	RanBP1 domain (PF00638)	PPIC-type PPIASE domain (PF00639)	Phosphotyrosine interaction domain (PTB/PID) (PF00640)	Zn-finger in Ran binding protein and others (PF00641)	Zinc finger C-x8-C-x5-C-x3-H type (and similar) (PF00642)	B-box zinc finger (PF00643)	Poly(ADP-ribose) polymerase catalytic domain (PF00644)	Poly(ADP-ribose) polymerase and DNA-Ligase Zn-finger region (PF00645)	F-box domain (PF00646)	Elongation factor 1 gamma, conserved domain (PF00647)	Calpain family cysteine protease (PF00648)	Copper fist DNA binding domain (PF00649)	CRAL/TRIO domain (PF00650)	BTB/POZ domain (PF00651)	Ricin-type beta-trefoil lectin domain (PF00652)	Inhibitor of Apoptosis domain (PF00653)	Voltage gated chloride channel (PF00654)	Caspase domain (PF00656)	GDSL-like Lipase/Acylhydrolase (PF00657)	Poly-adenylate binding protein, unique domain (PF00658)	POLO box duplicated region (PF00659)	NADH-Ubiquinone oxidoreductase (complex I), chain 5 N-terminus (PF00662)	ABC transporter transmembrane region (PF00664)	Integrase core domain (PF00665)	FAD binding domain (PF00667)	Condensation domain (PF00668)	Bacterial flagellin N-terminal helical region (PF00669)	S-adenosyl-L-homocysteine hydrolase, NAD binding domain (PF00670)	HAMP domain (PF00672)	ribosomal L5P family C-terminus (PF00673)	Insulinase (Peptidase family M16) (PF00675)	Dehydrogenase E1 component (PF00676)	Lumazine binding domain (PF00677)	Elongation factor G C-terminus (PF00679)	Plectin repeat (PF00681)	HMGL-like (PF00682)	DnaJ central domain (PF00684)	Sulfotransferase domain (PF00685)	Starch binding domain (PF00686)	Ribosomal protein L1p/L10e family (PF00687)	TGF-beta propeptide (PF00688)	Cation transporting ATPase, C-terminus (PF00689)	Cation transporter/ATPase, N-terminus (PF00690)	OmpA family (PF00691)	dUTPase (PF00692)	Aconitase C-terminal domain (PF00694)	Amino acid kinase family (PF00696)	N-(5'phosphoribosyl)anthranilate (PRA) isomerase (PF00697)	Acyl transferase domain (PF00698)	Urease beta subunit (PF00699)	Bacterial flagellin C-terminal helical region (PF00700)	Dihydrodipicolinate synthetase family (PF00701)	haloacid dehalogenase-like hydrolase (PF00702)	Glycosyl hydrolases family 2 (PF00703)	Glycosyl hydrolases family 18 (PF00704)	Proliferating cell nuclear antigen, N-terminal domain (PF00705)	Translation initiation factor IF-3, C-terminal domain (PF00707)	Acylphosphatase (PF00708)	Adenylosuccinate synthetase (PF00709)	Asparaginase (PF00710)	DNA polymerase III beta subunit, N-terminal domain (PF00712)	Peptidase S24-like (PF00717)	Inorganic pyrophosphatase (PF00719)	Glycosyl hydrolases family 16 (PF00722)	Glycosyl hydrolases family 15 (PF00723)	NADH:flavin oxidoreductase / NADH oxidase family (PF00724)	3-hydroxyacyl-CoA dehydrogenase, C-terminal domain (PF00725)	Glycosyl hydrolase family 20, catalytic domain (PF00728)	HhH-GPD superfamily base excision DNA repair protein (PF00730)	AIR carboxylase (PF00731)	GMC oxidoreductase (PF00732)	Asparagine synthase (PF00733)	Fungal cellulose binding domain (PF00734)	Septin (PF00735)	EF-1 guanine nucleotide exchange domain (PF00736)	PF00741	Homoserine dehydrogenase (PF00742)	Flavin-binding monooxygenase-like (PF00743)	Glutamyl-tRNAGlu reductase, dimerisation domain (PF00745)	PF00746	tRNA synthetases class I (E and Q), catalytic domain (PF00749)	tRNA synthetases class I (R) (PF00750)	XPG N-terminal domain (PF00752)	Metallo-beta-lactamase superfamily (PF00753)	F5/8 type C domain (PF00754)	Choline/Carnitine o-acyltransferase (PF00755)	Putative esterase (PF00756)	Furin-like cysteine rich region (PF00757)	Glycosyl hydrolase family 9 (PF00759)	Ferrochelatase (PF00762)	Tetrahydrofolate dehydrogenase/cyclohydrolase, catalytic domain (PF00763)	Arginosuccinate synthase (PF00764)	Autoinducer synthetase (PF00765)	Electron transfer flavoprotein FAD-binding domain (PF00766)	D-alanyl-D-alanine carboxypeptidase (PF00768)	FHIPEP family (PF00771)	DnaB-like helicase N terminal domain (PF00772)	Dioxygenase (PF00775)	PF00780	Diacylglycerol kinase catalytic domain (PF00781)	Dual specificity phosphatase, catalytic domain (PF00782)	MyTH4 domain (PF00784)	P21-Rho-binding domain (PF00786)	PX domain (PF00787)	Ras association (RalGDS/AF-6) domain (PF00788)	UBX domain (PF00789)	VHS domain (PF00790)	ZU5 domain (PF00791)	Phosphoinositide 3-kinase C2 (PF00792)	DAHP synthetase I family (PF00793)	Carbon-nitrogen hydrolase (PF00795)	N-acetyltransferase (PF00797)	Prephenate dehydratase (PF00800)	PKD domain (PF00801)	PF00803	Syntaxin (PF00804)	Pentapeptide repeats (8 copies) (PF00805)	Pumilio-family RNA binding repeat (PF00806)	Histone-like transcription factor (CBF/NF-Y) and archaeal histone (PF00808)	Pterin binding enzyme (PF00809)	PF00810	PF00813	Glycoprotease family (PF00814)	Histidinol dehydrogenase (PF00815)	H-NS histone family (PF00816)	impB/mucB/samB family (PF00817)	PF00818	Phosphoenolpyruvate carboxykinase (PF00821)	PPE family (PF00823)	Ribonuclease P (PF00825)	Ribosomal L15 (PF00827)	Ribosomal protein L18e/L15 (PF00828)	Ribosomal prokaryotic L21 protein (PF00829)	Ribosomal L28 family (PF00830)	Ribosomal L29 protein (PF00831)	Ribosomal S17 (PF00833)	Ribulose-phosphate 3 epimerase family (PF00834)	Translationally controlled tumour protein (PF00838)	Glycosyl hydrolase family 7 (PF00840)	Alanine racemase, C-terminal domain (PF00842)	AP2 domain (PF00847)	Ring hydroxylating alpha subunit (catalytic domain) (PF00848)	RNA pseudouridylate synthase (PF00849)	Histone deacetylase domain (PF00850)	Glycosyltransferase family 10 (fucosyltransferase) (PF00852)	Runt domain (PF00853)	POT family (PF00854)	PWWP domain (PF00855)	SET domain (PF00856)	Isochorismatase family (PF00857)	Amiloride-sensitive sodium channel (PF00858)	Permease family (PF00860)	Ribosomal L18p/L5e family (PF00861)	Sucrose synthase (PF00862)	Ring hydroxylating beta subunit (PF00866)	XPG I-region (PF00867)	Transglutaminase family (PF00868)	Acetokinase family (PF00871)	PF00872	AcrB/AcrD/AcrF family (PF00873)	PRD domain (PF00874)	DNA photolyase (PF00875)	PF00876	NlpC/P60 family (PF00877)	Nitroreductase family (PF00881)	Zinc dependent phospholipase C (PF00882)	Cytosol aminopeptidase family, catalytic domain (PF00883)	Sulfatase (PF00884)	6,7-dimethyl-8-ribityllumazine synthase (PF00885)	Ribosomal protein S16 (PF00886)	Acyl CoA binding protein (PF00887)	Cullin family (PF00888)	Elongation factor TS (PF00889)	FAD binding domain (PF00890)	O-methyltransferase (PF00891)	EamA-like transporter family (PF00892)	Small Multidrug Resistance protein (PF00893)	ThiF family (PF00899)	Ribosomal family S4e (PF00900)	Sec-independent protein translocase protein (TatC) (PF00902)	Glyoxalase/Bleomycin resistance protein/Dioxygenase superfamily (PF00903)	Penicillin binding protein transpeptidase domain (PF00905)	dTDP-4-dehydrorhamnose 3,5-epimerase (PF00908)	Ammonium Transporter Family (PF00909)	Transglycosylase (PF00912)	PF00916	MATH domain (PF00917)	Uncharacterized protein family UPF0004 (PF00919)	Dehydratase family (PF00920)	Transaldolase (PF00923)	Mechanosensitive ion channel (PF00924)	GTP cyclohydrolase II (PF00925)	3,4-dihydroxy-2-butanone 4-phosphate synthase (PF00926)	Transglutaminase family, C-terminal ig like domain (PF00927)	Adaptor complexes medium subunit family (PF00928)	Exonuclease (PF00929)	Dipeptidyl peptidase IV (DPP IV) N-terminal region (PF00930)	NB-ARC domain (PF00931)	Lamin Tail Domain (PF00932)	Glycosyl hydrolase family 3 N terminal domain (PF00933)	PE family (PF00934)	Ribosomal protein L44 (PF00935)	BMC domain (PF00936)	Sodium:sulfate symporter transmembrane region (PF00939)	DNA-dependent RNA polymerase (PF00940)	FAD binding domain in molybdopterin dehydrogenase (PF00941)	Cellulose binding domain (PF00942)	PF00946	PF00950	Glycosyl transferase family 4 (PF00953)	HCO3- transporter family (PF00955)	Nucleosome assembly protein (NAP) (PF00956)	Synaptobrevin (PF00957)	GMP synthase C terminal domain (PF00958)	Phage lysozyme (PF00959)	LAGLIDADG endonuclease (PF00961)	Adenosine/AMP deaminase (PF00962)	Cohesin domain (PF00963)	Oxidoreductase FAD-binding domain (PF00970)	Thioesterase domain (PF00975)	Histidine biosynthesis protein (PF00977)	Glycosyltransferase family 20 (PF00982)	UDP-glucose/GDP-mannose dehydrogenase family, central domain (PF00984)	DNA gyrase B subunit, carboxyl terminus (PF00986)	Carbamoyl-phosphate synthase small chain, CPSase domain (PF00988)	PAS fold (PF00989)	GGDEF domain (PF00990)	Probable molybdopterin binding domain (PF00994)	Sec1 family (PF00995)	GDP dissociation inhibitor (PF00996)	Sodium/hydrogen exchanger family (PF00999)	RNA polymerase Rpb3/RpoA insert domain (PF01000)	Flavivirus non-structural protein NS2B (PF01002)	Inward rectifier potassium channel (PF01007)	Initiation factor 2 subunit family (PF01008)	PF01010	PQQ enzyme repeat (PF01011)	Electron transfer flavoprotein domain (PF01012)	Uricase (PF01014)	Ribosomal S3Ae family (PF01015)	Ribosomal L27 protein (PF01016)	STAT protein, all-alpha domain (PF01017)	GTP1/OBG (PF01018)	Gamma-glutamyltranspeptidase (PF01019)	Ribosomal L40e family (PF01020)	Bacterial regulatory protein, arsR family (PF01022)	Colicin pore forming domain (PF01024)	GrpE (PF01025)	TatD related DNase (PF01026)	Inhibitor of apoptosis-promoting Bax1 (PF01027)	Eukaryotic DNA topoisomerase I, catalytic core (PF01028)	NusB family (PF01029)	Receptor L domain (PF01030)	Dynamin central region (PF01031)	FecCD transport family (PF01032)	6-O-methylguanine DNA methyltransferase, DNA binding domain (PF01035)	Bacteriorhodopsin-like protein (PF01036)	AsnC family (PF01037)	Carboxyl transferase domain (PF01039)	UbiA prenyltransferase family (PF01040)	DegT/DnrJ/EryC1/StrS aminotransferase family (PF01041)	Endoribonuclease L-PSP (PF01042)	SecA preprotein cross-linking domain (PF01043)	Vinculin family (PF01044)	MarR family (PF01047)	Phosphorylase superfamily (PF01048)	Cadherin cytoplasmic region (PF01049)	Mannose-6-phosphate isomerase (PF01050)	Initiator Replication protein (PF01051)	Surface presentation of antigens (SPOA) (PF01052)	Cys/Met metabolism PLP-dependent enzyme (PF01053)	Glycosyl hydrolases family 31 (PF01055)	NADH ubiquinone oxidoreductase, 20 Kd subunit (PF01058)	PF01059	PF01061	PF01062	Aminotransferase class IV (PF01063)	Activin types I and II receptor domain (PF01064)	CDP-alcohol phosphatidyltransferase (PF01066)	Calpain large subunit, domain III (PF01067)	ATP dependent DNA ligase domain (PF01068)	FMN-dependent dehydrogenase (PF01070)	Phosphoribosylglycinamide synthetase, ATP-grasp (A) domain (PF01071)	3-beta hydroxysteroid dehydrogenase/isomerase family (PF01073)	Glycosyl hydrolases family 38 N-terminal domain (PF01074)	Glycosyltransferase family 9 (heptosyltransferase) (PF01075)	PF01076	Nitrite and sulphite reductase 4Fe-4S domain (PF01077)	Magnesium chelatase, subunit ChlI (PF01078)	KDPG and KHG aldolase (PF01081)	Copper type II ascorbate-dependent monooxygenase, N-terminal domain (PF01082)	Cutinase (PF01083)	Ribosomal protein S18 (PF01084)	Galactose-1-phosphate uridyl transferase, N-terminal domain (PF01087)	Ubiquitin carboxyl-terminal hydrolase, family 1 (PF01088)	Ribosomal protein S19e (PF01090)	Ribosomal protein S6e (PF01092)	Receptor family ligand binding region (PF01094)	Pectinesterase (PF01095)	Transcription factor S-II (TFIIS) (PF01096)	PF01098	Surface antigen (PF01103)	PF01105	NifU-like domain (PF01106)	PF01107	Cyclin-dependent kinase regulatory subunit (PF01111)	Asparaginase (PF01112)	Dihydrodipicolinate reductase, N-terminus (PF01113)	Fructose-bisphosphate aldolase class-II (PF01116)	Semialdehyde dehydrogenase, NAD binding domain (PF01118)	DNA mismatch repair protein, C-terminal domain (PF01119)	Alpha-L-fucosidase (PF01120)	Dephospho-CoA kinase (PF01121)	MAPEG family (PF01124)	PF01125	Heme oxygenase (PF01126)	Succinate dehydrogenase/Fumarate reductase transmembrane subunit (PF01127)	2-C-methyl-D-erythritol 4-phosphate cytidylyltransferase (PF01128)	NAD:arginine ADP-ribosyltransferase (PF01129)	DNA topoisomerase (PF01131)	Elongation factor P (EF-P) OB domain (PF01132)	Glucose inhibited division protein A (PF01134)	Protein-L-isoaspartate(D-aspartate) O-methyltransferase (PCMT) (PF01135)	PF01136	RNA 3'-terminal phosphate cyclase (PF01137)	3' exoribonuclease family, domain 1 (PF01138)	tRNA-splicing ligase RtcB (PF01139)	Matrix protein (MA), p15 (PF01140)	tRNA pseudouridine synthase D (TruD) (PF01142)	Coenzyme A transferase (PF01144)	SPFH domain / Band 7 family (PF01145)	Cytidylyltransferase family (PF01148)	Formamidopyrimidine-DNA glycosylase N-terminal domain (PF01149)	GDA1/CD39 (nucleoside phosphatase) family (PF01150)	PF01151	Bacterial-like globin (PF01152)	Glypican (PF01153)	Hydroxymethylglutaryl-coenzyme A synthase N terminal (PF01154)	Hydrogenase expression/synthesis hypA family (PF01155)	Inosine-uridine preferring nucleoside hydrolase (PF01156)	Ribosomal protein L21e (PF01157)	Ribosomal protein L6e (PF01159)	Phosphatidylethanolamine-binding protein (PF01161)	RIO1 family (PF01163)	Ribosomal protein S21 (PF01165)	TSC-22/dip/bun family (PF01166)	Tub family (PF01167)	Alanine racemase, N-terminal domain (PF01168)	PF01169	Putative RNA methylase family UPF0020 (PF01170)	PP-loop family (PF01171)	Shwachman-Bodian-Diamond syndrome (SBDS) protein (PF01172)	SNO glutamine amidotransferase family (PF01174)	Urocanase (PF01175)	Translation initiation factor 1A / IF-1 (PF01176)	Asp/Glu/Hydantoin racemase (PF01177)	Copper amine oxidase, enzyme domain (PF01179)	Dihydroorotate dehydrogenase (PF01180)	Glucosamine-6-phosphate isomerases/6-phosphogluconolactonase (PF01182)	Glycosyl hydrolases family 25 (PF01183)	PF01184	PF01186	Macrophage migration inhibitory factor (MIF) (PF01187)	Mandelate racemase / muconate lactonizing enzyme, C-terminal domain (PF01188)	NOL1/NOP2/sun family (PF01189)	RNA polymerase Rpb5, C-terminal domain (PF01191)	RNA polymerase Rpb6 (PF01192)	RNA polymerase Rpb3/Rpb11 dimerisation domain (PF01193)	Peptidyl-tRNA hydrolase (PF01195)	Ribosomal protein L17 (PF01196)	Ribosomal protein L31 (PF01197)	Ribosomal protein L31e (PF01198)	Ribosomal protein L34e (PF01199)	Ribosomal protein S8e (PF01201)	Shikimate kinase (PF01202)	PF01203	Trehalase (PF01204)	Uncharacterized protein family UPF0029 (PF01205)	Sulfurtransferase TusA (PF01206)	Dihydrouridine synthase (Dus) (PF01207)	Uroporphyrinogen decarboxylase (URO-D) (PF01208)	ubiE/COQ5 methyltransferase family (PF01209)	NAD-dependent glycerol-3-phosphate dehydrogenase N-terminus (PF01210)	Beta-eliminating lyase (PF01212)	Adenylate cyclase associated (CAP) N terminal (PF01213)	Casein kinase II regulatory subunit (PF01214)	Clathrin adaptor complex small chain (PF01217)	Coproporphyrinogen III oxidase (PF01218)	Prokaryotic diacylglycerol kinase (PF01219)	Dehydroquinase class II (PF01220)	PF01222	DNA/RNA non-specific endonuclease (PF01223)	Mur ligase family, catalytic domain (PF01225)	Formate/nitrite transporter (PF01226)	GTP cyclohydrolase I (PF01227)	Glycine radical (PF01228)	Glycosyl hydrolases family 39 (PF01229)	HIT domain (PF01230)	Indoleamine 2,3-dioxygenase (PF01231)	Mannitol dehydrogenase Rossmann domain (PF01232)	Myristoyl-CoA:protein N-myristoyltransferase, N-terminal domain (PF01233)	PF01235	Oxysterol-binding protein (PF01237)	Phosphomannose isomerase type I (PF01238)	Protein prenyltransferase alpha subunit repeat (PF01239)	6-pyruvoyl tetrahydropterin synthase (PF01242)	Pyridoxamine 5'-phosphate oxidase (PF01243)	Membrane dipeptidase (Peptidase family M19) (PF01244)	Ribosomal protein L19 (PF01245)	Ribosomal protein L24e (PF01246)	Ribosomal protein L7Ae/L30e/S12e/Gadd45 family (PF01248)	Ribosomal protein S21e (PF01249)	Ribosomal protein S6 (PF01250)	Ribosomal protein S7e (PF01251)	PF01252	Translation initiation factor SUI1 (PF01253)	Putative undecaprenyl diphosphate synthase (PF01255)	Carbohydrate kinase (PF01256)	Prokaryotic dksA/traR C4-type zinc finger (PF01258)	SAICAR synthetase (PF01259)	Xylose isomerase-like TIM barrel (PF01261)	Alanine dehydrogenase/PNT, C-terminal domain (PF01262)	Aldose 1-epimerase (PF01263)	Chorismate synthase (PF01264)	PF01265	FAD dependent oxidoreductase (PF01266)	F-actin capping protein alpha subunit (PF01267)	Formate--tetrahydrofolate ligase (PF01268)	Fibrillarin (PF01269)	Glycosyl hydrolases family 8 (PF01270)	Transcription elongation factor, GreA/GreB, C-term (PF01272)	Malate synthase (PF01274)	Orn/Lys/Arg decarboxylase, major domain (PF01276)	Omptin family (PF01278)	Ribosomal protein L19e (PF01280)	Ribosomal protein L9, N-terminal domain (PF01281)	Ribosomal protein S24e (PF01282)	PF01284	TEA/ATTS domain family (PF01285)	Eukaryotic elongation factor 5A hypusine, DNA-binding OB fold (PF01287)	7,8-dihydro-6-hydroxymethylpterin-pyrophosphokinase (HPPK) (PF01288)	Prokaryotic cytochrome b561 (PF01292)	Phosphoenolpyruvate carboxykinase (PF01293)	Ribosomal protein L13e (PF01294)	PF01295	Periplasmic solute binding protein family (PF01297)	Telomere recombination (PF01300)	Glycosyl hydrolases family 35 (PF01301)	CAP-Gly domain (PF01302)	LacY proton/sugar symporter (PF01306)	PF01311	FlhB HrpN YscU SpaS Family (PF01312)	PF01313	Aldehyde ferredoxin oxidoreductase, domains 2 & 3 (PF01314)	Aldehyde oxidase and xanthine dehydrogenase, a/b hammerhead domain (PF01315)	Arginine repressor, DNA binding domain (PF01316)	Creatinase/Prolidase N-terminal domain (PF01321)	Cytochrome C' (PF01322)	DSBA-like thioredoxin domain (PF01323)	Iron dependent repressor, N-terminal DNA binding domain (PF01325)	Pyruvate phosphate dikinase, PEP/pyruvate binding domain (PF01326)	Polypeptide deformylase (PF01327)	Peroxidase, family 2 (PF01328)	Pterin 4 alpha carbinolamine dehydratase (PF01329)	RuvA N terminal domain (PF01330)	mRNA capping enzyme, catalytic domain (PF01331)	Apocytochrome F, C-terminal (PF01333)	OB-fold nucleic acid binding domain (PF01336)	Barstar (barnase inhibitor) (PF01337)	CheB methylesterase (PF01339)	Met Apo-repressor, MetJ (PF01340)	Glycosyl hydrolases family 6 (PF01341)	Peptidase family S49 (PF01343)	Kelch motif (PF01344)	PF01345	Domain amino terminal to FKBP-type peptidyl-prolyl isomerase (PF01346)	Lipoprotein amino terminal region (PF01347)	PF01348	Ribonuclease HII (PF01351)	KRAB box (PF01352)	Transposase (partial DDE domain) (PF01359)	Tautomerase enzyme (PF01361)	FYVE zinc finger (PF01363)	Peptidase family C25 (PF01364)	RIH domain (PF01365)	5'-3' exonuclease, C-terminal SAM fold (PF01367)	DHH family (PF01368)	Sec7 domain (PF01369)	NAD dependent epimerase/dehydratase family (PF01370)	Trp repressor protein (PF01371)	Glycosyl hydrolase family 14 (PF01373)	Glycosyl hydrolase family 46 (PF01374)	Porphobilinogen deaminase, dipyromethane cofactor binding domain (PF01379)	SIS domain (PF01380)	Helix-turn-helix (PF01381)	CpcD/allophycocyanin linker domain (PF01383)	PF01384	PF01385	Ribosomal L25p family (PF01386)	ARID/BRIGHT DNA binding domain (PF01388)	OmpA-like transmembrane domain (PF01389)	Collagen triple helix repeat (20 copies) (PF01391)	Fz domain (PF01392)	Chromo shadow domain (PF01393)	Clathrin propeller repeat (PF01394)	PF01396	JAB1/Mov34/MPN/PAD-1 ubiquitin protease (PF01398)	PCI domain (PF01399)	Astacin (Peptidase family M12A) (PF01400)	Angiotensin-converting enzyme (PF01401)	Ribbon-helix-helix protein, copG family (PF01402)	Sema domain (PF01403)	Ephrin receptor ligand binding domain (PF01404)	tRNA synthetases class I (C) catalytic domain (PF01406)	Oxidoreductase family, NAD-binding Rossmann fold (PF01408)	tRNA synthetases class II core domain (F) (PF01409)	Fibrillar collagen C-terminal domain (PF01410)	tRNA synthetases class II (A) (PF01411)	Putative GTPase activating protein for Arf (PF01412)	tRNA pseudouridine synthase (PF01416)	ENTH domain (PF01417)	Helix-turn-helix domain, rpiR family (PF01418)	Type I restriction modification DNA specificity domain (PF01420)	Reprolysin (M12B) family zinc metalloprotease (PF01421)	PF01422	LSM domain (PF01423)	R3H domain (PF01424)	Amidase (PF01425)	BAH domain (PF01426)	D-ala-D-ala dipeptidase (PF01427)	AN1-like Zinc finger (PF01428)	Hsp33 protein (PF01430)	Peptidase family M13 (PF01431)	Peptidase family M3 (PF01432)	Peptidase family M1 (PF01433)	Peptidase family M41 (PF01434)	Peptidase family M48 (PF01435)	NHL repeat (PF01436)	Plexin repeat (PF01437)	Apolipoprotein A1/A4/E domain (PF01442)	Viral (Superfamily 1) RNA helicase (PF01443)	PF01446	Thermolysin metallopeptidase, catalytic domain (PF01447)	ELM2 domain (PF01448)	Acetohydroxy acid isomeroreductase, catalytic domain (PF01450)	Low molecular weight phosphotyrosine protein phosphatase (PF01451)	D-mannose binding lectin (PF01453)	MAGE family (PF01454)	HupF/HypC family (PF01455)	Leishmanolysin (PF01457)	Uncharacterized protein family (UPF0051) (PF01458)	Eukaryotic porin (PF01459)	Leucine rich repeat N-terminal domain (PF01462)	Transglycosylase SLT domain (PF01464)	GRIP domain (PF01465)	Skp1 family, dimerisation domain (PF01466)	Cytidylyltransferase (PF01467)	GA module (PF01468)	PF01469	Pyroglutamyl peptidase (PF01470)	Putative peptidoglycan binding domain (PF01471)	PUA domain (PF01472)	Putative cell wall binding repeat (PF01473)	Class-II DAHP synthetase family (PF01474)	Ferric uptake regulator family (PF01475)	LysM domain (PF01476)	PLAT/LH2 domain (PF01477)	Type IV leader peptidase family (PF01478)	S4 domain (PF01479)	PWI domain (PF01480)	Proprotein convertase P-domain (PF01483)	IBR domain (PF01485)	Type I 3-dehydroquinase (PF01487)	Shikimate / quinate 5-dehydrogenase (PF01488)	PF01490	Frataxin-like domain (PF01491)	GXGXG motif (PF01493)	FAD binding domain (PF01494)	V-type ATPase 116kDa subunit family (PF01496)	Periplasmic binding protein (PF01497)	Transposase (PF01498)	Glycosyl transferase family 8 (PF01501)	Phosphoribosyl-AMP cyclohydrolase (PF01502)	Phosphoribosyl-ATP pyrophosphohydrolase (PF01503)	Phosphatidylinositol-4-phosphate 5-Kinase (PF01504)	Phosphoadenosine phosphosulfate reductase family (PF01507)	TruB family pseudouridylate synthase (N terminal domain) (PF01509)	N-acetylmuramoyl-L-alanine amidase (PF01510)	Respiratory-chain NADH dehydrogenase 51 Kd subunit (PF01512)	ATP-NAD kinase (PF01513)	Secretory protein of YscJ/FliF family (PF01514)	Phosphate acetyl/butaryl transferase (PF01515)	N-acetylmuramoyl-L-alanine amidase (PF01520)	Iron-sulphur cluster biosynthesis (PF01521)	Polysaccharide deacetylase (PF01522)	Putative modulator of DNA gyrase (PF01523)	PF01526	Transposase (PF01527)	PF01529	PF01531	Glycosyl hydrolase family 47 (PF01532)	PPR repeat (PF01535)	Adenosylmethionine decarboxylase (PF01536)	GIY-YIG catalytic domain (PF01541)	Hepatitis C virus core protein (PF01542)	CorA-like Mg2+ transporter protein (PF01544)	Cation efflux family (PF01545)	Peptidase family M20/M25/M40 (PF01546)	Bacterial extracellular solute-binding protein (PF01547)	PF01548	Peptidase family M23 (PF01551)	Acyltransferase (PF01553)	MatE (PF01554)	DNA methylase (PF01555)	DnaJ C terminal domain (PF01556)	Fumarylacetoacetate (FAA) hydrolase family (PF01557)	Pyruvate ferredoxin/flavodoxin oxidoreductase (PF01558)	PF01562	Spermine/spermidine synthase (PF01564)	FAD binding domain (PF01565)	PF01566	Molydopterin dinucleotide binding domain (PF01568)	PAP2 superfamily (PF01569)	Aminomethyltransferase folate-binding domain (PF01571)	MaoC like domain (PF01575)	Myosin tail (PF01576)	PF01578	FtsK/SpoIIIE family (PF01580)	TIR domain (PF01582)	Adenylylsulphate kinase (PF01583)	CheW-like domain (PF01584)	PF01585	Putative tRNA binding domain (PF01588)	GAF domain (PF01590)	6-phosphofructo-2-kinase (PF01591)	NifU-like N terminal domain (PF01592)	Flavin containing amine oxidoreductase (PF01593)	PF01594	PF01595	O-methyltransferase (PF01596)	Glycine cleavage H-protein (PF01597)	Ribosomal protein S27a (PF01599)	Adaptin N terminal region (PF01602)	Protein phosphatase 2A regulatory B subunit (B56 family) (PF01603)	Chitin binding Peritrophin-A domain (PF01607)	I/LWEQ domain (PF01608)	Transposase DDE domain (PF01609)	PF01610	3'-5' exonuclease (PF01612)	Flavin reductase like domain (PF01613)	Bacterial transcriptional regulator (PF01614)	PF01618	Proline dehydrogenase (PF01619)	MutS domain I (PF01624)	Peptide methionine sulfoxide reductase (PF01625)	Hpt domain (PF01627)	HrcA protein C terminal domain (PF01628)	Ribosomal protein L35 (PF01632)	ATP phosphoribosyltransferase (PF01634)	Phosphotransferase enzyme family (PF01636)	Archaeal ATPase (PF01637)	HxlR-like helix-turn-helix (PF01638)	SelR domain (PF01641)	Methylmalonyl-CoA mutase (PF01642)	Acyl-ACP thioesterase (PF01643)	PF01644	Conserved region in glutamate synthase (PF01645)	4'-phosphopantetheinyl transferase superfamily (PF01648)	Ribosomal protein S20 (PF01649)	Peptidase C13 family (PF01650)	Eukaryotic initiation factor 4E (PF01652)	NAD-dependent DNA ligase adenylation domain (PF01653)	PF01654	Ribosomal protein L32 (PF01655)	CobQ/CobB/MinD/ParA nucleotide binding domain (PF01656)	Salt stress response/antifungal (PF01657)	Myo-inositol-1-phosphate synthase (PF01658)	Macro domain (PF01661)	Type I phosphodiesterase / nucleotide pyrophosphatase (PF01663)	Ribosomal protein S27 (PF01667)	SmpB protein (PF01668)	Glycosyl hydrolase family 12 (PF01670)	Lipase (class 2) (PF01674)	Metalloenzyme superfamily (PF01676)	Diaminopimelate epimerase (PF01678)	PF01679	SOR/SNZ family (PF01680)	Adenovirus penton base protein (PF01686)	Riboflavin kinase (PF01687)	PF01690	Caulimovirus viroplasmin (PF01693)	Rhomboid family (PF01694)	IstB-like ATP binding protein (PF01695)	PF01697	Sodium/calcium exchanger protein (PF01699)	Queuine tRNA-ribosyltransferase (PF01702)	UTP--glucose-1-phosphate uridylyltransferase (PF01704)	Transcriptional regulator (PF01709)	Transposase (PF01710)	Deoxynucleoside kinase (PF01712)	Smr domain (PF01713)	IPP transferase (PF01715)	Manganese-stabilising protein / photosystem II polypeptide (PF01716)	Cobalamin-independent synthase, Catalytic domain (PF01717)	Plasmid replication protein (PF01719)	BolA-like protein (PF01722)	Domain of unknown function DUF29 (PF01724)	Ham1 family (PF01725)	LexA DNA binding domain (PF01726)	FtsJ-like methyltransferase (PF01728)	Quinolinate phosphoribosyl transferase, C-terminal domain (PF01729)	UreF (PF01730)	Arylesterase (PF01731)	PF01733	Patatin-like phospholipase (PF01734)	Lysophospholipase catalytic domain (PF01735)	Dienelactone hydrolase family (PF01738)	CheR methyltransferase, SAM binding domain (PF01739)	STAS domain (PF01740)	Large-conductance mechanosensitive channel, MscL (PF01741)	Poly A polymerase head domain (PF01743)	PF01744	tRNA (Guanine-1)-methyltransferase (PF01746)	ATP-sulfurylase (PF01747)	Importin beta binding domain (PF01749)	Hydrogenase maturation protease (PF01750)	Toprim domain (PF01751)	MYND finger (PF01753)	PF01755	Acyl-CoA oxidase (PF01756)	PF01757	Sodium Bile acid symporter family (PF01758)	Galactosyltransferase (PF01762)	Lipase (class 3) (PF01764)	Ribosome recycling factor (PF01765)	Divalent cation transporter (PF01769)	Na+ dependent nucleoside transporter N-terminus (PF01773)	UreD urease accessory protein (PF01774)	Ribosomal L18ae/LX protein domain (PF01775)	Ribosomal L22e protein family (PF01776)	Ribosomal L27e protein family (PF01777)	Ribosomal L28e protein family (PF01778)	Ribosomal L29e protein family (PF01779)	Ribosomal L37ae protein family (PF01780)	RimM N-terminal domain (PF01782)	Ribosomal L32p protein family (PF01783)	NIF3 (NGG1p interacting factor 3) (PF01784)	Alternative oxidase (PF01786)	PsbP (PF01789)	PF01790	DeoC/LacD family aldolase (PF01791)	Glycolipid 2-alpha-mannosyltransferase (PF01793)	PF01794	MraW methylase family (PF01795)	PF01796	Transposase IS200 like (PF01797)	Putative snoRNA binding domain (PF01798)	[2Fe-2S] binding domain (PF01799)	PF01803	Penicillin amidase (PF01804)	Surp module (PF01805)	CHC2 zinc finger (PF01807)	AICARFT/IMPCHase bienzyme (PF01808)	PF01809	PF01810	5-formyltetrahydrofolate cyclo-ligase family (PF01812)	ATP synthase subunit D (PF01813)	Hemerythrin HHE cation binding domain (PF01814)	Leucine rich repeat variant (PF01816)	Chorismate mutase type II (PF01817)	D-ala D-ala ligase N-terminus (PF01820)	PF01822	MAC/Perforin domain (PF01823)	Latrophilin/CL-1-like GPS domain (PF01825)	Peptidase A4 family (PF01828)	Mannosyl-glycoprotein endo-beta-N-acetylglucosaminidase (PF01832)	IPT/TIG domain (PF01833)	MG2 domain (PF01835)	PF01837	FG-GAP repeat (PF01839)	Transglutaminase-like superfamily (PF01841)	ACT domain (PF01842)	DIL domain (PF01843)	HNH endonuclease (PF01844)	CcdB protein (PF01845)	FF domain (PF01846)	PF01848	NAC domain (PF01849)	PIN domain (PF01850)	Proteasome/cyclosome repeat (PF01851)	START domain (PF01852)	MOZ/SAS family (PF01853)	Pyruvate flavodoxin/ferredoxin oxidoreductase, thiamine diP-bdg (PF01855)	Pyruvoyl-dependent arginine decarboxylase (PvlArgDC) (PF01862)	Protein of unknown function DUF45 (PF01863)	Protein of unknown function DUF47 (PF01865)	Putative diphthamide synthesis protein (PF01866)	CRISPR associated protein Cas1 (PF01867)	Domain of unknown function UPF0086 (PF01868)	BadF/BadG/BcrA/BcrD ATPase family (PF01869)	Archaeal holliday junction resolvase (hjc) (PF01870)	AMMECR1 (PF01871)	RibD C-terminal domain (PF01872)	Domain found in IF2B/IF5 (PF01873)	ATP:dephospho-CoA triphosphoribosyl transferase (PF01874)	Memo-like protein (PF01875)	RNase P subunit p30 (PF01876)	RNA binding (PF01877)	EVE domain (PF01878)	PF01882	Domain of unknown function DUF59 (PF01883)	PcrB family (PF01884)	RNA 2'-phosphotransferase, Tpt1 / KptA family (PF01885)	S-adenosyl-l-methionine hydroxide adenosyltransferase (PF01887)	CbiD (PF01888)	Cobalamin synthesis G C-terminus (PF01890)	Cobalt uptake substrate-specific transmembrane region (PF01891)	Uncharacterised protein family UPF0047 (PF01894)	PhoU domain (PF01895)	Eukaryotic and archaeal DNA primase small subunit (PF01896)	PF01899	Rpp14/Pop5 family (PF01900)	ATP-binding region (PF01902)	CbiX (PF01903)	Protein of unknown function DUF72 (PF01904)	Putative heavy-metal-binding (PF01906)	Nucleotidyltransferase domain (PF01909)	Domain of unknown function DUF77 (PF01910)	eIF-6 family (PF01912)	Formylmethanofuran-tetrahydromethanopterin formyltransferase (PF01913)	PF01914	Glycosyl hydrolase family 3 C-terminal domain (PF01915)	Deoxyhypusine synthase (PF01916)	Alba (PF01918)	Prefoldin subunit (PF01920)	tRNA synthetases class I (K) (PF01921)	SRP19 protein (PF01922)	Cobalamin adenosyltransferase (PF01923)	Hydrogenase formation hypA family (PF01924)	PF01925	50S ribosome-binding GTPase (PF01926)	PF01927	CYTH domain (PF01928)	Ribosomal protein L14 (PF01929)	Domain of unknown function DUF83 (PF01930)	Protein of unknown function DUF84 (PF01931)	Uncharacterised protein family UPF0052 (PF01933)	Protein of unknown function DUF86 (PF01934)	Domain of unknown function DUF87 (PF01935)	NYN domain (PF01936)	Protein of unknown function DUF89 (PF01937)	TRAM domain (PF01938)	Protein of unknown function DUF91 (PF01939)	PF01940	PF01943	PF01944	Protein of unknown function (DUF98) (PF01947)	Aspartate carbamoyltransferase regulatory chain, allosteric domain (PF01948)	Protein of unknown function DUF99 (PF01949)	Fructose-1,6-bisphosphatase (PF01950)	Archease protein family (MTH1598/TM1083) (PF01951)	PF01955	PF01956	NfeD-like C-terminal, partner-binding (PF01957)	Domain of unknown function DUF108 (PF01958)	PF01959	ArgJ family (PF01960)	PF01963	ThiC family (PF01964)	DJ-1/PfpI family (PF01965)	HD domain (PF01966)	MoaC family (PF01967)	Hydantoinase/oxoprolinase (PF01968)	Protein of unknown function DUF111 (PF01969)	PF01970	Serine dehydrogenase proteinase (PF01972)	PF01973	tRNA intron endonuclease, catalytic C-terminal domain (PF01974)	Survival protein SurE (PF01975)	3-octaprenyl-4-hydroxybenzoate carboxy-lyase (PF01977)	Sugar-specific transcriptional regulator TrmB (PF01978)	Amidohydrolase family (PF01979)	Uncharacterised protein family UPF0066 (PF01980)	Peptidyl-tRNA hydrolase PTH2 (PF01981)	Domain of unknown function DUF120 (PF01982)	Guanylyl transferase CofC like (PF01983)	Double-stranded DNA-binding domain (PF01984)	CRS1 / YhbY (CRM) domain (PF01985)	Mitochondrial biogenesis AIM24 (PF01987)	PF01988	Protein of unknown function DUF126 (PF01989)	ATP synthase (E/31 kDa) subunit (PF01991)	ATP synthase (C/AC39) subunit (PF01992)	tRNA ribose 2'-O-methyltransferase, aTrm56 (PF01994)	F420-0:Gamma-glutamyl ligase (PF01996)	Translin family (PF01997)	PF02001	TFIIE alpha subunit (PF02002)	N2,N2-dimethylguanosine tRNA methyltransferase (PF02005)	Protein of unknown function DUF137 (PF02006)	CXXC zinc finger domain (PF02008)	PF02010	Glycosyl hydrolase family 48 (PF02011)	BNR/Asp-box repeat (PF02012)	Glycosyl hydrolase family 45 (PF02015)	LD-carboxypeptidase (PF02016)	Carbohydrate binding domain (PF02018)	eIF4-gamma/eIF5/eIF2-epsilon (PF02020)	Uncharacterised protein family UPF0102 (PF02021)	RyR domain (PF02026)	BCCT family transporter (PF02028)	Ribosome-binding factor A (PF02033)	SCP-2 sterol transfer family (PF02036)	SAP domain (PF02037)	PF02040	Auxin binding protein (PF02041)	CCAAT-binding transcription factor (CBF-B/NF-YA) subunit B (PF02045)	PF02049	O-Glycosyl hydrolase family 30 (PF02055)	Family 4 glycosyl hydrolase (PF02056)	Glycosyl hydrolase family 59 (PF02057)	Melibiase (PF02065)	Thermophilic metalloprotease (M29) (PF02073)	Carboxypeptidase Taq (M32) metallopeptidase (PF02074)	Crossover junction endodeoxyribonuclease RuvC (PF02075)	PF02076	PF02077	TrkA-C domain (PF02080)	Transcriptional regulator (PF02082)	Class III cytochrome C family (PF02085)	D12 class N6 adenine-specific DNA methyltransferase (PF02086)	Palmitoyl protein thioesterase (PF02089)	PF02090	Glycyl-tRNA synthetase alpha subunit (PF02091)	PF02092	Gag P30 core shell protein (PF02093)	60Kd inner membrane protein (PF02096)	Ornithine decarboxylase antizyme (PF02100)	Deuterolysin metalloprotease (M35) family (PF02102)	PF02104	PF02107	PF02108	Hydroxyethylthiazole kinase family (PF02110)	PF02112	D-Ala-D-Ala carboxypeptidase 3 (S13) family (PF02113)	Phosducin (PF02114)	Fungal pheromone mating factor STE2 GPCR (PF02116)	PF02119	Flagellar hook-length control protein FliK (PF02120)	Phosphatidylinositol transfer protein (PF02121)	Phosphotriesterase family (PF02126)	Aminopeptidase I zinc metalloprotease (M18) (PF02127)	Fungalysin metallopeptidase (M36) (PF02128)	X-Pro dipeptidyl-peptidase (S15 family) (PF02129)	Uncharacterized protein family UPF0054 (PF02130)	RecR protein (PF02132)	Permease for cytosine/purines, uracil, thiamine, allantoin (PF02133)	Repeat in ubiquitin-activating (UBA) protein (PF02134)	TAZ zinc finger (PF02135)	Nuclear transport factor 2 (NTF2) domain (PF02136)	Beige/BEACH domain (PF02138)	DENN (AEX-3) domain (PF02141)	MGS-like domain (PF02142)	Repair protein Rad1/Rec1/Rad17 (PF02144)	Rap/ran-GAP (PF02145)	Sir2 family (PF02146)	Zn-finger in ubiquitin-hydrolases and other protein (PF02148)	Kinase associated domain 1 (PF02149)	RNA polymerases M/15 Kd subunit (PF02150)	UvrB/uvrC motif (PF02151)	Dihydroneopterin aldolase (PF02152)	Prephenate dehydrogenase (PF02153)	Flagellar motor switch protein FliM (PF02154)	Glycosyl hydrolase family 26 (PF02156)	Mannose-6-phosphate receptor (PF02157)	PF02160	Peptidase family M50 (PF02163)	Cytochrome C1 family (PF02167)	PAZ domain (PF02170)	Piwi domain (PF02171)	KIX domain (PF02172)	PTB domain (IRS-1 type) (PF02174)	AT hook motif (PF02178)	BAG domain (PF02179)	Formin Homology 2 Domain (PF02181)	SAD/SRA domain (PF02182)	PF02184	Hr1 repeat (PF02185)	TFIIE beta subunit core domain (PF02186)	Growth-Arrest-Specific Protein 2 Domain (PF02187)	ATP-dependent protease La (LON) domain (PF02190)	PF02194	ParB-like nuclease domain (PF02195)	Raf-like Ras-binding domain (PF02196)	Regulatory subunit of type II PKA R-subunit (PF02197)	PF02200	SWIB/MDM2 domain (PF02201)	Tar ligand binding domain homologue (PF02203)	Vacuolar sorting protein 9 (VPS9) domain (PF02204)	WH2 motif (PF02205)	Putative zinc finger in N-recognin (UBR box) (PF02207)	Villin headpiece domain (PF02209)	Laminin G domain (PF02210)	Nitrile hydratase beta subunit (PF02211)	Dynamin GTPase effector domain (PF02212)	GYF domain (PF02213)	BTB/POZ domain (PF02214)	Methylenetetrahydrofolate reductase (PF02219)	ML domain (PF02221)	ATP-grasp domain (PF02222)	Cytidylate kinase (PF02224)	PA domain (PF02225)	Phospholipase/Carboxylesterase (PF02230)	NAD(P) transhydrogenase beta subunit (PF02233)	Biotin protein ligase C terminal domain (PF02237)	Carboxypeptidase activation peptide (PF02244)	Methylpurine-DNA glycosylase (MPG) (PF02245)	Phospholipase A1 (PF02253)	TrkA-N domain (PF02254)	PTS system, Lactose/Cellobiose specific IIA subunit (PF02255)	Iron hydrogenase small subunit (PF02256)	RFX DNA-binding domain (PF02257)	FAT domain (PF02259)	FATC domain (PF02260)	Aspartate decarboxylase (PF02261)	LamB porin (PF02264)	S1/P1 Nuclease (PF02265)	Transcription initiation factor IID, 18kD subunit (PF02269)	Transcription initiation factor IIF, beta subunit (PF02270)	DHHA1 domain (PF02272)	Amidinotransferase (PF02274)	Linear amide C-N hydrolases, choloylglycine hydrolase family (PF02275)	Photosynthetic reaction centre cytochrome C subunit (PF02276)	Phosphoribosyltransferase (PF02277)	Polysaccharide lyase family 8, super-sandwich domain (PF02278)	Transposase Tn5 dimerisation domain (PF02281)	Cobinamide kinase / cobinamide phosphate guanyltransferase (PF02283)	Dehydratase large subunit (PF02286)	Dehydratase small subunit (PF02287)	Dehydratase medium subunit (PF02288)	Signal recognition particle 14kD protein (PF02290)	Transcription initiation factor IID, 31kD subunit (PF02291)	AmiS/UreI family transporter (PF02293)	Alpha adaptin AP2, C-terminal domain (PF02296)	Cytochrome oxidase c subunit VIb (PF02297)	Fumarate reductase subunit C (PF02300)	HORMA domain (PF02301)	PTS system, Lactose/Cellobiose specific IIB subunit (PF02302)	Capsid protein (F protein) (PF02305)	Major spike protein (G protein) (PF02306)	PF02308	B12 binding domain (PF02310)	AraC-like ligand binding domain (PF02311)	Fumarate reductase subunit D (PF02313)	Mu DNA-binding domain (PF02316)	NAD/NADP octopine/nopaline dehydrogenase, alpha-helical domain (PF02317)	E2F/DP family winged-helix DNA-binding domain (PF02319)	Ubiquinol-cytochrome C reductase hinge protein (PF02320)	Outer membrane efflux protein (PF02321)	PF02322	Glycosyl hydrolase family 70 (PF02324)	PF02325	Mitochondrial glycoprotein (PF02330)	Methane/Phenol/Toluene Hydroxylase (PF02332)	Phytase (PF02333)	Cytochrome c552 (PF02335)	OTU-like cysteine protease (PF02338)	RbcX protein (PF02341)	TerD domain (PF02342)	Glycine cleavage system P-protein (PF02347)	Cytidylyltransferase (PF02348)	UDP-N-acetylglucosamine 2-epimerase (PF02350)	Mycolic acid cyclopropane synthetase (PF02353)	Protein export membrane protein (PF02355)	Transcription termination factor nusG (PF02357)	Trehalose-phosphatase (PF02358)	Cell division protein 48 (CDC48), N-terminal domain (PF02359)	Cobalt transport protein (PF02361)	PF02364	PF02366	Uncharacterised P-loop hydrolase UPF0079 (PF02367)	Bacterial Ig-like domain (group 2) (PF02368)	Bacterial Ig-like domain (group 1) (PF02369)	PF02371	JmjC domain, hydroxylase (PF02373)	Anion-transporting ATPase (PF02374)	jmjN domain (PF02375)	Phosphotransferase system, EIIC (PF02378)	MraZ protein (PF02381)	SacI homology domain (PF02383)	N-6 DNA Methylase (PF02384)	Cation transport protein (PF02386)	PF02387	FemAB family (PF02388)	Putative methyltransferase (PF02390)	MoaE protein (PF02391)	PF02392	Immunoglobulin A1 protease (PF02395)	PF02397	PF02399	LytB protein (PF02401)	Seryl-tRNA synthetase N-terminal domain (PF02403)	PF02405	MmoB/DmpM family (PF02406)	Oligomerisation domain (PF02410)	PF02411	Thrombospondin type 3 repeat (PF02412)	PF02413	mttA/Hcf106 family (PF02416)	PF02417	Ferrous iron transport protein B (PF02421)	Ornithine cyclodeaminase/mu-crystallin family (PF02423)	ApbE family (PF02424)	Muconolactone delta-isomerase (PF02426)	Chalcone-flavanone isomerase (PF02431)	Cytochrome C oxidase, mono-heme subunit/FixO (PF02433)	Fringe-like (PF02434)	Levansucrase/Invertase (PF02435)	Conserved carboxylase domain (PF02436)	Flavoprotein (PF02441)	Quinolinate synthetase A protein (PF02445)	4-alpha-glucanotransferase (PF02446)	PF02447	Beta-galactosidase (PF02449)	Lecithin:cholesterol acyltransferase (PF02450)	PemK-like protein (PF02452)	Reticulon (PF02453)	Hexon-associated protein (IIIa) (PF02455)	DisA bacterial checkpoint controller nucleotide-binding (PF02457)	Transferase family (PF02458)	PF02460	Ammonia monooxygenase (PF02461)	RecF/RecN/SMC N terminal domain (PF02463)	Competence-damaged protein (PF02464)	PF02465	PF02466	PF02467	Fasciclin domain (PF02469)	PF02470	Biopolymer transport protein ExbD/TolR (PF02472)	Met-10+ like-protein (PF02475)	DNA recombination-mediator protein A (PF02481)	Sigma 54 modulation protein / S30EA ribosomal protein (PF02482)	Core-2/I-Branching enzyme (PF02485)	PF02486	PF02487	SHS2 domain inserted in FTSA (PF02491)	CobW/HypB/UreG, nucleotide-binding domain (PF02492)	MORN repeat (PF02493)	PF02494	PF02498	Type II secretion system (T2SS), protein I (PF02501)	Ribose/Galactose Isomerase (PF02502)	Polyphosphate kinase middle domain (PF02503)	Fatty acid synthesis protein (PF02504)	PF02508	Thymidylate synthase complementing protein (PF02511)	PF02514	CoA-transferase family III (PF02515)	Oligosaccharyl transferase STT3 subunit (PF02516)	CAAX protease self-immunity (PF02517)	Histidine kinase-, DNA gyrase B-, and HSP90-like ATPase (PF02518)	Aminoglycoside 3-N-acetyltransferase (PF02522)	Flavodoxin-like fold (PF02525)	rRNA small subunit methyltransferase G (PF02527)	PF02530	Type IV secretory system Conjugative DNA transfer (PF02534)	PF02535	PF02537	PF02538	NAD synthase (PF02540)	Ppx/GppA phosphatase family (PF02541)	YgbB family (PF02542)	Carbamoyltransferase (PF02543)	PF02544	Maf-like protein (PF02545)	Queuosine biosynthesis protein (PF02547)	Ketopantoate hydroxymethyltransferase (PF02548)	Acetyl-CoA hydrolase/transferase N-terminal domain (PF02550)	Acyl-CoA thioesterase (PF02551)	PF02553	PF02554	Preprotein translocase subunit SecB (PF02556)	D-alanyl-D-alanine carboxypeptidase (PF02557)	Ketopantoate reductase PanE/ApbA (PF02558)	CarD-like/TRCF domain (PF02559)	Cyanate lyase C-terminal domain (PF02560)	Flagellar protein FliS (PF02561)	PhoH-like protein (PF02562)	Polysaccharide biosynthesis/export protein (PF02563)	Recombination protein O C terminal (PF02565)	OsmC-like protein (PF02566)	Phenazine biosynthesis-like protein (PF02567)	Thiamine biosynthesis protein (ThiI) (PF02568)	Pantoate-beta-alanine ligase (PF02569)	Precorrin-8X methylmutase (PF02570)	PF02571	ATP:corrinoid adenosyltransferase BtuR/CobO/CobP (PF02572)	Homocysteine S-methyltransferase (PF02574)	YbaB/EbfC DNA-binding family (PF02575)	Uncharacterised BCR, YhbC family COG0779 (PF02576)	Bifunctional nuclease (PF02577)	Multi-copper polyphenol oxidoreductase laccase (PF02578)	Dinitrogenase iron-molybdenum cofactor (PF02579)	D-Tyr-tRNA(Tyr) deacylase (PF02580)	Thiamine monophosphate synthase/TENI (PF02581)	PF02582	Metal-sensitive transcriptional repressor (PF02583)	GlcNAc-PI de-N-acetylase (PF02585)	Uncharacterised ACR, COG2135 (PF02586)	PF02588	Uncharacterised ACR, YkgG family COG1556 (PF02589)	Predicted SPOUT methyltransferase (PF02590)	Putative zinc ribbon domain (PF02591)	PF02592	Uncharacterised ACR, YggU family COG1872 (PF02594)	Glycerate kinase family (PF02595)	PF02596	ThiS family (PF02597)	Putative RNA methyltransferase (PF02598)	Global regulator protein family (PF02599)	Disulfide bond formation protein DsbB (PF02600)	PF02601	Uroporphyrinogen-III synthase HemD (PF02602)	HPr Serine kinase N terminus (PF02603)	Antitoxin Phd_YefM, type II toxin-antitoxin system (PF02604)	Photosystem I reaction centre subunit XI (PF02605)	Tetraacyldisaccharide-1-P 4'-kinase (PF02606)	B12 binding domain (PF02607)	Basic membrane protein (PF02608)	Exonuclease VII small subunit (PF02609)	L-arabinose isomerase (PF02610)	CDP-diacylglycerol pyrophosphatase (PF02611)	Nitrate reductase delta subunit (PF02613)	Glucuronate isomerase (PF02614)	Malate/L-lactate dehydrogenase (PF02615)	ScpA/B protein (PF02616)	ATP-dependent Clp protease adaptor protein ClpS (PF02617)	YceG-like family (PF02618)	PF02620	Menaquinone biosynthesis (PF02621)	Uncharacterized ACR, COG1678 (PF02622)	YcaO-like family (PF02624)	XdhC and CoxI family (PF02625)	Allophanate hydrolase subunit 2 (PF02626)	Carboxymuconolactone decarboxylase family (PF02627)	PF02628	CoA binding domain (PF02629)	SCO1/SenC (PF02630)	RecX family (PF02631)	BioY family (PF02632)	Creatinine amidohydrolase (PF02633)	FdhD/NarQ family (PF02634)	DsrE/DsrF-like family (PF02635)	Putative S-adenosyl-L-methionine-dependent methyltransferase (PF02636)	GatB domain (PF02637)	PF02638	PF02639	Uncharacterized ACR, COG1993 (PF02641)	Uncharacterized ACR, COG1430 (PF02643)	Uncharacterised protein, DegV family COG1307 (PF02645)	PF02646	Type I GTP cyclohydrolase folE2 (PF02649)	WhiA C-terminal HTH domain (PF02650)	PF02652	PF02653	PF02654	ATP-grasp domain (PF02655)	PF02656	Fe-S metabolism associated domain (PF02657)	PF02659	PF02660	Fic/DOC family (PF02661)	FmdE, Molybdenum formylmethanofuran dehydrogenase operon (PF02663)	S-Ribosylhomocysteinase (LuxS) (PF02664)	Nitrate reductase gamma subunit (PF02665)	PF02666	PF02667	Taurine catabolism dioxygenase TauD, TfdA family (PF02668)	PF02669	1-deoxy-D-xylulose 5-phosphate reductoisomerase (PF02670)	Paired amphipathic helix repeat (PF02671)	PF02673	PF02674	S-adenosylmethionine decarboxylase (PF02675)	PF02677	Pirin (PF02678)	(2R)-phospho-3-sulfolactate synthase (ComA) (PF02679)	PF02681	Allophanate hydrolase subunit 1 (PF02682)	PF02683	PF02684	Glucokinase (PF02685)	Glu-tRNAGln amidotransferase C subunit (PF02686)	PF02687	PF02689	PF02690	PF02694	PF02696	DUF218 domain (PF02698)	Preprotein translocase subunit (PF02699)	Phosphoribosylformylglycinamidine (FGAM) synthase (PF02700)	Osmosensitive K+ channel His kinase sensor domain (PF02702)	PF02705	Chain length determinant protein (PF02706)	N-terminal domain of galactosyltransferase (PF02709)	PF02714	Polysaccharide biosynthesis protein (PF02719)	PF02720	PF02724	Copper amine oxidase, N2 domain (PF02727)	Copper amine oxidase, N3 domain (PF02728)	Aspartate/ornithine carbamoyltransferase, carbamoyl-P binding domain (PF02729)	Aldehyde ferredoxin oxidoreductase, N-terminal domain (PF02730)	PF02731	ERCC4 domain (PF02732)	Dak1 domain (PF02733)	DAK2 domain (PF02734)	Ku70/Ku80 beta-barrel domain (PF02735)	Myosin N-terminal SH3-like domain (PF02736)	3-hydroxyacyl-CoA dehydrogenase, NAD binding domain (PF02737)	Molybdopterin-binding domain of aldehyde dehydrogenase (PF02738)	5'-3' exonuclease, N-terminal resolvase-like domain (PF02739)	FTR, proximal lobe (PF02741)	Iron dependent repressor, metal binding and dimerisation domain (PF02742)	Cache domain (PF02743)	Galactose-1-phosphate uridyl transferase, C-terminal domain (PF02744)	Mandelate racemase / muconate lactonizing enzyme, N-terminal domain (PF02746)	Proliferating cell nuclear antigen, C-terminal domain (PF02747)	Aspartate carbamoyltransferase regulatory chain, metal binding domain (PF02748)	Quinolinate phosphoribosyl transferase, N-terminal domain (PF02749)	Arrestin (or S-antigen), C-terminal domain (PF02752)	Pili assembly chaperone PapD, C-terminal domain (PF02753)	PF02754	RUN domain (PF02759)	Telomeric single stranded DNA binding POT1/CDC13 (PF02765)	DNA polymerase III beta subunit, central domain (PF02767)	DNA polymerase III beta subunit, C-terminal domain (PF02768)	AIR synthase related protein, C-terminal domain (PF02769)	Acyl-CoA dehydrogenase, middle domain (PF02770)	Acyl-CoA dehydrogenase, N-terminal domain (PF02771)	S-adenosylmethionine synthetase, central domain (PF02772)	S-adenosylmethionine synthetase, C-terminal domain (PF02773)	Semialdehyde dehydrogenase, dimerisation domain (PF02774)	Thiamine pyrophosphate enzyme, C-terminal TPP binding domain (PF02775)	Thiamine pyrophosphate enzyme, N-terminal TPP binding domain (PF02776)	Iron/manganese superoxide dismutases, C-terminal domain (PF02777)	tRNA intron endonuclease, N-terminal domain (PF02778)	Transketolase, pyrimidine binding domain (PF02779)	Transketolase, C-terminal domain (PF02780)	Glucose-6-phosphate dehydrogenase, C-terminal domain (PF02781)	FGGY family of carbohydrate kinases, C-terminal domain (PF02782)	Pyridoxal-dependent decarboxylase, pyridoxal binding domain (PF02784)	Biotin carboxylase C-terminal domain (PF02785)	Carbamoyl-phosphate synthase L chain, ATP binding domain (PF02786)	Carbamoyl-phosphate synthetase large chain, oligomerisation domain (PF02787)	Ribulose bisphosphate carboxylase large chain, N-terminal domain (PF02788)	Cytosol aminopeptidase family, N-terminal domain (PF02789)	Cytochrome C oxidase subunit II, transmembrane domain (PF02790)	PF02791	Mago nashi protein (PF02792)	Hormone receptor domain (PF02793)	Helix-turn-helix domain of resolvase (PF02796)	Chalcone and stilbene synthases, C-terminal domain (PF02797)	Glutathione S-transferase, N-terminal domain (PF02798)	Myristoyl-CoA:protein N-myristoyltransferase, C-terminal domain (PF02799)	Glyceraldehyde 3-phosphate dehydrogenase, C-terminal domain (PF02800)	Beta-ketoacyl synthase, C-terminal domain (PF02801)	Thiolase, C-terminal domain (PF02803)	Metal binding domain of Ada (PF02805)	Alpha amylase, C-terminal all-beta domain (PF02806)	Ubiquitin interaction motif (PF02809)	SEC-C motif (PF02810)	PHP domain (PF02811)	Glu/Leu/Phe/Val dehydrogenase, dimerisation domain (PF02812)	UreE urease accessory protein, N-terminal domain (PF02814)	MIR domain (PF02815)	e3 binding domain (PF02817)	mbt repeat (PF02820)	ATP synthase, Delta/Epsilon chain, beta-sandwich domain (PF02823)	TGS domain (PF02824)	WWE domain (PF02825)	D-isomer specific 2-hydroxyacid dehydrogenase, NAD binding domain (PF02826)	L27 domain (PF02828)	3H domain (PF02829)	V4R domain (PF02830)	DHHA2 domain (PF02833)	LigT like Phosphoesterase (PF02834)	Glycosyl hydrolases family 2, TIM barrel domain (PF02836)	Glycosyl hydrolases family 2, sugar binding domain (PF02837)	Glycosyl hydrolase family 20, domain 2 (PF02838)	Carbohydrate binding domain (PF02839)	Prp18 domain (PF02840)	Phosphoribosylglycinamide synthetase, C domain (PF02843)	Phosphoribosylglycinamide synthetase, N domain (PF02844)	CUE domain (PF02845)	MA3 domain (PF02847)	Pyridine nucleotide-disulphide oxidoreductase, dimerisation domain (PF02852)	MIF4G domain (PF02854)	Clp amino terminal domain (PF02861)	PF02862	Arginine repressor, C-terminal domain (PF02863)	STAT protein, DNA binding domain (PF02864)	STAT protein, protein interaction domain (PF02865)	lactate/malate dehydrogenase, alpha/beta C-terminal domain (PF02866)	Ribonucleotide reductase, barrel domain (PF02867)	Thermolysin metallopeptidase, alpha-helical domain (PF02868)	6-O-methylguanine DNA methyltransferase, ribonuclease-like domain (PF02870)	5'-nucleotidase, C-terminal domain (PF02872)	UDP-N-acetylenolpyruvoylglucosamine reductase, C-terminal domain (PF02873)	ATP synthase alpha/beta family, beta-barrel domain (PF02874)	Mur ligase family, glutamate ligase domain (PF02875)	Poly(ADP-ribose) polymerase, regulatory domain (PF02877)	Phosphoglucomutase/phosphomannomutase, alpha/beta/alpha domain I (PF02878)	Phosphoglucomutase/phosphomannomutase, alpha/beta/alpha domain II (PF02879)	Phosphoglucomutase/phosphomannomutase, alpha/beta/alpha domain III (PF02880)	SRP54-type protein, helical bundle domain (PF02881)	Tetrahydrofolate dehydrogenase/cyclohydrolase, NAD(P)-binding domain (PF02882)	Adaptin C-terminal domain (PF02883)	Polysaccharide lyase family 8, C-terminal beta-sandwich domain (PF02884)	Glycosyl transferase family, helical bundle domain (PF02885)	Pyruvate kinase, alpha/beta domain (PF02887)	Sec63 Brl domain (PF02889)	MIZ/SP-RING zinc finger (PF02891)	GRAM domain (PF02893)	Oxidoreductase family, C-terminal alpha/beta domain (PF02894)	Signal transducing histidine kinase, homodimeric domain (PF02895)	PEP-utilising enzyme, TIM barrel domain (PF02896)	Prolyl oligopeptidase, N-terminal beta-propeller domain (PF02897)	Nitric oxide synthase, oxygenase domain (PF02898)	Phage integrase, N-terminal SAM-like domain (PF02899)	Catalytic LigB subunit of aromatic ring-opening dioxygenase (PF02900)	Pyruvate formate lyase (PF02901)	Ulp1 protease family, C-terminal catalytic domain (PF02902)	Alpha amylase, N-terminal ig-like domain (PF02903)	Iron only hydrogenase large subunit, C-terminal domain (PF02906)	Tetracyclin repressor, C-terminal all-alpha domain (PF02909)	Fumarate reductase flavoprotein C-term (PF02910)	Formyl transferase, C-terminal domain (PF02911)	Aminoacyl tRNA synthetase class II, N-terminal domain (PF02912)	FAD linked oxidases, C-terminal domain (PF02913)	Rubrerythrin (PF02915)	Pertussis toxin, subunit 1 (PF02917)	Eukaryotic DNA topoisomerase I, DNA binding fragment (PF02919)	Ubiquinol cytochrome reductase transmembrane region (PF02921)	Carbohydrate-binding module 48 (Isoamylase N-terminal domain) (PF02922)	Bacteriophage scaffolding protein D (PF02925)	THUMP domain (PF02926)	N-terminal ig-like domain of cellulase (PF02927)	PF02928	Beta galactosidase small chain (PF02929)	Neurotransmitter-gated ion-channel ligand binding domain (PF02931)	Cell division protein 48 (CDC48), domain 2 (PF02933)	GatB/GatE catalytic domain (PF02934)	Cytochrome c oxidase subunit VIIc (PF02935)	Cytochrome c oxidase subunit IV (PF02936)	GAD domain (PF02938)	UcrQ family (PF02939)	Influenza B non-structural protein (NS1) (PF02942)	PF02944	Recombination endonuclease VII (PF02945)	PF02949	Prokaryotic glutathione synthetase, N-terminal domain (PF02951)	L-fucose isomerase, C-terminal domain (PF02952)	Tim10/DDP family zinc finger (PF02953)	Bacterial regulatory protein, Fis family (PF02954)	Prokaryotic glutathione synthetase, ATP-grasp domain (PF02955)	Ecdysteroid kinase (PF02958)	5-carboxymethyl-2-hydroxymuconate isomerase (PF02962)	Vitamin B12 dependent methionine synthase, activation domain (PF02965)	Mitosis protein DIM1 (PF02966)	TATA box binding protein associated factor (TAF) (PF02969)	Formiminotransferase domain (PF02971)	Sialidase, N-terminal domain (PF02973)	Protease inhibitor Inh (PF02974)	DNA mismatch repair enzyme MutH (PF02976)	Signal peptide binding domain (PF02978)	Nitrile hydratase, alpha chain (PF02979)	Scytalone dehydratase (PF02982)	Alpha-lytic protease prodomain (PF02983)	Cyclin, C-terminal domain (PF02984)	HEAT repeat (PF02985)	PF02990	Autophagy protein Atg8 ubiquitin like (PF02991)	PF02992	Minor capsid protein VI (PF02993)	L1 transposable element (PF02994)	Protein of unknown function (DUF229) (PF02995)	Prefoldin subunit (PF02996)	PF03006	PF03007	PF03008	Glycerophosphoryl diester phosphodiesterase family (PF03009)	Pyrimidine dimer DNA glycosylase (PF03013)	PF03015	PF03016	Major royal jelly protein (PF03022)	PF03023	Dynein heavy chain and region D6 of dynein motor (PF03028)	Conserved hypothetical ATP binding protein (PF03029)	Inorganic H+ pyrophosphatase (PF03030)	NLI interacting factor-like phosphatase (PF03031)	Glycosyltransferase family 28 N-terminal domain (PF03033)	Perilipin family (PF03036)	PF03040	PF03050	Peptidase C1-like family (PF03051)	PF03052	tRNA methyl transferase (PF03054)	Retinal pigment epithelial membrane protein (PF03055)	Nicotianamine synthase protein (PF03059)	Nitronate monooxygenase (PF03060)	Thioesterase superfamily (PF03061)	PF03062	Prismane/CO dehydrogenase family (PF03063)	Glycosyl hydrolase family 57 (PF03065)	Chitin binding domain (PF03067)	Protein-arginine deiminase (PAD) (PF03068)	Acetamidase/Formamidase family (PF03069)	TENA/THI-4/PQQC family (PF03070)	TspO/MBR family (PF03073)	Glutamate-cysteine ligase (PF03074)	ARD/ARD' family (PF03079)	Exo70 exocyst complex subunit (PF03081)	Strictosidine synthase (PF03088)	PF03090	CutA1 divalent ion tolerance protein (PF03091)	PF03092	Phosphotyrosyl phosphate activator (PTPA) protein (PF03095)	BRO1-like domain (PF03097)	Animal haem peroxidase (PF03098)	Biotin/lipoate A/B protein ligase family (PF03099)	CcmE (PF03100)	PF03101	NeuB family (PF03102)	DNA polymerase family B, exonuclease domain (PF03104)	PF03105	PF03109	BAR domain (PF03114)	PF03116	Bacterial RNA polymerase, alpha chain C terminal domain (PF03118)	NAD-dependent DNA ligase C4 zinc finger domain (PF03119)	NAD-dependent DNA ligase OB-fold domain (PF03120)	CAT RNA binding domain (PF03123)	PF03124	Plus-3 domain (PF03126)	GAT domain (PF03127)	Anticodon binding domain (PF03129)	PBS lyase HEAT-like repeat (PF03130)	bZIP Maf transcription factor (PF03131)	Tubulin-tyrosine ligase family (PF03133)	PF03134	PF03135	Pup-ligase protein (PF03136)	Elongation factor Tu C-terminal domain (PF03143)	Elongation factor Tu domain 2 (PF03144)	Ferredoxin-fold anticodon binding domain (PF03147)	PF03148	Di-haem cytochrome c peroxidase (PF03150)	PF03151	Ubiquitin fusion degradation protein UFD1 (PF03152)	Transcription factor IIA, alpha/beta subunit (PF03153)	PF03155	XRN 5'-3' exonuclease N-terminus (PF03159)	Calx-beta domain (PF03160)	LAGLIDADG DNA endonuclease family (PF03161)	Tyrosine phosphatase family (PF03162)	PF03164	MH1 domain (PF03165)	MH2 domain (PF03166)	Uracil DNA glycosylase superfamily (PF03167)	Late embryogenesis abundant protein (PF03168)	PF03169	Bacterial cellulose synthase subunit (PF03170)	2OG-Fe(II) oxygenase superfamily (PF03171)	Putative carbohydrate binding domain (PF03173)	Chitobiase/beta-hexosaminidase C-terminal domain (PF03174)	DNA polymerase type B, organellar and viral (PF03175)	MMPL family (PF03176)	Non-repetitive/WGA-negative nucleoporin C-terminal (PF03177)	CPSF A subunit region (PF03178)	NLPA lipoprotein (PF03180)	PF03184	PF03186	Eukaryotic cytochrome b561 (PF03188)	PF03189	Protein of unknown function, DUF255 (PF03190)	Protein of unknown function, DUF258 (PF03193)	PF03194	Glucanosyltransferase (PF03198)	Eukaryotic glutathione synthase (PF03199)	Mannosyl oligosaccharide glucosidase (PF03200)	PF03203	Molybdopterin guanine dinucleotide synthesis protein B (PF03205)	PF03206	PF03208	PF03209	Pectate lyase (PF03211)	Pertactin (PF03212)	PF03217	PF03219	Tc5 transposase DNA-binding domain (PF03221)	Tryptophan/tyrosine permease family (PF03222)	V-ATPase subunit C (PF03223)	V-ATPase subunit H (PF03224)	PF03226	PF03227	PF03228	Antirestriction protein (PF03230)	PF03232	PF03234	PF03235	Terminase-like family (PF03237)	PF03239	4-hydroxyphenylacetate 3-hydroxylase C terminal (PF03241)	Alkylmercury lyase (PF03243)	PF03245	PF03248	Urea transporter (PF03253)	Acetyl co-enzyme A carboxylase carboxyltransferase alpha subunit (PF03255)	Anaphase-promoting complex, subunit 10 (APC10) (PF03256)	Roadblock/LC7 domain (PF03259)	NapC/NirT cytochrome c family, N-terminal region (PF03264)	Protein of unknown function, DUF269 (PF03270)	EB1-like C-terminal motif (PF03271)	PF03272	UDP-galactopyranose mutase (PF03275)	PF03279	Proteobacterial lipase chaperone protein (PF03280)	Mab-21 protein (PF03281)	PF03283	Poxvirus D5 protein-like (PF03288)	mRNA capping enzyme (PF03291)	Tryptophan 2,3-dioxygenase (PF03301)	Alpha-acetolactate decarboxylase (PF03306)	ArgK protein (PF03308)	Type III pantothenate kinase (PF03309)	PF03313	Serine dehydratase beta chain (PF03315)	Bacterial fructose-1,6-bisphosphatase, glpX-encoded (PF03320)	GH3 auxin-responsive promoter (PF03321)	PF03323	HpcH/HpaI aldolase/citrate lyase family (PF03328)	Rare lipoprotein A (RlpA)-like double-psi beta-barrel (PF03330)	UDP-3-O-acyl N-acetylglycosamine deacetylase (PF03331)	Eukaryotic phosphomannomutase (PF03332)	PF03334	Phage tail fibre repeat (PF03335)	SART-1 family (PF03343)	Daxx Family (PF03344)	PF03345	PF03348	Outer membrane protein transport protein (OMPP1/FadL/TodX) (PF03349)	PF03350	PF03351	Methyladenine glycosylase (PF03352)	PF03354	Snf7 (PF03357)	NADPH-dependent FMN reductase (PF03358)	Polyketide cyclase / dehydrase and lipid transport (PF03364)	YEATS family (PF03366)	ZPR1 zinc-finger domain (PF03367)	Dicer dimerisation domain (PF03368)	Putative phosphatase regulatory subunit (PF03370)	PF03371	Endonuclease/Exonuclease/phosphatase family (PF03372)	PF03374	Xanthomonas avirulence protein, Avr/PthA (PF03377)	CAS/CSE protein, C-terminus (PF03378)	PF03379	PF03381	PF03382	Legume-like lectin family (PF03388)	MobA/MobL family (PF03389)	PF03390	Pneumovirus matrix protein (PF03393)	Regulator of Vps4 activity in the MVB pathway (PF03398)	SAC3/GANP/Nin1/mts3/eIF-3 p25 family (PF03399)	PF03400	Tripartite tricarboxylate transporter family receptor (PF03401)	Platelet-activating factor acetylhydrolase, isoform II (PF03403)	Mo-co oxidoreductase dimerisation domain (PF03404)	Fatty acid desaturase (PF03405)	PF03406	PF03407	Penicillin-insensitive murein endopeptidase (PF03411)	Peptidase C39 family (PF03412)	Peptidase propeptide and YPEB domain (PF03413)	Clostripain family (PF03415)	Peptidase family C54 (PF03416)	Acyl-coenzyme A:6-aminopenicillanic acid acyl-transferase (PF03417)	Germination protease (PF03418)	PF03419	PF03421	Carbohydrate binding module (family 6) (PF03422)	Carbohydrate binding domain (family 25) (PF03423)	Carbohydrate binding domain (family 11) (PF03425)	PF03428	PF03432	EspA-like secreted protein (PF03433)	Saccharopine dehydrogenase (PF03435)	BtpA family (PF03437)	Early transcription elongation factor of RNA pol II, NGN section (PF03439)	FAD binding domain of DNA photolyase (PF03441)	Carbohydrate binding domain X2 (PF03442)	Glycosyl hydrolase family 61 (PF03443)	Winged helix-turn-helix transcription repressor, HrcA DNA-binding (PF03444)	PF03445	NAD binding domain of 6-phosphogluconate dehydrogenase (PF03446)	Homoserine dehydrogenase, NAD binding domain (PF03447)	MgtE intracellular N domain (PF03448)	Transcription elongation factor, N-terminal (PF03449)	CO dehydrogenase flavoprotein C-terminal domain (PF03450)	Anp1 (PF03452)	MoeA N-terminal region (domain I and II) (PF03453)	MoeA C-terminal region (domain IV) (PF03454)	dDENN domain (PF03455)	uDENN domain (PF03456)	Helicase associated domain (PF03457)	PF03458	TOBE domain (PF03459)	Nitrite/Sulfite reductase ferredoxin-like half domain (PF03460)	TRCF domain (PF03461)	PCRF domain (PF03462)	eRF1 domain 1 (PF03463)	eRF1 domain 2 (PF03464)	eRF1 domain 3 (PF03465)	LysR substrate binding domain (PF03466)	Smg-4/UPF3 family (PF03467)	Transporter associated domain (PF03471)	Autoinducer binding domain (PF03472)	MOSC domain (PF03473)	3-alpha domain (PF03475)	MOSC N-terminal beta barrel domain (PF03476)	ATP cone domain (PF03477)	Domain of unknown function (DUF296) (PF03479)	Bacterial extracellular solute-binding protein, family 7 (PF03480)	Putative GTP-binding controlling metal-binding (PF03481)	B3/4 domain (PF03483)	tRNA synthetase B5 domain (PF03484)	Arginyl tRNA synthetase N terminal domain (PF03485)	HI0933-like protein (PF03486)	Saposin-like type B, region 2 (PF03489)	SAM dependent carboxyl methyltransferase (PF03492)	Calcium-activated BK potassium channel alpha subunit (PF03493)	Clostridial binary toxin B/anthrax toxin PA (PF03495)	ADP-ribosyltransferase exoenzyme (PF03496)	Anthrax toxin LF subunit (PF03497)	Cellulose synthase subunit D (PF03500)	Plectin/S10 domain (PF03501)	Nucleoside-specific channel-forming protein, Tsx (PF03502)	Glycosyl hydrolase family 52 (PF03512)	Conjugal transfer protein (PF03524)	PF03527	Structure-specific recognition protein (SSRP1) (PF03531)	Salmonella virulence-associated 28kDa protein (PF03536)	Glycoside-hydrolase family GH114 (PF03537)	Salmonella virulence plasmid 28.1kDa A protein (PF03538)	PF03540	PF03542	Yersinia/Haemophilus virulence surface antigen (PF03543)	Gram-negative bacterial TonB protein C-terminal (PF03544)	PF03547	Outer membrane lipoprotein carrier protein LolA (PF03548)	Outer membrane lipoprotein LolB (PF03550)	Transcriptional regulator PadR-like family (PF03551)	Cellulose synthase (PF03552)	PF03553	Cullin binding (PF03556)	Allantoicase repeat (PF03561)	MltA specific insert domain (PF03562)	PF03564	Sulfotransferase family (PF03567)	PF03568	Peptidase family S41 (PF03572)	outer membrane porin, OprD family (PF03573)	Peptidase family S51 (PF03575)	Peptidase family S58 (PF03576)	PF03577	Secretory lipase (PF03583)	EMG1/NEP1 methyltransferase (PF03587)	Leucyl/phenylalanyl-tRNA protein transferase (PF03588)	Antitermination protein (PF03589)	Aspartate-ammonia ligase (PF03590)	PF03591	Terminase small subunit (PF03592)	PF03594	Voltage-dependent anion channel (PF03595)	PF03596	PF03597	CO dehydrogenase/acetyl-CoA synthase complex beta subunit (PF03598)	CO dehydrogenase/acetyl-CoA synthase delta subunit (PF03599)	Citrate transporter (PF03600)	PF03601	Conserved hypothetical protein 95 (PF03602)	DNA polymerase III psi subunit (PF03603)	DNA directed RNA polymerase, 7 kDa subunit (PF03604)	PF03605	PF03606	PF03608	PF03609	PTS system fructose IIA component (PF03610)	PF03611	PF03612	PF03613	GCM motif protein (PF03615)	PF03616	PF03618	PF03619	MbtH-like protein (PF03621)	Focal adhesion targeting region (PF03623)	Domain of unknown function DUF302 (PF03625)	PF03626	Domain of unknown function (DUF303) (PF03629)	Fumble (PF03630)	PF03631	Glycosyl hydrolase family 65 central catalytic domain (PF03632)	Glycosyl hydrolase family 65, C-terminal domain (PF03633)	Vacuolar protein sorting-associated protein 35 (PF03635)	Glycosyl hydrolase family 65, N-terminal domain (PF03636)	Mob1/phocein family (PF03637)	Glycosyl hydrolase family 81 (PF03639)	PF03640	Possible lysine decarboxylase (PF03641)	Vacuolar protein sorting-associated protein 26 (PF03643)	Glycosyl hydrolase family 85 (PF03644)	Transmembrane proteins 14C (PF03647)	Glycosyl hydrolase family 67 N-terminus (PF03648)	PF03649	PF03650	Uncharacterised protein family (UPF0081) (PF03652)	PF03653	Uncharacterised protein family (UPF0113) (PF03657)	RnfH family Ubiquitin (PF03658)	PF03659	PF03661	Glycosyl hydrolase family 76 (PF03663)	Glycosyl hydrolase family 62 (PF03664)	PF03666	PF03668	PF03672	PF03676	Uncharacterised protein family (UPF0150) (PF03681)	PF03682	Uncharacterised protein family (UPF0147) (PF03685)	PF03690	PF03691	PF03692	Uncharacterised protein family (UPF0156) (PF03693)	PF03694	Uncharacterised protein family (UPF0149) (PF03695)	PF03699	Uncharacterised protein family (UPF0075) (PF03702)	PF03703	Bacterial transcriptional activator domain (PF03704)	CheR methyltransferase, all-alpha domain (PF03705)	PF03706	PF03707	Orn/Lys/Arg decarboxylase, N-terminal domain (PF03709)	Glutamate-ammonia ligase adenylyltransferase (PF03710)	Orn/Lys/Arg decarboxylase, C-terminal domain (PF03711)	Domain of unknown function (DUF305) (PF03713)	Bacterial pullanase-associated domain (PF03714)	PF03715	PF03716	Penicillin-binding Protein dimerisation domain (PF03717)	Glycosyl hydrolase family 49 (PF03718)	Ribosomal protein S5, C-terminal domain (PF03719)	UDP-glucose/GDP-mannose dehydrogenase family, UDP binding domain (PF03720)	UDP-glucose/GDP-mannose dehydrogenase family, NAD binding domain (PF03721)	Hemocyanin, all-alpha domain (PF03722)	Hemocyanin, ig-like domain (PF03723)	META domain (PF03724)	3' exoribonuclease family, domain 2 (PF03725)	Polyribonucleotide nucleotidyltransferase, RNA binding domain (PF03726)	Hexokinase (PF03727)	PF03729	Ku70/Ku80 C-terminal arm (PF03730)	Ku70/Ku80 N-terminal alpha/beta domain (PF03731)	PF03732	PF03733	L,D-transpeptidase catalytic domain (PF03734)	Demethylmenaquinone methyltransferase (PF03737)	Glutathionylspermidine synthase preATP-grasp (PF03738)	PF03739	Pyridoxal phosphate biosynthesis protein PdxJ (PF03740)	PF03741	Bacterial conjugation TrbI-like protein (PF03743)	PF03744	Domain of unknown function (DUF309) (PF03745)	LamB/YcsF family (PF03746)	ADP-ribosylglycohydrolase (PF03747)	PF03748	Sugar fermentation stimulation protein (PF03749)	PF03752	PF03755	PF03756	Elongation factor G, domain IV (PF03764)	CRAL/TRIO, N-terminal domain (PF03765)	HAD superfamily, subfamily IIIB (Acid phosphatase) (PF03767)	Inositol polyphosphate kinase (PF03770)	PF03772	PF03773	Septum formation inhibitor MinC, C-terminal domain (PF03775)	Septum formation topological specificity factor MinE (PF03776)	PF03777	PF03779	PF03780	Sulfatase-modifying factor enzyme 1 (PF03781)	PF03783	D-mannonate dehydratase (UxuA) (PF03786)	RAMP superfamily (PF03787)	PF03788	PASTA domain (PF03793)	YCII-related domain (PF03795)	DnaB-like helicase C terminal domain (PF03796)	Autotransporter beta-domain (PF03797)	PF03798	Cell division protein FtsQ (PF03799)	Nuf2 family (PF03800)	HEC/Ndc80p family (PF03801)	PF03802	PF03803	PF03806	NADP oxidoreductase coenzyme F420-dependent (PF03807)	PF03808	Importin-beta N-terminal domain (PF03810)	PF03811	PF03812	Nrap protein (PF03813)	PF03814	LCCL domain (PF03815)	Cell envelope-related transcriptional attenuator domain (PF03816)	PF03817	PF03818	MazG nucleotide pyrophosphohydrolase domain (PF03819)	PF03820	PF03824	Cid1 family poly A polymerase (PF03828)	PTS system glucitol/sorbitol-specific IIA component (PF03829)	PTS system sorbose subfamily IIB component (PF03830)	PhnA protein (PF03831)	DNA polymerase II large subunit DP2 (PF03833)	Binding domain of DNA repair protein Ercc1 (rad10/Swi10) (PF03834)	Rad4 transglutaminase-like domain (PF03835)	RasGAP C-terminus (PF03836)	PF03837	Recombination protein U (PF03838)	PF03839	Preprotein translocase SecG subunit (PF03840)	L-seryl-tRNA selenium transferase (PF03841)	PF03843	PF03845	Cell division inhibitor SulA (PF03846)	Transcription initiation factor TFIID subunit A (PF03847)	Tellurite resistance protein TehB (PF03848)	PF03849	Transcription factor Tfb4 (PF03850)	UV-endonuclease UvdE (PF03851)	DNA mismatch endonuclease Vsr (PF03852)	YjeF-related protein N-terminus (PF03853)	PF03856	Domain of Unknown Function (DUF326) (PF03860)	ANTAR domain (PF03861)	PF03862	Phage major capsid protein E (PF03864)	Haemolysin secretion/activation protein ShlB/FhaC/HecB (PF03865)	Arc-like DNA binding domain (PF03869)	RNA polymerase Rpb8 (PF03870)	RNA polymerase Rpb5, N-terminal domain (PF03871)	Anti sigma-E protein RseA, N-terminal domain (PF03872)	Anti sigma-E protein RseA, C-terminal domain (PF03873)	SHS2 domain found in N terminus of Rpb7p/Rpc25p/MJ0397 (PF03876)	PF03878	DbpA RNA binding domain (PF03880)	Fructosamine kinase (PF03881)	KicB killing factor (PF03882)	PF03883	Domain of unknown function (DUF329) (PF03884)	Protein of unknown function (DUF327) (PF03885)	Protein of unknown function (DUF330) (PF03886)	YfbU domain (PF03887)	MucB/RseB family (PF03888)	PF03889	PF03891	Nitrate reductase cytochrome c-type subunit (NapB) (PF03892)	D-xylulose 5-phosphate/D-fructose 6-phosphate phosphoketolase (PF03894)	YadA-like C-terminal region (PF03895)	PF03899	Porphobilinogen deaminase, C-terminal domain (PF03900)	PF03901	Gal4-like dimerisation domain (PF03902)	PF03907	PF03908	BSD domain (PF03909)	Adenovirus minor core protein PV (PF03910)	Sec61beta family (PF03911)	PF03914	Actin interacting protein 3 (PF03915)	PF03916	Eukaryotic glutathione synthase, ATP binding domain (PF03917)	Cytochrome C biogenesis protein (PF03918)	mRNA capping enzyme, C-terminal domain (PF03919)	OmpW family (PF03922)	PF03923	CHASE domain (PF03924)	SeqA protein (PF03925)	Domain of unknown function (DUF336) (PF03928)	PF03929	Skp1 family, tetramerisation domain (PF03931)	CutC family (PF03932)	Type II secretion system (T2SS), protein K (PF03934)	Beta-glucan synthesis-associated protein (SKN1) (PF03935)	Terpene synthase family, metal binding domain (PF03936)	Flavinator of succinate dehydrogenase (PF03937)	Outer membrane protein (OmpH-like) (PF03938)	Inner centromere protein, ARK binding region (PF03941)	PF03942	TAP C-terminal domain (PF03943)	delta endotoxin, N-terminal domain (PF03945)	Ribosomal protein L11, N-terminal domain (PF03946)	Ribosomal Proteins L2, C-terminal domain (PF03947)	Ribosomal protein L9, C-terminal domain (PF03948)	Malic enzyme, NAD binding domain (PF03949)	tRNA synthetases class I (E and Q), anti-codon binding domain (PF03950)	Glutamine synthetase, beta-Grasp domain (PF03951)	Enolase, N-terminal domain (PF03952)	Tubulin C-terminal domain (PF03953)	PF03956	Bacterial type II/III secretion system short domain (PF03958)	Serine hydrolase (FSH1) (PF03959)	ArsC family (PF03960)	PF03961	PF03962	PF03963	Penicillinase repressor (PF03965)	Trm112p-like protein (PF03966)	Photosynthetic reaction centre, H-chain N-terminal region (PF03967)	OstA-like protein (PF03968)	AFG1-like ATPase (PF03969)	Monomeric isocitrate dehydrogenase (PF03971)	MmgE/PrpD family (PF03972)	Ecotin (PF03974)	CheD chemotactic sensory transduction (PF03975)	Polyphosphate kinase 2 (PPK2) (PF03976)	PF03977	Sigma-70 factor, region 1.1 (PF03979)	PF03980	PF03981	PF03982	SLA1 homology domain 1, SHD1 (PF03983)	Paf1 (PF03985)	Autophagocytosis associated protein (Atg3), N-terminal domain (PF03986)	Autophagocytosis associated protein, active-site domain (PF03987)	PF03988	DNA gyrase C-terminal domain, beta-propeller (PF03989)	PF03990	Antibiotic biosynthesis monooxygenase (PF03992)	PF03993	PF03994	Microtubule associated protein (MAP65/ASE1 family) (PF03999)	PF04000	RadC-like JAB domain (PF04002)	PF04003	Leo1-like protein (PF04004)	Hus1-like protein (PF04005)	PF04006	PF04007	Adenosine specific kinase (PF04008)	Protein of unknown function (DUF357) (PF04010)	LemA family (PF04011)	PF04012	Antidote-toxin recognition MazE (PF04014)	PF04015	Domain of unknown function (DUF364) (PF04016)	PF04018	PF04019	PF04020	FeoA domain (PF04023)	PF04024	SpoVG (PF04026)	Domain of unknown function (DUF371) (PF04027)	PF04028	2-phosphosulpholactate phosphatase (PF04029)	D-arabinono-1,4-lactone oxidase (PF04030)	PF04031	PF04034	PF04037	PF04039	Domain of unknown function (DUF377) (PF04041)	DNA polymerase alpha/epsilon subunit B (PF04042)	Arp2/3 complex, 34 kD subunit p34-Arc (PF04045)	PF04046	PF04048	Anaphase promoting complex subunit 8 / Cdc23 (PF04049)	Up-frameshift suppressor 2 (PF04050)	Transport protein particle (TRAPP) component (PF04051)	TolB amino-terminal domain (PF04052)	Coatomer WD associated region (PF04053)	CCR4-Not complex component, Not1 (PF04054)	Radical SAM superfamily (PF04055)	Ssl1-like (PF04056)	Replication factor-A protein 1, N-terminal domain (PF04057)	PF04059	Putative Fe-S cluster (PF04060)	PF04061	ARP2/3 complex ARPC3 (21 kDa) subunit (PF04062)	PF04063	PF04064	PF04065	PF04066	Possible Fer4-like domain in RNase L inhibitor, RLI (PF04068)	Substrate binding domain of ABC-type glycine betaine transport system (PF04069)	PF04070	Leucine carboxyl methyltransferase (PF04072)	Aminoacyl-tRNA editing domain (PF04073)	Domain of unknown function (DUF386) (PF04074)	Domain of unknown function (DUF385) (PF04075)	Bacterial OB fold (BOF) protein (PF04076)	DsrH like protein (PF04077)	Cell differentiation family, Rcd1-like (PF04078)	Putative transcriptional regulators (Ypuh-like) (PF04079)	PF04080	PF04082	Partial alpha/beta-hydrolase lipase region (PF04083)	PF04084	rod shape-determining protein MreC (PF04085)	Signal recognition particle, alpha subunit, N-terminal (PF04086)	PF04087	PF04088	Exocyst complex subunit Sec15-like (PF04091)	PF04093	Nicotinate phosphoribosyltransferase (NAPRTase) family (PF04095)	Nucleoporin autopeptidase (PF04096)	Nup93/Nic96 (PF04097)	Rad52/22 family double-strand break repair protein (PF04098)	Sybindin-like family (PF04099)	PF04100	Glycosyltransferase family 28 C-terminal domain (PF04101)	SlyX (PF04102)	Eukaryotic and archaeal DNA primase, large subunit (PF04104)	Autophagy protein Apg5 (PF04106)	Glutamate-cysteine ligase family 2(GCS2) (PF04107)	PF04109	Ubiquitin-like autophagy protein Apg12 (PF04110)	Autophagy protein Apg6 (PF04111)	PF04112	PF04113	PF04114	Ureidoglycolate hydrolase (PF04115)	PF04116	PF04117	PF04118	PF04120	Nuclear pore protein 84 / 107 (PF04121)	PF04122	PF04123	PF04124	Cyclophilin-like (PF04126)	DNA / pantothenate metabolism flavoprotein (PF04127)	PF04129	Spc97 / Spc98 family (PF04130)	Putative N-acetylmannosamine-6-phosphate epimerase (PF04131)	PF04134	PF04136	Endoplasmic Reticulum Oxidoreductin 1 (ERO1) (PF04137)	PF04138	Rad9 (PF04139)	Isoprenylcysteine carboxyl methyltransferase (ICMT) family (PF04140)	PF04142	PF04143	Ctr copper transporter family (PF04145)	YT521-B-like domain (PF04146)	PF04147	PF04148	Bacterial pre-peptidase C-terminal domain (PF04151)	Mre11 DNA-binding presumed domain (PF04152)	NOT2 / NOT3 / NOT5 family (PF04153)	EAP30/Vps36 family (PF04157)	PF04158	PF04161	PF04163	Pyridoxal phosphate biosynthetic protein PdxA (PF04166)	Protein of unknown function (DUF402) (PF04167)	PF04168	NlpE N-terminal domain (PF04170)	PF04172	PF04173	A circularly permuted ATPgrasp (PF04174)	Protein of unknown function (DUF406) (PF04175)	PF04176	TAP42-like family (PF04177)	PF04178	PF04179	PF04180	Rtr1/RPAP2 family (PF04181)	B-block binding subunit of TFIIIC (PF04182)	IucA / IucC family (PF04183)	PF04184	Phosphoesterase family (PF04185)	PF04186	Protein of unknown function, DUF399 (PF04187)	PF04188	PF04189	Protein of unknown function (DUF410) (PF04190)	Phospholipid methyltransferase (PF04191)	PF04192	PF04193	PF04194	Putative sugar-binding domain (PF04198)	Putative cyclase (PF04199)	Lipoprotein associated domain (PF04200)	Sortase family (PF04203)	Homoserine O-succinyltransferase (PF04204)	FMN-binding domain (PF04205)	PF04208	homogentisate 1,2-dioxygenase (PF04209)	MIT (microtubule interacting and transport) domain (PF04212)	PF04213	PF04214	Protein involved in formate dehydrogenase formation (PF04216)	PF04217	CENP-B N-terminal DNA-binding domain (PF04218)	PF04219	RelB antitoxin (PF04221)	Protein of unknown function (DUF416) (PF04222)	Citrate lyase, alpha subunit (CitF) (PF04223)	PF04224	Opacity-associated protein A LysM-like domain (PF04225)	PF04226	Indigoidine synthase A like protein (PF04227)	PF04228	GrpB protein (PF04229)	PF04230	Endonuclease I (PF04231)	PF04233	CopC domain (PF04234)	PF04235	YjbR (PF04237)	PF04238	Protein of unknown function (DUF421) (PF04239)	PF04240	PF04241	Deoxyribodipyrimidine photo-lyase-related protein (PF04244)	PF04245	PF04246	PF04247	Domain of unknown function (DUF427) (PF04248)	PF04250	Transferrin receptor-like dimerisation domain (PF04253)	Protein of unknown function (DUF433) (PF04255)	PF04256	PF04258	Protein of unknown function (DUF436) (PF04260)	Dyp-type peroxidase family (PF04261)	Glutamate-cysteine ligase (PF04262)	Thiamin pyrophosphokinase, catalytic domain (PF04263)	YceI-like domain (PF04264)	Thiamin pyrophosphokinase, vitamin B1 binding domain (PF04265)	ASCH domain (PF04266)	Sarcosine oxidase, delta subunit family (PF04267)	Sarcosine oxidase, gamma subunit family (PF04268)	Protein of unknown function, DUF440 (PF04269)	Streptococcal histidine triad protein (PF04270)	Putative phosphatase (DUF442) (PF04273)	Phosphomevalonate kinase (PF04275)	PF04277	PF04279	Tim44-like domain (PF04280)	PF04281	PF04282	PF04284	PF04285	PF04286	tRNA pseudouridine synthase C (PF04287)	MukE-like family (PF04288)	Protein of unknown function (DUF447) (PF04289)	PF04290	PF04293	PF04294	PF04295	Protein of unknown function (DUF448) (PF04296)	PF04298	Putative FMN-binding domain (PF04299)	PrpF protein (PF04303)	PF04304	PF04305	PF04306	PF04307	PF04308	Glycerol-3-phosphate responsive antiterminator (PF04309)	MukB N-terminal (PF04310)	PF04311	Type I restriction enzyme R protein N terminus (HSDR_N) (PF04313)	Protein of unknown function (DUF461) (PF04314)	PF04315	Anti-sigma-28 factor, FlgM (PF04316)	PF04317	PF04320	RmlD substrate binding domain (PF04321)	BFD-like [2Fe-2S] binding domain (PF04324)	Protein of unknown function (DUF465) (PF04325)	Divergent AAA domain (PF04326)	Protein of unknown function (DUF464) (PF04327)	PF04328	PF04332	PF04333	VirB8 protein (PF04335)	PF04336	Protein of unknown function, DUF480 (PF04337)	Protein of unknown function, DUF481 (PF04338)	PF04339	Protein of unknown function, DUF484 (PF04340)	PF04341	PF04342	PF04343	Chemotaxis phosphatase, CheZ (PF04344)	Chorismate lyase (PF04345)	PF04346	PF04347	LppC putative lipoprotein (PF04348)	Periplasmic glucan biosynthesis protein, MdoG (PF04349)	Pilus assembly protein, PilO (PF04350)	Pilus assembly protein, PilP (PF04351)	ProQ/FINO family (PF04352)	Regulator of RNA polymerase sigma(70) subunit, Rsd/AlgQ (PF04353)	ZipA, C-terminal FtsZ-binding domain (PF04354)	SmpA / OmlA family (PF04355)	Protein of unknown function (DUF489) (PF04356)	PF04357	DsrC like protein (PF04358)	Protein of unknown function (DUF493) (PF04359)	PF04361	Bacterial Fe(2+) trafficking (PF04362)	PF04363	DNA polymerase III chi subunit, HolC (PF04364)	Protein of unknown function (DUF497) (PF04365)	PF04366	PF04367	Porphyromonas-type peptidyl-arginine deiminase (PF04371)	PF04375	PF04376	PF04377	Ribosomal RNA small subunit methyltransferase D, RsmJ (PF04378)	Protein of unknown function (DUF525) (PF04379)	PF04380	Putative exonuclease, RdgC (PF04381)	KilA-N domain (PF04383)	Iron-sulphur cluster assembly (PF04384)	Stringent starvation protein B (PF04386)	PF04387	Hamartin protein (PF04388)	Peptidase family M28 (PF04389)	Lipopolysaccharide-assembly (PF04390)	PF04391	ABC transporter substrate binding protein (PF04392)	PF04393	PF04394	LytTr DNA-binding domain (PF04397)	Glutaredoxin 2, C terminal domain (PF04399)	Protein of unknown function (DUF541) (PF04402)	PF04403	PF04404	PF04405	Type IIB DNA topoisomerase (PF04406)	Helicase associated domain (HA2) (PF04408)	Gar1/Naf1 RNA binding region (PF04410)	PF04411	PF04412	3-Deoxy-D-manno-octulosonic-acid transferase (kdotransferase) (PF04413)	D-aminoacyl-tRNA deacylase (PF04414)	PF04417	CHD5-like protein (PF04420)	Coenzyme F420 hydrogenase/dehydrogenase, beta subunit N-term (PF04422)	Rad50 zinc hook motif (PF04423)	PF04424	PF04425	PF04426	Brix domain (PF04427)	PF04428	Protein of unknown function (DUF498/DUF598) (PF04430)	Coenzyme F420 hydrogenase/dehydrogenase, beta subunit C terminus (PF04432)	SWIRM domain (PF04433)	PF04434	RINT-1 / TIP-1 family (PF04437)	HIT zinc finger (PF04438)	Streptomycin adenylyltransferase (PF04439)	Cytochrome c oxidase assembly protein CtaG/Cox11 (PF04442)	PF04443	Catechol dioxygenase N terminus (PF04444)	Putative SAM-dependent methyltransferase (PF04445)	tRNAHis guanylyltransferase (PF04446)	CS1 type fimbrial major subunit (PF04449)	PF04450	RNA methyltransferase (PF04452)	Organic solvent tolerance protein (PF04453)	Encapsulating protein for peroxidase (PF04454)	LOR/SDH bifunctional enzyme conserved region (PF04455)	Protein of unknown function (DUF503) (PF04456)	PF04457	PF04459	Protein of unknown function (DUF520) (PF04461)	PF04463	CDP-Glycerol:Poly(glycerophosphate) glycerophosphotransferase (PF04464)	PF04465	Phage terminase large subunit (PF04466)	PF04468	Restriction endonuclease (PF04471)	Protein of unknown function (DUF552) (PF04472)	PF04474	PF04479	Protein of unknown function (DUF559) (PF04480)	Glycosyltransferase sugar-binding region containing DXD motif (PF04488)	PF04492	Endonuclease V (PF04493)	WD40 associated region in TFIID subunit (PF04494)	GRASP55/65 PDZ-like domain (PF04495)	PF04499	FLYWCH zinc finger domain (PF04500)	PF04502	PF04506	Protein of unknown function, DUF576 (PF04507)	CheC-like family (PF04509)	PF04511	PF04515	PF04516	PF04519	Tubby C 2 (PF04525)	TLP18.3, Psb32 and MOLO-1 founding proteins of phosphatase (PF04536)	Sigma-70 region 3 (PF04539)	Sigma-70 region 2 (PF04542)	Sigma-70, region 4 (PF04545)	Sigma-70, non-essential region (PF04546)	PF04547	GcpE protein (PF04551)	Sigma-54, DNA binding domain (PF04552)	PF04555	PF04559	RNA polymerase Rpb2, domain 7 (PF04560)	RNA polymerase Rpb2, domain 2 (PF04561)	RNA polymerase beta subunit (PF04563)	U-box domain (PF04564)	RNA polymerase Rpb2, domain 3 (PF04565)	RNA polymerase Rpb2, domain 4 (PF04566)	RNA polymerase Rpb2, domain 5 (PF04567)	PF04571	PF04575	PF04577	PF04586	ADP-specific Phosphofructokinase/Glucokinase conserved region (PF04587)	Hypoxia induced protein conserved region (PF04588)	PF04597	Mycobacterial cell wall arabinan synthesis protein (PF04602)	Ran-interacting Mog1 protein (PF04603)	PF04606	Region found in RelA / SpoT proteins (PF04607)	Phosphatidylglycerophosphatase A (PF04608)	PF04610	Type II secretion system (T2SS), protein M (PF04612)	UDP-3-O-[3-hydroxymyristoyl] glucosamine N-acyltransferase, LpxD (PF04613)	PF04615	Glycosyl hydrolases family 43 (PF04616)	PF04620	PF04622	Sedlin, N-terminal conserved region (PF04628)	PF04630	PF04632	PF04636	PF04641	PF04646	PF04650	PF04654	Aminoglycoside/hydroxyurea antibiotic resistance kinase (PF04655)	PF04657	TAFII55 protein conserved region (PF04658)	Phenol hydroxylase conserved region (PF04663)	PF04664	PF04666	Polysaccharide biosynthesis (PF04669)	Gtr1/RagA G protein conserved region (PF04670)	S-adenosyl methyltransferase (PF04672)	Polyketide synthesis cyclase (PF04673)	DNA ligase N terminus (PF04675)	PF04676	Protein similar to CwfJ C-terminus 1 (PF04677)	PF04678	ATP dependent DNA ligase C terminal region (PF04679)	Proteasome complex subunit Rpn13 ubiquitin receptor (PF04683)	Protein of unknown function, DUF608 (PF04685)	Streptomyces sporulation and cell division protein, SsgA (PF04686)	Microvirus H protein (pilot protein) (PF04687)	PF04693	Peroxisomal membrane anchor protein (Pex14p) conserved region (PF04695)	FaeA-like protein (PF04703)	PF04707	Anthranilate synthase component I, N terminal region (PF04715)	PF04716	Phage-related baseplate assembly protein (PF04717)	hTAFII28-like protein conserved region (PF04719)	Ssu72-like protein (PF04722)	PF04724	PF04727	Lipoprotein leucine-zipper (PF04728)	Coatomer epsilon subunit (PF04733)	Neutral/alkaline non-lysosomal ceramidase (PF04734)	PF04737	PF04738	5'-AMP-activated protein kinase beta subunit, interation domain (PF04739)	PF04740	Monooxygenase subunit B protein (PF04744)	Divergent polysaccharide deacetylase (PF04748)	PF04749	PF04750	Protein of unknown function (DUF615) (PF04751)	PF04752	PF04754	PF04755	PF04756	PF04757	Translation initiation factor IF-2, N-terminal region (PF04760)	PF04762	PF04765	Protein of unknown function (DUF619) (PF04768)	PF04769	Influenza B matrix protein 2 (BM2) (PF04772)	FecR protein (PF04773)	Erv1 / Alr family (PF04777)	PF04784	PF04791	YdjC-like protein (PF04794)	PF04796	ETC complex I subunit conserved region (PF04800)	PF04801	PF04802	HupH hydrogenase expression protein, C-terminal conserved region (PF04809)	Sec23/Sec24 zinc finger (PF04810)	Sec23/Sec24 trunk domain (PF04811)	Sec23/Sec24 helical domain (PF04815)	Family of unknown function (DUF633) (PF04816)	RNA polymerase II-binding domain. (PF04818)	Tryptophan halogenase (PF04820)	PF04821	Conserved region of Rad21 / Rec8 like protein (PF04824)	PF04825	PF04827	Glutathione-dependent formaldehyde-activating enzyme (PF04828)	PF04829	PF04830	SOUL heme-binding protein (PF04832)	PF04837	Plastid and cyanobacterial ribosomal protein (PSRP-3 / Ycf65) (PF04839)	Vps16, C-terminal region (PF04840)	PF04841	Calcipressin (PF04847)	Type III restriction enzyme, res subunit (PF04851)	PF04855	CAF1 family ribonuclease (PF04857)	Phage portal protein (PF04860)	PF04862	PF04865	Uso1 / p115 like vesicle tethering protein, head region (PF04869)	PF04871	PF04874	PF04877	Molybdopterin oxidoreductase Fe4S4 domain (PF04879)	NUDE protein, C-terminal conserved region (PF04880)	Peroxin-3 (PF04882)	PF04883	PF04884	PF04886	PF04888	PF04892	PF04893	PF04894	PF04895	Ammonia monooxygenase/methane monooxygenase, subunit C (PF04896)	Glutamate synthase central domain (PF04898)	Fcf1 (PF04900)	SH3-binding, glutamic acid-rich protein (PF04908)	Amidohydrolase (PF04909)	PF04910	DltD C-terminal region (PF04914)	DltD N-terminal region (PF04915)	Phospholipase B (PF04916)	PF04917	DltD central region (PF04918)	Protein of unknown function (DUF655) (PF04919)	PF04921	PF04922	PF04923	Poly(A) polymerase predicted RNA binding domain (PF04926)	Poly(A) polymerase central domain (PF04928)	PF04930	PF04931	PF04932	PF04935	PF04939	Sensors of blue-light using FAD (PF04940)	YHS domain (PF04945)	PF04947	Protein of unknown function (DUF663) (PF04950)	D-aminopeptidase (PF04951)	Succinylglutamate desuccinylase / Aspartoacylase family (PF04952)	Siderophore-interacting protein (PF04954)	PF04955	Ribosome modulation factor (PF04957)	Arginine N-succinyltransferase beta subunit (PF04958)	PF04959	Glutaminase (PF04960)	Formiminotransferase-cyclodeaminase (PF04961)	KduI/IolB family (PF04962)	Sigma-54 factor, core binding domain (PF04963)	Gene 25-like lysozyme (PF04965)	Carbohydrate-selective porin, OprB family (PF04966)	CHORD (PF04968)	CS domain (PF04969)	Lecithin retinol acyltransferase (PF04970)	PF04971	BON domain (PF04972)	PF04973	PF04976	Septum formation initiator (PF04977)	Protein of unknown function (DUF664) (PF04978)	Protein phosphatase inhibitor 2 (IPP-2) (PF04979)	PF04981	PF04982	RNA polymerase Rpb1, domain 3 (PF04983)	Phage tail sheath protein (PF04984)	PF04985	PF04986	PF04987	Cephalosporin hydroxylase (PF04989)	RNA polymerase Rpb1, domain 7 (PF04990)	PF04991	RNA polymerase Rpb1, domain 6 (PF04992)	TfoX N-terminal domain (PF04993)	TfoX C-terminal domain (PF04994)	Succinylarginine dihydrolase (PF04996)	RNA polymerase Rpb1, domain 1 (PF04997)	RNA polymerase Rpb1, domain 5 (PF04998)	PF04999	RNA polymerase Rpb1, domain 4 (PF05000)	RNA polymerase Rpb1 C-terminal repeat (PF05001)	SGS domain (PF05002)	PF05004	PF05007	Vesicle transport v-SNARE protein N-terminus (PF05008)	PF05011	N-formylglutamate amidohydrolase (PF05013)	Nucleoside 2-deoxyribosyltransferase (PF05014)	Plasmid maintenance system killer protein (PF05015)	Plasmid stabilisation system protein (PF05016)	PF05017	PF05018	Coenzyme Q (ubiquinone) biosynthesis protein Coq4 (PF05019)	PF05020	PF05021	Phytochelatin synthase (PF05023)	PF05024	RbsD / FucU transport protein family (PF05025)	Dcp2, box A domain (PF05026)	PF05029	Iron Transport-associated domain (PF05031)	Pre-SET motif (PF05033)	Methylaspartate ammonia-lyase N-terminus (PF05034)	2-keto-3-deoxy-galactonokinase (PF05035)	Sporulation related domain (PF05036)	PF05037	PF05042	Mga helix-turn-helix domain (PF05043)	PF05045	Mitochondrial large subunit ribosomal protein (Img2) (PF05046)	Mitochondrial ribosomal protein L51 / S25 / CI-B8 domain (PF05047)	Periplasmic copper-binding protein (NosD) (PF05048)	Methyltransferase FkbM domain (PF05050)	Putative serine esterase (DUF676) (PF05057)	PF05060	PF05063	Nsp1-like C-terminal region (PF05064)	Phage capsid family (PF05065)	HB1, ASXL, restriction endonuclease HTH domain (PF05066)	Manganese containing catalase (PF05067)	Mannitol repressor (PF05068)	PF05069	Suppressor of fused protein (SUFU) (PF05076)	PF05088	Alpha-N-acetylglucosaminidase (NAGLU) tim-barrel domain (PF05089)	PF05090	PF05091	PF05093	Glutamine cyclotransferase (PF05096)	Tellurite resistance protein TerB (PF05099)	PF05100	PF05101	DivIVA protein (PF05103)	PF05106	PF05107	Protein of unknown function (DUF690) (PF05108)	Protein of unknown function (DUF692) (PF05114)	Sucrose-6F-phosphate phosphohydrolase (PF05116)	PF05117	Aspartyl/Asparaginyl beta-hydroxylase (PF05118)	PF05119	PF05124	PF05125	Helicase (PF05127)	PF05128	FlgN protein (PF05130)	PF05131	PF05132	Phage portal protein, SPP1 Gp6-like (PF05133)	Type II secretion system (T2SS), protein L (PF05134)	Phage gp6-like head-tail connector protein (PF05135)	PF05136	PF05137	Phenylacetic acid catabolic protein (PF05138)	Erythromycin esterase (PF05139)	PF05140	Pyoverdine/dityrosine biosynthesis protein (PF05141)	PF05144	PF05145	Lanthionine synthetase C-like protein (PF05147)	Hypothetical methyltransferase (PF05148)	PF05149	Family of unknown function (DUF706) (PF05153)	PF05154	PF05155	Type II secretion system (T2SS), protein E, N-terminal domain (PF05157)	RNA polymerase Rpc34 subunit (PF05158)	PF05159	MOFRL family (PF05161)	DinB family (PF05163)	Cell division protein ZapA (PF05164)	GGDN family (PF05165)	YcgL domain (PF05166)	Uncharacterised ACR (DUF711) (PF05167)	HEPN domain (PF05168)	PF05170	Haemin-degrading HemS.ChuX domain (PF05171)	Dihydrodipicolinate reductase, C-terminus (PF05173)	Methyltransferase small domain (PF05175)	PF05176	PF05178	RNA pol II accessory factor, Cdc73 family (PF05179)	DNL zinc finger (PF05180)	XPA protein C-terminus (PF05181)	RNA dependent RNA polymerase (PF05183)	PRMT5 arginine-N-methyltransferase (PF05185)	Electron transfer flavoprotein-ubiquinone oxidoreductase (PF05187)	MutS domain II (PF05188)	RNA 3'-terminal phosphate cyclase (RTC), insert domain (PF05189)	MutS family domain IV (PF05190)	Adenylate kinase, active site lid (PF05191)	MutS domain III (PF05192)	Peptidase M16 inactive domain (PF05193)	UreE urease accessory protein, C-terminal domain (PF05194)	Aminopeptidase P, N-terminal domain (PF05195)	Translation initiation factor IF-3, N-terminal domain (PF05198)	GMC oxidoreductase (PF05199)	Glutamyl-tRNAGlu reductase, N-terminal domain (PF05201)	Hom_end-associated Hint (PF05203)	Homing endonuclease (PF05204)	PF05208	Septum formation inhibitor MinC, N-terminal domain (PF05209)	PF05216	S-adenosyl-L-homocysteine hydrolase (PF05221)	Alanine dehydrogenase/PNT, N-terminal domain (PF05222)	NTF2-like N-terminal transpeptidase domain (PF05223)	NDT80 / PhoG like DNA-binding  family (PF05224)	helix-turn-helix, Psq domain (PF05225)	PF05226	CHASE3 domain (PF05227)	PF05228	PF05229	PF05230	PF05231	PF05232	PF05233	CHAD domain (PF05235)	Transcription initiation factor TFIID component TAF4 family (PF05236)	MoeZ/MoeB domain (PF05237)	Kinetochore protein CHL4 like (PF05238)	PRC-barrel domain (PF05239)	PF05241	Flagellar transcriptional activator (FlhD) (PF05247)	PF05255	CHAP domain (PF05257)	PF05258	TraM protein, DNA-binding (PF05261)	PF05262	PF05263	Bacteriophage CII protein (PF05269)	Alpha-L-arabinofuranosidase B (ABFB) (PF05270)	PF05272	PF05275	PF05277	Flagellar transcriptional activator (FlhC) (PF05280)	AAR2 protein (PF05282)	PF05284	PF05285	PF05291	Malonyl-CoA decarboxylase (MCD) (PF05292)	Mammalian taste receptor protein (TAS2R) (PF05296)	M61 glycyl aminopeptidase (PF05299)	Protein of unknown function (DUF727) (PF05303)	PF05305	PF05309	PF05316	Haemolysin expression modulating protein (PF05321)	RNA polymerase I specific transcription initiation factor RRN3 (PF05327)	CybS (PF05328)	PF05331	Domain of unknown function (DUF718) (PF05336)	M42 glutamyl aminopeptidase (PF05343)	Putative Ig domain (PF05345)	PF05346	PF05347	PF05348	Phage Head-Tail Attachment (PF05354)	PF05359	PF05360	Lon protease (S16) C-terminal proteolytic domain (PF05362)	Ubiquinol-cytochrome C reductase, UQCRX/QCR9 like (PF05365)	NmrA-like family (PF05368)	Phage major coat protein, Gp8 (PF05371)	PF05378	PF05380	PF05382	La domain (PF05383)	PF05384	PF05388	Negative regulator of genetic competence (MecA) (PF05389)	Flagellar protein FliT (PF05400)	Nodulation protein S (NodS) (PF05401)	Coenzyme PQQ synthesis protein D (PqqD) (PF05402)	Mitochondrial ATP synthase B chain precursor (ATP-synt_B) (PF05405)	WGR domain (PF05406)	PF05420	Stress-activated map kinase interacting protein 1 (SIN1) (PF05422)	Mycobacterium membrane protein (PF05423)	PF05425	Alginate lyase (PF05426)	S-adenosyl-L-methionine-dependent methyltransferase (PF05430)	PF05433	PF05437	ROS/MUCR transcriptional regulator protein (PF05443)	Acetyl xylan esterase (AXE1) (PF05448)	PF05449	PF05460	PF05461	PF05470	DNA replication terminus site-binding protein (Ter protein) (PF05472)	THAP domain (PF05485)	PAAR motif (PF05488)	Phage Tail Protein X (PF05489)	Holliday junction DNA helicase ruvB C-terminus (PF05491)	Toluene tolerance, Ttg2 (PF05494)	CHY zinc finger (PF05495)	Holliday junction DNA helicase ruvB N-terminus (PF05496)	Destabilase (PF05497)	PF05502	Spore germination B3/ GerAC like, C-terminal (PF05504)	PF05506	PF05508	PF05513	Phage head-tail joining protein (PF05521)	WxcM-like, C-terminal (PF05523)	PEP-utilising enzyme, N-terminal (PF05524)	PF05525	CsbD-like (PF05532)	PF05534	Proline racemase (PF05544)	PF05545	PF05546	PF05547	Conserved TM helix (PF05552)	Mitotic checkpoint protein (PF05557)	PF05559	PF05565	Neisseria PilC beta-propeller domain (PF05567)	BlaR1 peptidase M56 (PF05569)	Pregnancy-associated plasma protein-A (PF05572)	NosL (PF05573)	PS-10 peptidase S37 (PF05576)	Serine carboxypeptidase S28 (PF05577)	PF05580	Vibrio chemotaxis protein N terminus (PF05581)	PF05582	PF05585	PF05591	Bacterial alpha-L-rhamnosidase (PF05592)	PF05593	PF05594	PF05597	PF05598	PF05602	PF05610	PF05615	PF05621	HOOK protein (PF05622)	PAXNEB protein (PF05625)	PF05626	Necrosis inducing protein (NPP1) (PF05630)	PF05631	23S rRNA-intervening sequence protein (PF05635)	HIGH Nucleotidyl Transferase (PF05636)	galactosyl transferase GMA12/MNN10 family (PF05637)	Protein of unknown function (DUF796) (PF05638)	Agenet domain (PF05641)	Putative bacterial lipoprotein (DUF799) (PF05643)	PF05644	RNA polymerase III subunit RPC82 (PF05645)	PF05648	Peptidase family M13 (PF05649)	PF05651	Scavenger mRNA decapping enzyme (DcpS) N-terminal (PF05652)	PF05653	PF05656	PF05657	Head domain of trimeric autotransporter adhesin (PF05658)	PF05661	Coiled stalk of trimeric autotransporter adhesin (PF05662)	PF05664	PF05670	Protein of unknown function (DUF815) (PF05673)	PF05675	PF05679	PF05680	PF05681	Fumarase C-terminus (PF05683)	PF05684	Putative restriction endonuclease (PF05685)	PF05686	PF05688	PF05689	Thiazole biosynthesis protein ThiG (PF05690)	PF05691	Glycogen synthase (PF05693)	56kDa selenium binding protein (SBP56) (PF05694)	PF05695	Bacterial trigger factor protein (TF) (PF05697)	Bacterial trigger factor protein (TF) C-terminus (PF05698)	hAT family C-terminal dimerisation region (PF05699)	PF05704	PF05705	Cyclin-dependent kinase inhibitor 3 (CDKN3) (PF05706)	Zonular occludens toxin (Zot) (PF05707)	Macrocin-O-methyltransferase (TylF) (PF05711)	MRG (PF05712)	PF05713	PF05717	Golgi phosphoprotein 3 (GPP34) (PF05719)	Phytanoyl-CoA dioxygenase (PhyH) (PF05721)	Thiopurine S-methyltransferase (TPMT) (PF05724)	Pirin C-terminal cupin domain (PF05726)	Uncharacterised protein family (UPF0227) (PF05728)	PF05730	TROVE domain (PF05731)	PF05732	OprF membrane domain (PF05736)	Collagen binding domain (PF05737)	Cna protein B-type domain (PF05738)	SNARE domain (PF05739)	PF05742	DALR anticodon binding domain (PF05746)	PF05751	5' nucleotidase family (PF05761)	VWA domain containing CoxE-like protein (PF05762)	PF05764	PF05766	Glutaredoxin-like domain (DUF836) (PF05768)	NinB protein (PF05772)	RWD domain (PF05773)	Enterobacteria AfaD invasin protein (PF05775)	PF05783	PF05786	Bacterial protein of unknown function (DUF839) (PF05787)	PF05792	PF05794	PF05810	PF05816	PF05818	PF05821	PF05827	Fibronectin-binding protein A N-terminus (FbpA) (PF05833)	PF05834	PF05837	Glycosyl hydrolase 108 (PF05838)	PF05840	Suppressor of forked protein (Suf) (PF05843)	Bacterial phosphonate metabolism protein (PhnH) (PF05845)	Firmicute transcriptional repressor of class III stress genes (CtsR) (PF05848)	Prokaryotic protein of unknown function (DUF849) (PF05853)	ARP2/3 complex 20 kDa subunit (ARPC4) (PF05856)	PF05857	PF05859	haemagglutination activity domain (PF05860)	PF05861	Endodeoxyribonuclease RusA (PF05866)	PF05869	Phenolic acid decarboxylase (PAD) (PF05870)	ESCRT-II complex subunit (PF05871)	PF05872	ATP synthase D chain, mitochondrial (ATP5H) (PF05873)	PF05875	PF05876	PF05879	PF05890	AdoMet dependent proline di-methyltransferase (PF05891)	Acyl-CoA reductase (LuxC) (PF05893)	PF05895	PF05896	Protein of unknown function (DUF861) (PF05899)	PF05901	PPPDE putative peptidase domain (PF05903)	Eukaryotic protein of unknown function (DUF866) (PF05907)	Protein of unknown function (DUF867) (PF05908)	Bacterial protein of unknown function (DUF871) (PF05913)	GINS complex protein (PF05916)	Homeobox KN domain (PF05920)	Peptidase inhibitor I9 (PF05922)	PF05926	PF05929	Prophage CP4-57 regulatory protein (AlpA) (PF05930)	Tir chaperone protein (CesT) family (PF05932)	Arylsulfotransferase (ASST) (PF05935)	PF05936	PF05939	PF05940	PF05943	PF05944	PF05947	Bacterial protein of unknown function (DUF881) (PF05949)	PF05951	PF05957	tRNA (Uracil-5-)-methyltransferase (PF05958)	Bacterial protein of unknown function (DUF885) (PF05960)	HutD (PF05962)	PF05970	Protein of unknown function (DUF890) (PF05971)	PF05973	Domain of unknown function (DUF892) (PF05974)	PF05975	Transmembrane secretion effector (PF05977)	PF05978	Bacterial protein of unknown function (DUF896) (PF05979)	PF05981	PF05982	MED7 protein (PF05983)	Ethanolamine ammonia-lyase light chain (EutC) (PF05985)	PF05987	PF05988	Alpha/beta hydrolase of unknown function (DUF900) (PF05990)	PF05991	PF05992	Cysteine dioxygenase type I (PF05995)	PF05997	Domain of Unknown Function (DUF902) (PF06001)	Bacterial protein of unknown function (DUF903) (PF06004)	Protein of unknown function (DUF904) (PF06005)	Bacterial protein of unknown function (DUF905) (PF06006)	PF06007	Laminin Domain II (PF06009)	PF06011	PF06012	Proteins of 100 residues with WXG (PF06013)	PF06017	CodY GAF-like domain (PF06018)	PF06025	Ribose 5-phosphate isomerase A (phosphoriboisomerase A) (PF06026)	PF06027	Alpha/beta hydrolase of unknown function (DUF915) (PF06028)	AlkA N-terminal domain (PF06029)	PF06030	Protein of unknown function (DUF917) (PF06032)	Bacterial transglutaminase-like cysteine proteinase BTLCP (PF06035)	PF06037	PF06039	Bacterial protein of unknown function (DUF924) (PF06041)	Bacterial protein of unknown function (DUF925) (PF06042)	Dam-replacing family (PF06044)	PF06045	Exocyst complex component Sec6 (PF06046)	PF06048	2-hydroxyglutaryl-CoA dehydratase, D-component (PF06050)	PF06051	3-hydroxyanthranilic acid dioxygenase (PF06052)	PF06054	PF06055	Putative ATPase subunit of terminase (gpP-like) (PF06056)	Bacterial virulence protein (VirJ) (PF06057)	Dcp1-like decapping family (PF06058)	PF06059	PF06062	PF06067	TIP49 C-terminus (PF06068)	Protein of unknown function (DUF933) (PF06071)	PF06073	PF06074	Bacterial protein of unknown function (DUF937) (PF06078)	Apyrase (PF06079)	PF06080	PF06081	PF06082	Tyrosyl-DNA phosphodiesterase (PF06087)	PF06089	Inositol-pentakisphosphate 2-kinase (PF06090)	PF06092	Spt4/RpoE2 zinc finger (PF06093)	AIG2-like family (PF06094)	PF06097	PF06099	Streptococcal 67 kDa myosin-cross-reactive antigen like family (PF06100)	PF06101	PF06102	PF06103	Protein of unknown function (DUF952) (PF06108)	Domain of unknown function (DUF955) (PF06114)	PF06120	PF06122	PF06123	Bacterial protein of unknown function (DUF961) (PF06125)	PF06127	PF06130	Protein of unknown function (DUF964) (PF06133)	L-rhamnose isomerase (RhaA) (PF06134)	DNA polymerase III, delta subunit (PF06144)	PF06146	PF06147	PF06148	PF06149	ChaB (PF06150)	PF06152	Protein of unknown function (DUF970) (PF06153)	Protein of unknown function (DUF971) (PF06155)	PF06159	PF06160	PF06161	PF06163	Glycosyltransferase family 36 (PF06165)	PF06166	Glucose-regulated metallo-peptidase M90 (PF06167)	PF06168	Protein of unknown function (DUF982) (PF06169)	PF06170	Cupin superfamily (DUF985) (PF06172)	PF06173	tRNA-(MS[2]IO[6]A)-hydroxylase (MiaE) (PF06175)	Lipopolysaccharide core biosynthesis protein (WaaY) (PF06176)	PF06177	Oligogalacturonate-specific porin protein (KdgM) (PF06178)	Surfeit locus protein 5 subunit 22 of Mediator complex (PF06179)	PF06181	PF06182	DinI-like family (PF06183)	YecM protein (PF06185)	PF06186	Protein of unknown function (DUF993) (PF06187)	PF06188	PF06189	PF06196	PF06197	PF06199	PITH domain (PF06201)	Amylo-alpha-1,6-glucosidase (PF06202)	Putative carbohydrate binding domain (PF06204)	Glycosyltransferase 36 associated family (PF06205)	PF06207	PF06210	PF06213	PF06218	PF06221	PF06223	PF06224	PF06226	Haem utilisation ChuX/HutX (PF06228)	FRG1-like family (PF06229)	Protein of unknown function (DUF1009) (PF06230)	PF06233	Carbon monoxide dehydrogenase subunit G (CoxG) (PF06240)	PF06242	Phenylacetic acid degradation B (PF06243)	PF06244	PF06245	PF06248	Ethanolamine utilisation protein EutQ (PF06249)	PF06250	Capsule biosynthesis GfcC (PF06251)	PF06252	Trimethylamine methyltransferase (MTTB) (PF06253)	Protein of unknown function (DUF1019) (PF06254)	PF06258	Alpha/beta hydrolase (PF06259)	Possibl zinc metallo-peptidase (PF06262)	Protein of unknown function (DUF1027) (PF06265)	PF06266	Family of unknown function (DUF1028) (PF06267)	Fascin domain (PF06268)	PF06271	Ferric iron reductase FhuF-like transporter (PF06276)	Ethanolamine utilisation protein EutA (PF06277)	Fn3-like domain (DUF1034) (PF06280)	PF06282	Trehalose utilisation (PF06283)	Protein of unknown function (DUF1040) (PF06288)	Plasmid SOS inhibition protein (PsiB) (PF06290)	PF06291	PF06292	Lipopolysaccharide kinase (Kdo/WaaP) family (PF06293)	PF06295	PF06296	PF06299	Organiser of macrodomain of Terminus of chromosome (PF06303)	Protein of unknown function (DUF1048) (PF06304)	PF06305	PF06311	Acetoacetate decarboxylase (ADC) (PF06314)	Isocitrate dehydrogenase kinase/phosphatase (AceK) (PF06315)	Protein of unknown function (DUF1052) (PF06319)	PF06320	Major fimbrial subunit protein (FimA) (PF06321)	Ribosomal protein L11 methyltransferase (PrmA) (PF06325)	Trichodiene synthase (TRI5) (PF06330)	PF06333	Protein of unknown function (DUF1054) (PF06335)	DUSP domain (PF06337)	PF06338	Bacterial SH3 domain (PF06347)	PF06353	PF06366	Diaphanous FH3 Domain (PF06367)	Diaphanous GTPase-binding Domain (PF06371)	PF06378	PF06379	PF06381	PF06386	PF06391	CDC24 Calponin (PF06395)	Integral peroxisomal membrane peroxin (PF06398)	StbA protein (PF06406)	HdeA/HdeB family (PF06411)	PF06412	PF06413	Zeta toxin (PF06414)	BPG-independent PGAM N-terminus (iPGM_N) (PF06415)	PF06417	CTP synthase N-terminus (PF06418)	PF06419	PF06420	GTP-binding protein LepA C-terminus (PF06421)	PF06422	PF06423	PF06424	Serine acetyltransferase, N-terminal (PF06426)	PF06427	GDP/GTP exchange factor Sec2p (PF06428)	Flagellar basal body rod FlgEFG protein C-terminal (PF06429)	PF06430	PF06432	Aconitate hydratase 2 N-terminus (PF06434)	PF06437	Domain of Unknown Function (DUF1080) (PF06439)	DNA polymerase III, theta subunit (PF06440)	Epoxide hydrolase N terminus (PF06441)	GyrI-like small molecule binding domain (PF06445)	PF06448	PF06450	Domain of unknown function (DUF1083) (PF06452)	PF06455	MucBP domain (PF06458)	PF06459	PF06461	Molybdenum Cofactor Synthesis C (PF06463)	PF06464	PF06465	MYM-type Zinc finger with FCS sequence motif (PF06467)	Spondin_N (PF06468)	PF06469	SMC proteins Flexible Hinge Domain (PF06470)	PF06472	PF06474	Putative glycolipid-binding (PF06475)	PF06476	Ribonuclease 2-5A (PF06479)	FtsH Extracellular (PF06480)	COX Aromatic Rich Motif (PF06481)	Collagenase NC10 and Endostatin (PF06482)	PF06485	Protein of unknown function (DUF1093) (PF06486)	Sin3 associated polypeptide p18 (SAP18) (PF06487)	PF06488	PF06490	Disulphide isomerase (PF06491)	PF06496	Alpha/beta hydrolase of unknown function (DUF1100) (PF06500)	PF06505	Propionate catabolism activator (PF06506)	Queuosine biosynthesis protein QueC (PF06508)	Invasion plasmid antigen IpaD (PF06511)	PF06512	PF06516	TolA C-terminal (PF06519)	Sulfocyanin (SoxE) (PF06525)	Protein of unknown function (DUF1107) (PF06526)	PF06527	PF06530	PF06532	PF06537	PF06541	PF06543	PF06544	Protein of unknown function (DUF1116) (PF06545)	PF06551	Plant specific mitochondrial import receptor subunit TOM20 (PF06552)	PF06558	2'-deoxycytidine 5'-triphosphate deaminase (DCD) (PF06559)	Glucose-6-phosphate isomerase (GPI) (PF06560)	YhjQ protein (PF06564)	Repeat of unknown function (DUF1126) (PF06565)	PF06568	PF06569	PF06570	Protein of unknown function (DUF1131) (PF06572)	FAD synthetase (PF06574)	PF06577	PF06580	PF06582	PF06586	PF06588	PF06594	Myotubularin-like phosphatase domain (PF06602)	Prophage endopeptidase tail (PF06605)	Fungal trichothecene efflux pump (TRI12) (PF06609)	PF06610	PF06611	PF06612	BsuBI/PstI restriction endonuclease C-terminus (PF06616)	PF06626	Protein of unknown function (DUF1153) (PF06627)	Catalase-related immune-responsive (PF06628)	PF06629	PF06630	Protein of unknown function (DUF1154) (PF06631)	PF06634	ATP11 protein (PF06644)	PF06649	PF06650	Centrosome microtubule-binding domain of Cep57 (PF06657)	PF06666	PF06667	PF06672	PF06674	PF06675	PF06676	Amino acid synthesis (PF06684)	PF06685	PF06687	ClpX C4-type zinc finger (PF06689)	PF06691	PF06693	PF06695	PF06703	Protein of unknown function (DUF1194) (PF06707)	PF06711	PF06713	Gp5 C-terminal repeat (3 copies) (PF06715)	PF06718	PF06719	MreB/Mbl protein (PF06723)	PF06724	3D domain (PF06725)	PF06726	PF06727	PF06728	PF06732	DEAD_2 (PF06733)	PF06736	Transglycosylase-like domain (PF06737)	PF06738	PF06739	PF06741	Protein of unknown function (DUF1214) (PF06742)	PF06744	KaiC (PF06745)	CHCH domain (PF06747)	Protein of unknown function (DUF1217) (PF06748)	PF06750	Ethanolamine ammonia lyase large subunit (EutB) (PF06751)	PF06754	PF06755	PF06761	PF06762	PF06763	Protein of unknown function (DUF1223) (PF06764)	Plasmid encoded toxin Txe (PF06769)	PF06772	PF06775	Invasion associated locus B (IalB) protein (PF06776)	PF06777	Chlorite dismutase (PF06778)	PF06779	PF06781	PF06782	PF06786	PF06788	PF06790	PF06791	Uncharacterised protein family (UPF0261) (PF06792)	PF06793	Uncharacterised protein family (UPF0270) (PF06794)	PF06798	PF06800	PF06803	NlpB/DapX lipoprotein (PF06804)	PF06805	Putative excisionase (DUF1233) (PF06806)	Pre-mRNA cleavage complex II protein Clp1 (PF06807)	PF06808	PF06810	PF06812	PF06814	Serine hydrolase (PF06821)	PF06823	Protein of unknown function (DUF1237) (PF06824)	PF06826	Zinc finger found in FPG and IleRS (PF06827)	Formamidopyrimidine-DNA glycosylase H2TH domain (PF06831)	PF06832	Malonate decarboxylase gamma subunit (MdcE) (PF06833)	PF06834	Lipopolysaccharide-assembly, LptC-related (PF06835)	Methionine gamma-lyase (PF06838)	PF06839	PF06841	Protein of unknown function (DUF1244) (PF06844)	Protein of unknown function (DUF1246) (PF06849)	PF06850	PF06853	PF06854	Protein of unknown function (DUF1250) (PF06855)	PF06857	Nucleolar GTP-binding protein 1 (NOG1) (PF06858)	PF06862	Protein of unknown function (DUF1254) (PF06863)	PF06864	Protein of unknown function (DUF1255) (PF06865)	PF06866	PF06868	A49-like RNA polymerase I associated factor (PF06870)	PF06874	Regulator of ribonuclease activity B (PF06877)	RNA polymerase II transcription factor SIII (Elongin) subunit A (PF06881)	RNA polymerase I, Rpa2 specific domain (PF06883)	PF06884	Putative Phosphatase (PF06888)	PF06889	Bacteriophage Mu Gp45 protein (PF06890)	PF06891	PF06892	PF06894	PF06897	PF06898	PF06899	Divergent 4Fe-4S mono-cluster (PF06902)	PF06904	PF06906	Protein of unknown function (DUF1273) (PF06908)	PF06911	PF06912	Dedicator of cytokinesis (PF06920)	PF06923	Protein of unknown function (DUF1281) (PF06924)	PF06925	PF06930	PF06932	PF06934	PF06935	Protein of unknown function (DUF1285) (PF06938)	PF06940	5' nucleotidase, deoxy (Pyrimidine), cytosolic type C protein (NT5C) (PF06941)	PF06942	PF06945	PF06947	PF06949	PF06952	Arsenical resistance operon trans-acting repressor ArsD (PF06953)	PF06956	Coatomer (COPI) alpha subunit C-terminus (PF06957)	S-type Pyocin (PF06958)	PF06961	Putative rRNA methylase (PF06962)	Alpha-L-arabinofuranosidase C-terminus (PF06964)	Na+/H+ antiporter 1 (PF06965)	PF06966	PF06967	Biotin and Thiamin Synthesis associated domain (PF06968)	HemN C-terminal domain (PF06969)	Replication initiator protein A (RepA) N-terminus (PF06970)	Putative DNA-binding protein N-terminus (PF06971)	Domain of unknown function (DUF1297) (PF06973)	PF06974	SdiA-regulated (PF06977)	PF06978	PF06980	3-demethylubiquinone-9 3-methyltransferase (PF06983)	PF06985	PF06986	PF06991	PF06992	PF06993	PF06995	PF06996	Protein of unknown function (DUF1307) (PF06998)	PF06999	PF07000	PF07004	Protein of unknown function, DUF1537 (PF07005)	PF07006	Protein of unknown function (DUF1311) (PF07007)	Protein of unknown function (DUF1312) (PF07009)	PF07012	VirC1 protein (PF07015)	Antimicrobial peptide resistance and lipid A acylation protein PagP (PF07017)	PF07019	Methionine biosynthesis protein MetW (PF07021)	Bacteriophage CI repressor helix-turn-helix domain (PF07022)	PF07023	ImpE protein (PF07024)	PF07027	PF07030	PF07034	PF07035	PF07037	SGF29 tudor-like domain (PF07039)	PF07040	PF07042	Protein of unknown function (DUF1329) (PF07044)	Protein of unknown function (DUF1330) (PF07045)	PF07047	Enoyl reductase FAD binding domain (PF07055)	DNA helicase TraI (PF07057)	Domain of unknown function (DUF1338) (PF07063)	PF07064	PF07065	Major capsid protein Gp23 (PF07068)	PF07070	Protein of unknown function (DUF1341) (PF07071)	Protein of unknown function (DUF1342) (PF07072)	Modulator of Rho-dependent transcription termination (ROF) (PF07073)	Protein of unknown function (DUF1343) (PF07075)	PF07076	PF07077	Protein of unknown function (DUF1348) (PF07080)	Protein of unknown function (DUF1349) (PF07081)	PF07083	Thyroid hormone-inducible hepatic protein Spot 14 (PF07084)	DRTGG domain (PF07085)	GvpD gas vesicle protein (PF07088)	Protein of unknown function (DUF1355) (PF07090)	PF07093	PF07095	PF07098	PF07099	Anabaena sensory rhodopsin transducer (PF07100)	Protein of unknown function (DUF1364) (PF07102)	PF07103	PF07105	Tat binding protein 1(TBP-1)-interacting protein (TBPIP) (PF07106)	Magnesium-protoporphyrin IX methyltransferase C-terminus (PF07109)	EthD domain (PF07110)	PF07119	PF07120	PF07126	PF07128	YebG protein (PF07130)	PF07136	PF07141	Hydroxyneurosporene synthase (CrtC) (PF07143)	PF07148	YaeQ protein (PF07152)	ECF-type riboflavin transporter, S component (PF07155)	PF07156	PF07157	PF07158	Protein of unknown function (DUF1396) (PF07161)	PF07162	PF07167	MlrC C-terminus (PF07171)	PF07173	PF07174	PF07178	PF07179	PF07182	zinc-ribbons (PF07191)	P2 response regulator binding domain (PF07194)	PF07195	Flagellin hook IN motif (PF07196)	Modifier of rudimentary (Mod(r)) protein (PF07200)	HrpJ-like domain (PF07201)	Protein of unknown function (DUF1414) (PF07208)	PF07209	PF07210	PF07215	PF07217	PF07219	PF07226	Stage II sporulation protein E (SpoIIE) (PF07228)	Protein of unknown function (DUF1425) (PF07233)	PF07235	Protein of unknown function (DUF1428) (PF07237)	PilZ domain (PF07238)	PF07242	Surface antigen variable number repeat (PF07244)	PF07247	Cerato-platanin (PF07249)	PF07250	PF07254	PF07256	Replication initiation and membrane attachment (PF07261)	Protein of unknown function (DUF1436) (PF07262)	Protein of unknown function (DUF1439) (PF07273)	PF07274	Antirestriction protein (ArdA) (PF07275)	PF07277	PF07278	PF07281	PF07282	PF07284	PF07285	Protein of unknown function (DUF1445) (PF07286)	PF07287	PF07290	PF07291	PF07293	PF07295	PF07296	PF07297	PF07298	Fibronectin-binding protein (FBP) (PF07299)	PF07302	Steroid receptor RNA activator (SRA1) (PF07304)	PF07305	PF07307	PF07308	PF07310	Dodecin (PF07311)	Protein of unknown function (DUF1460) (PF07313)	Flagellar regulator YcgR (PF07317)	Primosomal protein DnaI N-terminus (PF07319)	Protein of unknown function (DUF1465) (PF07323)	PF07324	PF07330	PF07331	PF07332	PF07335	Protein of unknown function (DUF1470) (PF07336)	Protein of unknown function (DUF1471) (PF07338)	Domain of unknown function (DUF1476) (PF07345)	Syd protein (SUKH-2) (PF07348)	Protein of unknown function (DUF1479) (PF07350)	PF07351	PF07355	PF07356	Cytochrome b562 (PF07361)	Post-segregation antitoxin CcdA (PF07362)	Protein of unknown function (DUF1485) (PF07364)	SnoaL-like polyketide cyclase (PF07366)	Protein of unknown function (DUF1488) (PF07369)	PF07370	Protein of unknown function (DUF1491) (PF07372)	PF07373	Protein of unknown function (DUF1493) (PF07377)	PF07378	PF07382	PF07383	Protein of unknown function (DUF1498) (PF07385)	PF07386	PF07393	PF07394	PF07395	Phosphate-selective porin O and P (PF07396)	PF07398	PF07399	PF07406	PF07409	Domain of unknown function (DUF1508) (PF07411)	Transcriptional regulator Crl (PF07417)	PilM (PF07419)	PF07429	PF07431	PF07433	CblD like pilus biogenesis initiator (PF07434)	YycH protein (PF07435)	PF07437	Primosomal replication protein priB and priC (PF07445)	PF07450	Stage V sporulation protein AD (SpoVAD) (PF07451)	PF07452	PF07453	PF07454	PF07456	NUMOD3 motif (2 copies) (PF07460)	NUMOD4 motif (PF07463)	Apolipophorin-III precursor (apoLp-III) (PF07464)	PF07466	Glycosyl Hydrolase Family 88 (PF07470)	Phage DNA packaging protein Nu1 (PF07471)	Fucose-binding lectin II (PA-IIL) (PF07472)	HPr Serine kinase C-terminal domain (PF07475)	Methylaspartate ammonia-lyase C-terminus (PF07476)	Glycosyl hydrolase family 67 C-terminus (PF07477)	D-ala D-ala ligase C-terminus (PF07478)	NAD-dependent glycerol-3-phosphate dehydrogenase C-terminus (PF07479)	PF07482	PF07483	Phage Tail Collar Domain (PF07484)	PF07485	Cell Wall Hydrolase (PF07486)	Glycosyl hydrolase family 67 middle domain (PF07488)	PF07491	PF07492	Two component regulator propeller (PF07494)	Y_Y_Y domain (PF07495)	Rho termination factor, RNA-binding domain (PF07497)	Rho termination factor, N-terminal domain (PF07498)	RuvA, C-terminal domain (PF07499)	Transcription factor S-II (TFIIS), central domain (PF07500)	G5 domain (PF07501)	HypF finger (PF07503)	Fungalysin/Thermolysin Propeptide Motif (PF07504)	PF07505	PF07506	PF07507	Recombinase (PF07508)	PF07509	PF07510	PF07511	Putative helicase (PF07514)	Protein of unknown function (DUF1528) (PF07515)	SecA Wing and Scaffold domain (PF07516)	SecA DEAD-like domain (PF07517)	Tannase and feruloyl esterase (PF07519)	PF07520	RNA-metabolising metallo-beta-lactamase (PF07521)	DNA repair metallo-beta-lactamase (PF07522)	Bacterial Ig-like domain (group 3) (PF07523)	Bromodomain associated (PF07524)	PF07529	PF07530	PF07532	BRK domain (PF07533)	TLD (PF07534)	DBF zinc finger (PF07535)	PF07536	CamS sex pheromone cAM373 precursor (PF07537)	PF07538	PF07539	PF07540	Eukaryotic translation initiation factor 2 alpha subunit (PF07541)	ATP12 chaperone protein (PF07542)	PF07544	SecD/SecF GG Motif (PF07549)	PF07550	PF07551	PF07552	Host cell surface-exposed lipoprotein (PF07553)	Uncharacterised Sugar-binding Domain (PF07554)	beta-N-acetylglucosaminidase (PF07555)	PF07557	PF07558	Flagellar basal body protein FlaE (PF07559)	PF07561	Nine Cysteines Domain of family 3 GPCR (PF07562)	Protein of unknown function (DUF1541) (PF07563)	PF07564	Domain of Unknown Function (DUF1543) (PF07566)	PF07568	PF07569	Protein of unknown function (DUF1546) (PF07571)	Nse1 non-SMC component of SMC5-6 complex (PF07574)	Nup85 Nucleoporin (PF07575)	PF07576	PF07581	AP endonuclease family 2 C terminus (PF07582)	PF07583	PF07584	PF07586	PF07587	PF07589	PF07592	PF07593	PF07596	PF07602	Protein of unknown function (DUF1569) (PF07606)	PF07607	PF07608	PF07609	PF07610	PF07613	PF07614	YKOF-related Family (PF07615)	PF07617	PF07624	PF07626	PF07627	PF07631	Protein of unknown function (DUF1593) (PF07632)	PF07635	PF07637	PF07639	PF07642	Calcium-binding EGF domain (PF07645)	Kelch motif (PF07646)	SAM domain (Sterile alpha motif) (PF07647)	Kazal-type serine protease inhibitor domain (PF07648)	KH domain (PF07650)	ANTH domain (PF07651)	Variant SH3 domain (PF07653)	PF07655	PF07659	Secretin and TonB N terminus short domain (PF07660)	PF07661	Na+ dependent nucleoside transporter C-terminus (PF07662)	PF07663	PF07664	PF07666	PF07668	Eco57I restriction-modification methylase (PF07669)	Nucleoside recognition (PF07670)	PF07673	Cleaved Adhesin Domain (PF07675)	WD40-like Beta Propeller Repeat (PF07676)	A-macroglobulin receptor (PF07677)	A-macroglobulin complement component (PF07678)	Immunoglobulin I-set domain (PF07679)	PF07681	Cobalamin synthesis protein cobW C-terminal domain (PF07683)	CobB/CobQ-like glutamine amidotransferase domain (PF07685)	Immunoglobulin V-set domain (PF07686)	Peptidase dimerisation domain (PF07687)	KaiB domain (PF07689)	Major Facilitator Superfamily (PF07690)	PA14 domain (PF07691)	PF07693	5TMR of 5TMR-LYT (PF07694)	PF07695	7TMR-DISM extracellular 2 (PF07696)	PF07697	PF07698	PF07699	Heme NO binding (PF07700)	Heme NO binding associated (PF07701)	UTRA domain (PF07702)	Alpha-2-macroglobulin family N-terminal region (PF07703)	CARDB (PF07705)	BTB And C-terminal Kelch (PF07707)	PF07713	Protein tyrosine kinase (PF07714)	TonB-dependent Receptor Plug Domain (PF07715)	Basic region leucine zipper (PF07716)	Oligonucleotide/oligosaccharide-binding (OB)-fold (PF07717)	PF07718	Tetratricopeptide repeat (PF07719)	Tetratricopeptide repeat (PF07721)	Peptidase C26 (PF07722)	AAA domain (Cdc48 subfamily) (PF07724)	ATPase family associated with various cellular activities (AAA) (PF07726)	PF07727	AAA domain (dynein-related subfamily) (PF07728)	FCD domain (PF07729)	Histidine kinase (PF07730)	Multicopper oxidase (PF07731)	Multicopper oxidase (PF07732)	Bacterial DNA polymerase III alpha subunit (PF07733)	Chorismate mutase type I (PF07736)	Sad1 / UNC-like C-terminal (PF07738)	TipAS antibiotic-recognition domain (PF07739)	Brf1-like TBP-binding domain (PF07741)	HSCB C-terminal oligomerisation domain (PF07743)	SPOC domain (PF07744)	Glycosyl hydrolase family 53 (PF07745)	Aromatic-ring-opening dioxygenase LigAB, LigA subunit (PF07746)	Glycosyl hydrolases family 38 C-terminal domain (PF07748)	Endoplasmic reticulum protein ERp29, C-terminal domain (PF07749)	PF07750	PF07751	Protein of unknown function (DUF1611) (PF07755)	PF07756	PF07757	PF07759	PF07763	LETM1-like protein (PF07766)	PF07767	PF07769	PF07774	PF07778	PF07779	PF07780	PF07784	PF07786	PF07791	PF07792	PF07793	PF07795	PF07796	PF07798	PF07799	HipA-like C-terminal domain (PF07804)	HipA-like N-terminal domain (PF07805)	PF07808	PF07811	PF07812	LTXXQ motif family protein (PF07813)	Wings apart-like protein regulation of heterochromatin (PF07814)	Abl-interactor HHR (PF07815)	GLE1-like protein (PF07817)	PF07818	PGAP1-like protein (PF07819)	Alpha-amylase C-terminal beta-sheet domain (PF07821)	Cyclic phosphodiesterase-like protein (PF07823)	IMP cyclohydrolase-like protein (PF07826)	Protein serine/threonine phosphatase 2C, C-terminal domain (PF07830)	Pyrimidine nucleoside phosphorylase C-terminal domain (PF07831)	Cfr10I/Bse634I restriction endonuclease (PF07832)	Copper amine oxidase N-terminal domain (PF07833)	DmpG-like communication domain (PF07836)	Formiminotransferase domain, N-terminal subdomain (PF07837)	FadR C-terminal domain (PF07840)	PF07842	PF07843	PF07845	PaaX-like protein (PF07848)	PF07849	PF07852	PF07853	PF07855	Mediator of CRAC channel activity (PF07856)	Limonene-1,2-epoxide hydrolase catalytic domain (PF07858)	alpha/beta hydrolase fold (PF07859)	PF07863	PF07865	Protein of unknown function (DUF1653) (PF07866)	PF07867	PF07869	YabP family (PF07873)	PF07875	Stress responsive A/B Barrel Domain (PF07876)	PF07879	L-fucose isomerase, first N-terminal domain (PF07881)	L-fucose isomerase, second N-terminal domain (PF07882)	Cupin domain (PF07883)	Vitamin K epoxide reductase family (PF07884)	Ion channel (PF07885)	PF07890	PF07902	PF07905	PF07907	D-aminoacylase, C-terminal region (PF07908)	Peptidase family C78 (PF07910)	Glucosidase II beta subunit-like protein (PF07915)	PF07916	PF07919	Protein of unknown function (DUF1684) (PF07920)	PF07923	PF07926	YcfA-like protein (PF07927)	Vps54-like protein (PF07928)	Plasmid pRiA4b ORF-3-like protein (PF07929)	D-aminopeptidase, domain B (PF07930)	Chloramphenicol phosphotransferase-like protein (PF07931)	D-aminopeptidase, domain C (PF07932)	8-oxoguanine DNA glycosylase, N-terminal domain (PF07934)	Heparinase II/III-like protein (PF07940)	PF07942	Penicillin-binding protein 5, C-terminal domain (PF07943)	Putative glycosyl hydrolase of unknown function (DUF1680) (PF07944)	PF07946	PF07947	YbbR-like protein (PF07949)	PF07950	PF07956	PF07958	PF07959	PF07960	PF07962	Prokaryotic N-terminal methylation motif (PF07963)	PF07967	Amidohydrolase family (PF07969)	Endoplasmic reticulum vesicle transporter (PF07970)	Glycosyl hydrolase family 92 (PF07971)	NrdI Flavodoxin like (PF07972)	Threonyl and Alanyl tRNA synthetase second additional domain (PF07973)	EGF-like domain (PF07974)	TFIIH C1-like domain (PF07975)	Phenol hydroxylase, C-terminal dimerisation domain (PF07976)	FabA-like domain (PF07977)	NIPSNAP (PF07978)	SusD family (PF07980)	X8 domain (PF07983)	Tubulin binding cofactor C (PF07986)	Domain of unkown function (DUF1775) (PF07987)	PF07989	Acetohydroxy acid isomeroreductase, catalytic domain (PF07991)	Pyridine nucleotide-disulphide oxidoreductase (PF07992)	Male sterility protein (PF07993)	Myo-inositol-1-phosphate synthase (PF07994)	Glucose / Sorbosone dehydrogenase (PF07995)	Type IV secretion system proteins (PF07996)	Protein of unknown function (DUF1694) (PF07997)	Peptidase family M54 (PF07998)	Bacterial PH domain (PF08000)	Protein of unknown function (DUF1697) (PF08002)	Protein of unknown function (DUF1698) (PF08003)	PF08006	Cupin superfamily protein (PF08007)	PF08009	PF08011	Tagatose 6 phosphate kinase (PF08013)	PF08014	Polycystin cation channel (PF08016)	PF08019	Protein of unknown function (DUF1706) (PF08020)	Siderophore-interacting FAD-binding domain (PF08021)	PF08022	Acyl-CoA dehydrogenase, C-terminal domain (PF08028)	HisG, C-terminal domain (PF08029)	Ferric reductase NAD binding domain (PF08030)	Berberine and berberine like (PF08031)	RNA 2'-O ribose methyltransferase substrate binding (PF08032)	Sec23/Sec24 beta-sandwich domain (PF08033)	PF08044	PF08045	PF08058	SEP domain (PF08059)	NOSIC (NUC001) domain (PF08060)	PF08064	PF08066	DKCLD (NUC011) domain (PF08068)	Ribosomal S13/S15 N-terminal domain (PF08069)	RS4NT (NUC023) domain (PF08071)	PF08074	Ribosomal L30 N-terminal domain (PF08079)	PF08082	PF08083	PROCT (NUC072) domain (PF08084)	PF08101	PF08118	Histone methylation protein DOT1 (PF08123)	Polysaccharide lyase family 8, N terminal alpha-helical domain (PF08124)	Mannitol dehydrogenase C-terminal domain (PF08125)	PF08139	PF08142	PF08144	PF08145	PF08146	PF08147	DSHCT (NUC185) domain (PF08148)	PF08149	PF08150	PF08151	PF08153	NLE (NUC135) domain (PF08154)	PF08155	PF08156	PF08158	PF08159	PF08161	PF08164	PF08170	PF08172	PF08174	PF08192	PF08193	CD80-like C2-set immunoglobulin domain (PF08205)	Ribonuclease B OB domain (PF08206)	Elongation factor P (EF-P) KOW-like domain (PF08207)	Sgf11 (transcriptional regulation protein) (PF08209)	Cytidine and deoxycytidylate deaminase zinc-binding region (PF08211)	Lipocalin-like domain (PF08212)	PF08213	Histone acetylation protein (PF08214)	Catenin-beta-like, Arm-motif containing nuclear (PF08216)	PF08217	Citrate lyase ligase C-terminal domain (PF08218)	DeoR-like helix-turn-helix domain (PF08220)	RNA polymerase III subunit RPC82 helix-turn-helix domain (PF08221)	CodY helix-turn-helix domain (PF08222)	PaaX-like protein C-terminal domain (PF08223)	PF08226	PF08227	RNase P subunit Pop3 (PF08228)	PF08229	PF08231	Striatin family (PF08232)	Chromosome segregation protein Spc25 (PF08234)	PF08235	SRI (Set2 Rpb1 interacting) domain (PF08236)	PE-PPE domain (PF08237)	Sel1 repeat (PF08238)	Bacterial SH3 domain (PF08239)	Alcohol dehydrogenase GroES-like domain (PF08240)	Methyltransferase domain (PF08241)	Methyltransferase domain (PF08242)	PF08243	Glycosyl hydrolases family 32 C terminal (PF08244)	Mur ligase middle domain (PF08245)	Anticodon-binding domain of tRNA (PF08264)	PF08265	Cobalamin-independent synthase, N-terminal domain (PF08267)	Cache domain (PF08269)	PF08270	TFIIB zinc-binding (PF08271)	Topoisomerase I zinc-ribbon-like (PF08272)	Zinc-binding domain of primase-helicase (PF08273)	PhnA Zinc-Ribbon (PF08274)	DNA primase catalytic core, N-terminal domain (PF08275)	PF08277	DNA primase DnaG DnaB-binding (PF08278)	HTH domain (PF08279)	M protein trans-acting positive regulator (MGA) HTH domain (PF08280)	Sigma-70, region 4 (PF08281)	haloacid dehalogenase-like hydrolase (PF08282)	Retroviral aspartyl protease (PF08284)	PF08288	PF08289	Peptidase M15 (PF08291)	RNA polymerase III subunit Rpc25 (PF08292)	PF08293	PF08295	PrkA AAA domain (PF08298)	Bacterial dnaA protein helix-turn-helix (PF08299)	PF08302	PF08303	NPCBM/NEW2 domain (PF08305)	Glycosyl hydrolase family 98 (PF08306)	Glycosyl hydrolase family 98 C-terminal domain (PF08307)	PF08308	PF08309	PF08310	Mad3/BUB1 homology region 1 (PF08311)	cwf21 domain (PF08312)	SCA7, zinc-binding domain (PF08313)	Secretory pathway protein Sec39 (PF08314)	PF08316	PF08317	PF08318	PF08320	PPP5 TPR repeat region (PF08321)	Starch synthase catalytic domain (PF08323)	PUL domain (PF08324)	PF08325	PF08326	Activator of Hsp90 ATPase homolog 1-like protein (PF08327)	Adenylosuccinate lyase C-terminal (PF08328)	Chitinase A, N-terminal domain (PF08329)	PF08331	Calcium/calmodulin dependent protein kinase II Association (PF08332)	PF08333	Type II secretion system (T2SS), protein G (PF08334)	GlnD PII-uridylyltransferase (PF08335)	Plexin cytoplasmic RasGAP domain (PF08337)	Domain of unknown function (DUF1731) (PF08338)	PF08340	Ribonucleotide reductase N-terminal (PF08343)	PF08344	PF08345	PF08348	PF08349	Domain of unknown function (DUF1726) (PF08351)	Oligopeptide/dipeptide transporter, C-terminal region (PF08352)	PF08353	Domain of unknown function (DUF1729) (PF08354)	EF hand associated (PF08355)	EF hand associated (PF08356)	SEFIR domain (PF08357)	YsiA-like protein, C-terminal region (PF08359)	MAATS-type transcriptional repressor, C-terminal region (PF08361)	YcdC-like protein, C-terminal region (PF08362)	Glucan-binding protein C (PF08363)	PF08364	Peptidase M16C associated (PF08367)	Proto-chlorophyllide reductase 57 kD subunit (PF08369)	PF08370	PF08373	Proteasome regulatory subunit C-terminal (PF08375)	Nitrate and nitrite sensing (PF08376)	PF08378	PF08379	PF08385	TAP-like protein (PF08386)	PF08388	Exportin 1-like protein (PF08389)	PF08390	FAE1/Type III polyketide synthase-like protein (PF08392)	Dynein heavy chain, N-terminal region 2 (PF08393)	IRSp53/MIM homology domain (PF08397)	PF08399	PF08400	PF08401	TOBE domain (PF08402)	PF08406	PF08407	PF08409	PF08410	Exonuclease C-terminal (PF08411)	PF08415	PF08417	DNA polymerase alpha subunit B N-terminal (PF08418)	Putative zinc binding domain (PF08421)	Rad51 (PF08423)	PF08424	PF08426	PF08427	PF08428	PF08429	Chromatin associated protein KTI12 (PF08433)	1-deoxy-D-xylulose 5-phosphate reductoisomerase C-terminal (PF08436)	PF08437	GTPase of unknown function C-terminal (PF08438)	Oligopeptidase F (PF08439)	ATP-grasp domain (PF08442)	RimK-like ATP-grasp domain (PF08443)	FR47-like protein (PF08445)	PAS fold (PF08446)	PAS fold (PF08447)	PAS fold (PF08448)	PF08449	SMP-30/Gluconolaconase/LRE-like region (PF08450)	PF08454	PF08455	Sfi1 spindle body protein (PF08457)	UvrC Helix-hairpin-helix N-terminal (PF08459)	Bacterial SH3 domain (PF08460)	Ribonuclease R winged-helix domain (PF08461)	PF08463	Methyltransferase small domain N-terminal (PF08468)	PF08471	Miro-like protein (PF08477)	POTRA domain, FtsQ-type (PF08478)	POTRA domain, ShlB-type (PF08479)	PF08481	PF08482	PF08483	C-methyltransferase C-terminal domain (PF08484)	Polysaccharide biosynthesis protein C-terminal (PF08485)	PF08486	PF08487	Domain of unknown function (DUF1743) (PF08489)	PF08490	Squalene epoxidase (PF08491)	PF08492	PF08493	PF08494	PF08495	PF08496	PF08497	PF08498	Shikimate dehydrogenase substrate binding domain (PF08501)	LeuA allosteric (dimerisation) domain (PF08502)	Tetrahydrodipicolinate succinyltransferase N-terminal (PF08503)	Cse1 (PF08506)	PF08508	PF08509	PF08510	COQ9 (PF08511)	Histone chaperone Rttp106-like (PF08512)	LisH (PF08513)	PF08514	ADAM cysteine-rich (PF08516)	PF08518	Replication factor RFC1 C terminal domain (PF08519)	PF08521	Domain of unknown function (DUF1735) (PF08522)	PF08523	PF08525	PF08528	NusA N-terminal domain (PF08529)	X-Pro dipeptidyl-peptidase C-terminal non-catalytic domain (PF08530)	Alpha-L-rhamnosidase N-terminal domain (PF08531)	Beta-galactosidase trimerisation domain (PF08532)	Beta-galactosidase C-terminal domain (PF08533)	Redoxin (PF08534)	KorB domain (PF08535)	Protein of unknown function (DUF1749) (PF08538)	PF08539	Hydroxymethylglutaryl-coenzyme A synthase C terminal (PF08540)	3-Oxoacyl-[acyl-carrier-protein (ACP)] synthase III C terminal (PF08541)	Replication factor C C-terminal domain (PF08542)	Phosphomethylpyrimidine kinase (PF08543)	GHMP kinases C terminal (PF08544)	3-Oxoacyl-[acyl-carrier-protein (ACP)] synthase III (PF08545)	Ketopantoate reductase PanE/ApbA C terminal (PF08546)	Complex I intermediate-associated protein 30 (CIA30) (PF08547)	Peptidase M10 serralysin C terminal (PF08548)	PF08549	PF08550	PF08551	PF08553	PF08557	Telomere repeat binding factor (TRF) (PF08558)	Cut8 six-helix bundle (PF08559)	PF08561	Cdc37 C terminal domain (PF08564)	Cdc37 Hsp90 binding domain (PF08565)	PF08566	TFIIH p62 subunit, N-terminal domain (PF08567)	Uncharacterised protein family, YAP/Alf4/glomulin (PF08568)	Mo25-like (PF08569)	PF08570	PF08572	PF08574	PF08576	PF08577	PF08578	PF08579	PF08580	Tup N-terminal (PF08581)	PF08583	Domain of unknown function (DUF1767) (PF08585)	Ubiquitin associated domain (UBA) (PF08587)	PF08588	PF08589	PF08590	PF08592	PF08593	PF08595	Lethal giant larvae(Lgl) like, C-terminal (PF08596)	Translation initiation factor eIF3 subunit (PF08597)	Sds3-like (PF08598)	PF08600	Transcription factor PAP1 (PF08601)	Adenylate cyclase associated (CAP) C terminal (PF08603)	PF08605	PF08606	Wyosine base formation (PF08608)	PF08609	PF08610	TATA-binding related factor (TRF) of subunit 20 of Mediator complex (PF08612)	Cyclin (PF08613)	Ribonuclease H2 non-catalytic subunit (Ylr154p-like) (PF08615)	Kinase binding protein CGI-121 (PF08617)	PF08618	PF08619	PF08620	PF08621	PF08622	TATA-binding protein interacting (TIP20) (PF08623)	PF08624	PF08625	PF08626	PF08628	Dfp1/Him1, central region (PF08630)	PF08631	PF08632	PF08633	PF08634	PF08637	PF08638	PF08639	PF08640	PF08642	Fungal family of unknown function (DUF1776) (PF08643)	FACT complex subunit (SPT16/CDC68) (PF08644)	Polynucleotide kinase 3 phosphatase (PF08645)	Replication factor-A C terminal domain (PF08646)	PF08647	PF08651	PF08655	PF08657	PF08658	KR domain (PF08659)	PF08660	Eukaryotic translation initiation factor eIF2A (PF08662)	PF08664	PF08665	SAF domain (PF08666)	BetR domain (PF08667)	HDOD domain (PF08668)	Glycine cleavage T-protein C-terminal barrel domain (PF08669)	PF08670	Anaphase promoting complex (APC) subunit 2 (PF08672)	Phosphoserine phosphatase RsbU, N-terminal domain (PF08673)	MutL C terminal dimerisation domain (PF08676)	Rsbr N terminal (PF08678)	Protein of unknown function (DUF1778) (PF08681)	Protein of unknown function (DUF1780) (PF08682)	Microtubule-binding calmodulin-regulated spectrin-associated (PF08683)	PF08689	PF08695	PF08696	PF08698	Domain of unknown function (DUF1785) (PF08699)	PF08701	tRNA methyltransferase complex GCD14 subunit (PF08704)	PF08706	PF08707	Primase C terminal 1 (PriCT-1) (PF08708)	Inositol 1,4,5-trisphosphate/ryanodine receptor (PF08709)	TFIIS helical bundle-like domain (PF08711)	Scaffold protein Nfu/NifU N terminal (PF08712)	DNA alkylation repair enzyme (PF08713)	Formaldehyde-activating enzyme (Fae) (PF08714)	Glycolipid transfer protein (GLTP) (PF08718)	Domain of unknown function (DUF1768) (PF08719)	TnsA endonuclease C terminal (PF08721)	TnsA endonuclease N terminal (PF08722)	Ca2+ insensitive EF hand (PF08726)	PF08728	PF08729	PF08733	PF08734	PF08735	PF08737	PF08740	PF08741	RING-like domain (PF08746)	Domain of unknown function (DUF1788) (PF08747)	PF08748	PF08750	TrwC relaxase (PF08751)	Coatomer gamma subunit appendage platform subdomain (PF08752)	NikR C terminal nickel binding domain (PF08753)	Hemimethylated DNA-binding protein YccV like (PF08755)	PF08756	PF08757	Domain of unknown function (DUF1792) (PF08759)	PF08760	dUTPase (PF08761)	Mor transcription activator family (PF08765)	DEK C terminal domain (PF08766)	CRM1 C terminal (PF08767)	Domain of unknown function (DUF1794) (PF08768)	Sporulation initiation factor Spo0A C terminal (PF08769)	Sulphur oxidation protein SoxZ (PF08770)	Rapamycin binding domain (PF08771)	Nin one binding (NOB1) Zn-ribbon like (PF08772)	PF08774	ParB family (PF08775)	Transcription factor DP (PF08781)	DWNN domain (PF08783)	Replication protein A C terminal (PF08784)	Ku C terminal domain like (PF08785)	Domain of unknown function (DUF1795) (PF08786)	Alginate lyase (PF08787)	PF08795	Protein of unknown function (DUF1797) (PF08796)	HIRAN domain (PF08797)	pre-mRNA processing factor 4 (PRP4) like (PF08799)	PF08800	Nup133 N terminal like (PF08801)	Putative mono-oxygenase ydhR (PF08803)	PilS N terminal (PF08805)	Bacterial domain of unknown function (DUF1798) (PF08807)	PF08808	PF08811	PF08812	PF08813	XisH protein (PF08814)	WXG100 protein secretion system (Wss), protein YukD (PF08817)	Domain of unknown function (DU1801) (PF08818)	PF08819	PF08822	PF08823	Serine rich protein interaction domain (PF08824)	E2 binding domain (PF08825)	Protein of unknown function (DUF1806) (PF08830)	Protein of unknown function (DUF1810) (PF08837)	DNA replication factor CDT1 like (PF08839)	Diol dehydratase reactivase ATPase-like domain (PF08841)	Fimbrillin-A associated anchor proteins Mfa1 and Mfa2 (PF08842)	Nucleotidyl transferase of unknown function (DUF1814) (PF08843)	PF08844	PF08845	PF08847	Domain of unknown function (DUF1818) (PF08848)	Putative inner membrane protein (DUF1819) (PF08849)	PF08850	PF08852	PF08856	Putative ParB-like nuclease (PF08857)	IDEAL domain (PF08858)	PF08863	UPF0302 domain (PF08864)	PF08867	YugN-like family (PF08868)	XisI protein (PF08869)	Domain of unknown function (DUF1832) (PF08870)	PF08873	PF08874	PF08875	PF08876	MepB protein (PF08877)	PF08878	PF08880	CVNH domain (PF08881)	Dopa 4,5-dioxygenase family (PF08883)	PF08885	Glutamate-cysteine ligase (PF08886)	PF08887	HopJ type III effector protein (PF08888)	PF08889	Phage XkdN-like protein (PF08890)	PF08891	PF08892	PF08893	PF08894	PF08897	PF08900	PF08901	PF08902	Domain of unknown function (DUF1846) (PF08903)	PF08904	PF08905	PF08906	PF08907	PF08908	PF08909	NUP50 (Nucleoporin 50 kDa) (PF08911)	Rap1 Myb domain (PF08914)	Archaea-specific editing domain of threonyl-tRNA synthetase (PF08915)	PhoQ Sensor (PF08918)	Splicing factor 3B subunit 1 (PF08920)	Domain of unknown function (DUF1905) (PF08922)	Domain of unknown function (DUF1906) (PF08924)	Domain of Unknown Function (DUF1907) (PF08925)	PF08928	Domain of unknown function (DUF1911) (PF08929)	MTH538 TIR-like domain (DUF1863) (PF08937)	HBS1 N-terminus (PF08938)	Domain of unknown function (DUF1917) (PF08939)	CsiD (PF08943)	Osmosensory transporter coiled coil (PF08946)	Enterocin A Immunity (PF08951)	Domain of unknown function (DUF1866) (PF08952)	Domain of unknown function (DUF1899) (PF08953)	Domain of unknown function (DUF1900) (PF08954)	BofC C-terminal domain (PF08955)	Domain of unknown function (DUF1869) (PF08956)	Protein of unknown function (DUF1878) (PF08963)	USP8 dimerisation domain (PF08969)	Domain of unknown function (DUF1877) (PF08974)	Domain of unknown function (DUF1868) (PF08975)	Domain of unknown function (DUF1883) (PF08980)	Domain of unknown function (DUF1857) (PF08982)	Domain of unknown function (DUF1896) (PF08989)	Erythronolide synthase docking (PF08990)	DNA Polymerase alpha zinc finger (PF08996)	Cytotoxic (PF09000)	Bacteriophage lambda integrase, N-terminal domain (PF09003)	Head binding (PF09008)	NgoMIV restriction enzyme (PF09015)	EcoRII C terminal (PF09019)	HutP (PF09021)	5-aminolevulinate synthase presequence (PF09029)	Stf0 sulphotransferase (PF09037)	Mu DNA binding, I gamma subdomain (PF09039)	D-Lysine 5,6-aminomutase alpha subunit (PF09043)	Cro (PF09048)	Nickel-containing superoxide dismutase (PF09055)	EF hand (PF09068)	EF-hand (PF09069)	PFU (PLAA family ubiquitin binding) (PF09070)	CheY binding (PF09078)	CDC6, C terminal (PF09079)	NMT1/THI5 like (PF09084)	Cyclomaltodextrinase, N-terminal (PF09087)	MIF4G like (PF09088)	MIF4G like (PF09090)	Domain of unknown function (DUF1925) (PF09094)	Domain of unknown function (DUF1926) (PF09095)	Quinohemoprotein amine dehydrogenase A, alpha subunit, haem binding (PF09098)	Quinohemoprotein amine dehydrogenase, alpha subunit domain III (PF09099)	Quinohemoprotein amine dehydrogenase, alpha subunit domain IV (PF09100)	Elongation factor SelB, winged helix (PF09106)	Elongation factor SelB, winged helix (PF09107)	HAND (PF09110)	SLIDE (PF09111)	Peptide-N-glycosidase F, N terminal (PF09112)	Peptide-N-glycosidase F, C terminal (PF09113)	DNA polymerase III, delta subunit, C terminal (PF09115)	Domain of unknown function (DUF1929) (PF09118)	SicP binding (PF09119)	Restriction endonuclease NaeI (PF09126)	Leukotriene A4 hydrolase, C-terminal (PF09127)	Cholesterol oxidase, substrate-binding (PF09129)	Domain of unknown function (DUF1932) (PF09130)	Invasin, domain 3 (PF09134)	PF09135	Glucodextranase, domain N (PF09137)	PF09139	ATPase MipZ (PF09140)	Talin, middle domain (PF09141)	tRNA Pseudouridine synthase II, C terminal (PF09142)	Domain of unknown function (DUF1934) (PF09148)	Orange carotenoid protein, N-terminal (PF09150)	Domain of unknown function (DUF1939) (PF09154)	Pseudouridine synthase II TruB, C-terminal (PF09157)	Mitochondrial resolvase Ydc2 / RNA splicing MRS1 (PF09159)	Formate dehydrogenase N, transmembrane (PF09163)	Domain of unknown function (DUF1942) (PF09167)	X-Prolyl dipeptidyl aminopeptidase PepX, N-terminal (PF09168)	Domain of unknown function (DUF1943) (PF09172)	Initiation factor eIF2 gamma, C terminal (PF09173)	Maf1 regulator (PF09174)	Methylene-tetrahydromethanopterin dehydrogenase, N-terminal (PF09176)	Syntaxin 6, N-terminal (PF09177)	TilS substrate binding domain (PF09179)	Prolyl-tRNA synthetase, C-terminal (PF09180)	Bacterial purine repressor, N-terminal (PF09182)	PF09184	Domain of unknown function (DUF1949) (PF09186)	DALR domain (PF09190)	Restriction endonuclease BglII (PF09195)	Rio2, N-terminal (PF09202)	MspA (PF09203)	Bacterial self-protective colicin-like immunity (PF09204)	Alpha-L-arabinofuranosidase B, catalytic (PF09206)	Domain of unknown function (DUF1956) (PF09209)	Domain of unknown function (DUF1957) (PF09210)	Domain of unknown function (DUF1958) (PF09211)	Restriction endonuclease EcoRII, N-terminal (PF09217)	YodA lipocalin-like domain (PF09223)	Activator of Hsp90 ATPase, N-terminal (PF09229)	Restriction endonuclease EcoRV (PF09233)	Domain of unknown function (DUF1963) (PF09234)	Topoisomerase VI B subunit, transducer (PF09239)	Flavocytochrome c sulphide dehydrogenase, flavin-binding (PF09242)	PF09243	TATA box-binding protein binding (PF09247)	Domain of unknown function (DUF1965) (PF09248)	tRNA nucleotidyltransferase, second domain (PF09249)	Bifunctional DNA primase/polymerase, N-terminal (PF09250)	Restriction endonuclease FokI, C terminal (PF09254)	Domain of unknown function (DUF1966) (PF09260)	Alpha mannosidase, middle domain (PF09261)	Peroxisome biogenesis factor 1, N-terminal (PF09262)	Peroxisome biogenesis factor 1, N-terminal (PF09263)	Cytokinin dehydrogenase 1, FAD and cytokinin binding (PF09265)	Clathrin, heavy-chain linker (PF09268)	Domain of unknown function (DUF1967) (PF09269)	Beta-trefoil DNA-binding domain (PF09270)	LAG1, DNA binding (PF09271)	Rubisco LSMT substrate-binding (PF09273)	ParG (PF09274)	MerR, DNA binding (PF09278)	Phosphoinositide-specific phospholipase C, efhand-like (PF09279)	XPC-binding domain (PF09280)	Taq polymerase, exonuclease (PF09281)	Mago binding (PF09282)	Rhamnogalacturonase B, N-terminal (PF09284)	Elongation factor P, C-terminal (PF09285)	Pro-kumamolisin, activation domain (PF09286)	Fungal ubiquitin-associated domain (PF09288)	Prokaryotic acetaldehyde dehydrogenase, dimerisation (PF09290)	T4 RNase H, C terminal (PF09293)	ChAPs (Chs5p-Arf1p-binding proteins) (PF09295)	NADH pyrophosphatase-like rudimentary NUDIX domain (PF09296)	NADH pyrophosphatase zinc ribbon domain (PF09297)	Fumarylacetoacetase N-terminal (PF09298)	Mu transposase, C-terminal (PF09299)	XLF (XRCC4-like factor) (PF09302)	Cortexillin I, coiled coil (PF09304)	Bacteriophage, scaffolding protein (PF09306)	PF09307	LuxQ, periplasmic (PF09308)	SurA N-terminal domain (PF09312)	Domain of unknown function (DUF1971) (PF09313)	PF09314	PF09317	Domain of unknown function (DUF1975) (PF09318)	PF09320	PF09323	PF09324	Vps5 C terminal like (PF09325)	PF09326	PF09327	Primase zinc finger (PF09329)	D-lactate dehydrogenase, membrane binding (PF09330)	PF09333	tRNA synthetases class I (M) (PF09334)	PF09335	Vps4 C terminal oligomerisation domain (PF09336)	PF09337	IclR helix-turn-helix domain (PF09339)	PF09340	Transcription factor Pcc1 (PF09341)	PF09343	PF09344	PF09345	SMI1 / KNR4 family (SUKH-1) (PF09346)	Domain of unknown function (DUF1989) (PF09347)	PF09348	OHCU decarboxylase (PF09349)	PF09350	Domain of unknown function (DUF1993) (PF09351)	PF09353	PF09355	PF09356	PF09357	Ubiquitin-activating enzyme e1 C-terminal domain (PF09358)	VTC domain (PF09359)	Iron-binding zinc finger CDGSH type (PF09360)	PF09361	PF09362	XFP C-terminal domain (PF09363)	XFP N-terminal domain (PF09364)	PF09365	PF09366	CpeS-like protein (PF09367)	PF09369	TIM-barrel signal transduction protein (PF09370)	Tex-like protein N-terminal domain (PF09371)	PF09373	Predicted Peptidoglycan domain (PF09374)	Imelysin (PF09375)	NurA domain (PF09376)	SBDS protein C-terminal domain (PF09377)	HAS barrel domain (PF09378)	FERM N-terminal domain (PF09379)	FERM C-terminal PH-like domain (PF09380)	Outer membrane protein G (OmpG) (PF09381)	RQC domain (PF09382)	NIL domain (PF09383)	PF09384	Protein of unknown function (DUF2000) (PF09391)	Protein of unknown function (DUF2001) (PF09393)	Chagasin family peptidase inhibitor I42 (PF09394)	Ftsk gamma domain (PF09397)	Protein of unknown function (DUF2002) (PF09400)	Man1-Src1p-C-terminal domain (PF09402)	CASC3/Barentsz eIF4AIII binding (PF09405)	Protein of unknown function (DUF2004) (PF09406)	Lipid A 3-O-deacylase (PagL) (PF09411)	Domain of unknown function (DUF2007) (PF09413)	RNA ligase (PF09414)	CENP-S associating Centromere protein X (PF09415)	RNA helicase (UPF2 interacting domain) (PF09416)	PF09419	PF09420	PF09421	PhoD-like phosphatase (PF09423)	Yqey-like protein (PF09424)	PF09427	PF09429	PF09430	PF09431	PF09435	PF09436	PF09438	Signal recognition particle receptor beta subunit (PF09439)	PF09440	PF09441	PF09444	RNA cap guanine-N2 methyltransferase (PF09445)	PF09447	Domain of unknown function (DUF2020) (PF09449)	Domain of unknown function (DUF2019) (PF09450)	PF09451	HIRA B motif (PF09453)	RcsC Alpha-Beta-Loop (ABL) (PF09456)	H-type lectin domain (PF09458)	Ethylbenzene dehydrogenase (PF09459)	Saf-pilin pilus formation protein (PF09460)	PF09462	PF09463	Ydr279p protein family (RNase H2 complex component) (PF09468)	IgA Peptidase M64 (PF09471)	PF09476	Listeria-Bacteroides repeat domain (List_Bact_rpt) (PF09479)	CRISPR-associated protein Cse1 (CRISPR_cse1) (PF09481)	PF09483	PF09484	CRISPR-associated protein Cse2 (CRISPR_cse2) (PF09485)	PF09487	Mannosyl-3-phosphoglycerate synthase (osmo_MPGsynth) (PF09488)	PF09490	Pectic acid lyase (PF09492)	PF09493	PF09494	Cenp-O kinetochore centromere component (PF09496)	PF09497	PF09498	Putative thioesterase (yiiD_Cterm) (PF09500)	DNA polymerase subunit Cdc27 (PF09507)	Lacto-N-biose phosphorylase (PF09508)	PF09509	RNA ligase (PF09511)	Thiamine transporter protein (Thia_YuaJ) (PF09515)	Eco29kI restriction endonuclease (PF09517)	PF09523	PF09524	PF09526	PF09529	PF09531	FDF domain (PF09532)	PF09536	Domain of unknown function (DUF2383) (PF09537)	PF09538	PF09539	PF09544	PF09546	PF09547	PF09549	PF09551	PF09553	PF09557	PF09560	PF09561	PF09563	PF09565	PF09566	PF09578	PF09579	PF09580	PF09584	PF09586	Bacterial capsule synthesis protein PGA_cap (PF09587)	YqaJ-like viral recombinase domain (PF09588)	PF09594	PF09597	PF09600	PF09601	PF09602	PF09603	PF09604	PF09605	ARC105 or Med15 subunit of Mediator complex non-fungal (PF09606)	PF09608	PF09612	PF09613	PF09615	PF09622	PrgU-like protein (PF09627)	Domain of unknown function (DUF2024) (PF09630)	Sen15 protein (PF09631)	Protein of unknown function (DUF2023) (PF09633)	Protein of unknown function (DUF2025) (PF09634)	YycH protein (PF09648)	PF09650	PF09656	PF09661	Amidohydrolase ring-opening protein (Amido_AtzD_TrzD) (PF09663)	PF09664	Aspartyl protease (PF09668)	PF09669	PF09673	PF09674	PF09676	PF09677	PF09678	Bacteriocin (Lactococcin_972) (PF09683)	PF09684	PF09685	PF09686	Bacterial chaperone lipoprotein (PulS_OutS) (PF09691)	PF09692	PF09694	PF09695	PF09696	PF09697	Doubled CXXCH motif (Paired_CXXCH_1) (PF09699)	CRISPR-associated protein (Cas_Cas5) (PF09704)	CRISPR-associated protein (Cas_Cas2CT1978) (PF09707)	PF09709	PF09712	PF09718	Putative redox-active protein (C_GCAxxG_C_C) (PF09719)	PF09721	PF09722	PF09723	PF09728	Gti1/Pac2 family (PF09729)	PF09731	PF09732	PF09733	RNA polymerase III transcription factor (TF)IIIC subunit (PF09734)	Membrane-associated apoptosis protein (PF09735)	PF09737	PF09745	PF09747	Uncharacterised conserved protein (PF09749)	PF09751	Uncharacterized conserved protein (DUF2048) (PF09752)	PF09753	PAC2 family (PF09754)	Arb2 domain (PF09757)	PF09759	PF09763	PF09768	PF09769	Topoisomerase II-associated protein PAT1 (PF09770)	PF09774	PF09779	PF09783	PF09785	PF09791	PF09792	PF09793	PF09794	PF09797	PF09801	PF09802	PF09804	Mitochondrial ribosomal protein L27 (PF09809)	PF09810	PF09811	PF09814	PF09816	Predicted ATPase of the ABC class (PF09818)	PF09819	PF09820	PF09821	PF09822	PF09823	PF09825	PF09826	CRISPR associated protein Cas2 (PF09827)	PF09828	PF09829	ATP adenylyltransferase (PF09830)	PF09831	Uncharacterized protein conserved in bacteria (DUF2059) (PF09832)	PF09834	PF09835	Uncharacterized protein conserved in bacteria (DUF2063) (PF09836)	Uncharacterized protein conserved in bacteria (DUF2064) (PF09837)	PF09839	PF09842	Predicted membrane protein (DUF2070) (PF09843)	PF09844	Uncharacterized conserved protein (DUF2075) (PF09848)	PF09849	Uncharacterized protein conserved in bacteria (DUF2077) (PF09850)	PF09851	PF09852	PF09855	PF09856	PF09857	PF09858	PF09859	PF09860	Domain of unknown function (DUF2088) (PF09861)	Uncharacterized protein conserved in bacteria (DUF2090) (PF09863)	Membrane-bound lysozyme-inhibitor of c-type lysozyme (PF09864)	PF09865	PF09866	Uncharacterized protein conserved in bacteria (DUF2094) (PF09867)	PF09883	PF09889	PF09899	PF09900	PF09903	Winged helix-turn helix (PF09904)	Uncharacterized conserved protein (DUF2132) (PF09905)	PF09906	PF09907	PF09909	PF09912	PF09913	PF09916	Uncharacterized protein conserved in bacteria (DUF2147) (PF09917)	Cell wall-active antibiotics response protein (DUF2154) (PF09922)	PF09923	Uncharacterized conserved protein (DUF2156) (PF09924)	PF09925	PF09928	PF09929	PF09931	PF09932	PF09933	PF09935	PF09937	PF09938	PF09939	Domain of unknown function (DUF2172) (PF09940)	PF09945	PF09948	PF09949	PF09950	PF09951	PF09952	PF09953	PF09954	PF09955	PF09956	PF09957	PF09962	PF09965	Uncharacterized protein conserved in bacteria (DUF2200) (PF09966)	PF09967	PF09969	PF09970	PF09972	Tetratricopeptide repeat (PF09976)	PF09977	PF09979	PF09980	Uncharacterized protein conserved in bacteria (DUF2218) (PF09981)	Uncharacterized protein conserved in bacteria (DUF2219) (PF09982)	PF09983	PF09984	Domain of unknown function (DUF2223) (PF09985)	PF09986	PF09989	PF09990	PF09991	Predicted periplasmic protein (DUF2233) (PF09992)	PF09994	PF09995	Uncharacterized protein conserved in bacteria (DUF2237) (PF09996)	PF09997	PF09998	ACT domain (PF10000)	PF10001	PF10002	PF10003	PF10004	PF10005	PF10006	PF10009	Predicted membrane protein (DUF2254) (PF10011)	2OG-Fe dioxygenase (PF10014)	PF10017	PF10018	PF10020	Uncharacterized protein conserved in bacteria (DUF2263) (PF10021)	PF10022	PF10023	Uncharacterized conserved protein (DUF2267) (PF10025)	PF10026	PF10027	PF10028	PF10029	PF10030	PF10031	PF10032	Autophagy-related protein 13 (PF10033)	Uncharacterized protein conserved in bacteria (DUF2179) (PF10035)	PF10038	PF10041	PF10042	PF10043	PF10045	PF10050	Protein of unknown function (DUF2288) (PF10052)	Predicted periplasmic lipoprotein (DUF2291) (PF10054)	PF10056	PF10057	PF10058	PF10060	PF10062	PF10063	PF10065	PF10066	PF10067	PF10069	PF10070	PF10073	PF10074	PF10076	PF10077	PF10079	PF10080	PF10081	PF10082	PF10084	PF10086	PF10087	PF10088	Uncharacterized protein conserved in bacteria (DUF2328) (PF10090)	Putative glucoamylase (PF10091)	PF10092	PF10093	PF10094	PF10095	PF10096	PF10098	PF10099	PF10100	PF10101	PF10102	Uncharacterised conserved protein (DUF2342) (PF10103)	PF10104	PF10105	PF10106	PF10107	Predicted 3'-5' exonuclease related to the exonuclease domain of PolB (PF10108)	PF10109	PF10110	Glycosyltransferase like family 2 (PF10111)	PF10112	PF10114	PF10116	PF10117	PF10118	PF10119	Putative aldolase (PF10120)	PF10123	PF10124	PF10127	PF10128	PF10129	PF10131	PF10134	PF10135	PF10136	PF10137	PF10138	PF10139	WXG100 protein secretion system (Wss), protein YukC (PF10140)	PF10141	PhoPQ-activated pathogenicity-related protein (PF10142)	2,3-bisphosphoglycerate-independent phosphoglycerate mutase (PF10143)	PF10144	PF10145	Ribonuclease E/G family (PF10150)	PF10153	PF10154	Subunit 17 of Mediator complex (PF10156)	PF10162	PF10165	PF10173	PF10174	PF10176	PF10184	Chaperone for wingless signalling and trafficking of LDL receptor (PF10185)	PF10186	Conserved protein (DUF2356) (PF10189)	Telomere length regulation protein (PF10193)	PF10197	PF10198	PF10199	PF10203	PF10213	PF10216	PF10221	PF10230	PF10236	PF10237	PF10241	PF10242	PF10253	PF10255	PF10256	PF10257	PF10259	PF10261	Rdx family (PF10262)	PF10263	PF10266	PF10274	Peptidase C65 Otubain (PF10275)	Zinc-finger domain (PF10276)	PF10277	Mediator complex protein (PF10280)	PF10281	Lactonase, 7-bladed beta-propeller (PF10282)	Putative TOS1-like glycosyl hydrolase (DUF2401) (PF10287)	PF10288	PF10290	Muniscin C-terminal mu homology domain (PF10291)	PF10293	Putative methyltransferase (PF10294)	PF10295	PF10296	PF10297	WhiA N-terminal LAGLIDADG-like domain (PF10298)	PF10300	PF10302	PF10303	PF10304	PF10305	PF10306	PF10307	PF10309	PF10310	PF10311	PF10312	PF10313	Serpentine type 7TM GPCR chemoreceptor Srv (PF10323)	PF10329	PF10330	PF10332	PF10334	PF10335	PF10336	PF10337	Protein of unknown function (DUF2424) (PF10340)	PF10342	PF10343	PF10344	PF10345	PF10346	PF10347	PF10348	PF10349	PF10350	PF10351	PF10354	PF10355	PF10356	Domain of Kin17 curved DNA-binding protein (PF10357)	PF10359	PF10360	PF10363	PF10366	PF10367	Putative cell-wall binding lipoprotein (PF10368)	Small subunit of acetolactate synthase (PF10369)	Domain of unknown function (DUF2437) (PF10370)	Domain of unknown function (PF10371)	Est1 DNA/RNA binding domain (PF10373)	Telomerase activating protein Est1 (PF10374)	PF10375	PF10377	PF10378	Autophagocytosis associated protein C-terminal (PF10381)	PF10382	PF10383	RNA polymerase beta subunit external 1 domain (PF10385)	Protein of unknown function (DUF2442) (PF10387)	EAL-domain associated signalling protein domain (PF10388)	RNA polymerase II elongation factor ELL (PF10390)	Fingers domain of DNA polymerase lambda (PF10391)	PF10392	Histone acetyl transferase HAT1 N-terminus (PF10394)	GTP-binding protein TrmE N-terminus (PF10396)	Adenylosuccinate lyase C-terminus (PF10397)	Ubiquitinol-cytochrome C reductase Fe-S subunit TAT signal (PF10399)	Virulence activator alpha C-term (PF10400)	Rad4 beta-hairpin domain 1 (PF10403)	Rad4 beta-hairpin domain 2 (PF10404)	Rad4 beta-hairpin domain 3 (PF10405)	PF10406	Ubiquitin elongating factor core (PF10408)	DnaB-helicase binding domain of primase (PF10410)	Disulfide bond isomerase protein N-terminus (PF10411)	Type IV secretion-system coupling protein DNA-binding domain (PF10412)	Sirohaem synthase dimerisation region (PF10414)	Fumarase C C-terminus (PF10415)	C-terminal domain of 1-Cys peroxiredoxin (PF10417)	Iron-sulfur cluster binding domain of dihydroorotate dehydrogenase B (PF10418)	TFIIIC subunit (PF10419)	Bacterial AMP nucleoside phosphorylase N-terminus (PF10423)	C-terminus of bacterial fibrinogen-binding adhesin (PF10425)	PF10428	C-terminal, D2-small domain, of ClpB protein (PF10431)	Bacterial phospho-glucose isomerase C-terminal region (PF10432)	Beta-galactosidase, domain 2 (PF10435)	Mitochondrial branched-chain alpha-ketoacid dehydrogenase kinase (PF10436)	Bacterial lipoate protein ligase C-terminus (PF10437)	Cyclo-malto-dextrinase C-terminal domain (PF10438)	PF10441	PF10442	PF10443	PF10446	Exosome component EXOSC1/CSL4 (PF10447)	Telomere regulation protein Stn1 (PF10451)	PF10452	Nuclear fragile X mental retardation-interacting protein 1 (NUFIP1) (PF10453)	PF10454	Valyl tRNA synthetase tRNA binding arm (PF10458)	Peptidase S46 (PF10459)	PF10460	Peptidase M66 (PF10462)	AKAP7 2'5' RNA ligase-like domain (PF10469)	PF10474	PF10475	PF10479	Elongator subunit Iki1 (PF10483)	Nucleoporin subcomplex protein binding to Pom34 (PF10487)	PF10494	PF10495	PF10496	PF10497	PF10498	Ribosomal subunit 39S (PF10501)	Signal peptidase, peptidase S26 (PF10502)	PF10504	Galactokinase galactose-binding signature (PF10509)	PF10510	PF10513	SHNi-TPR (PF10516)	PF10517	TAT (twin-arginine translocation) pathway signal sequence (PF10518)	PF10521	GLEYA domain (PF10528)	SLBB domain (PF10531)	PF10537	PF10539	Munc13 (mammalian uncoordinated) homology domain (PF10540)	PF10543	PF10544	Alcohol dehydrogenase transcription factor Myb/SANT-like (PF10545)	PF10546	PF10547	PF10549	PF10551	PF10552	PF10554	Phospho-N-acetylmuramoyl-pentapeptide-transferase signature 1 (PF10555)	Cullin protein neddylation domain (PF10557)	PF10558	Plug domain of Sec61p (PF10559)	Glycoside hydrolase 97 (PF10566)	PF10568	Alpha-macro-globulin thiol-ester bond-forming region (PF10569)	PF10571	Iron-sulfur binding domain of endonuclease III (PF10576)	PF10577	Proteasome subunit A N-terminal signature (PF10584)	Ubiquitin-activating enzyme active site (PF10585)	PF10587	NADH-ubiquinone oxidoreductase-G iron-sulfur binding region (PF10588)	NADH-ubiquinone oxidoreductase-F iron-sulfur binding region (PF10589)	Pyridoxine 5'-phosphate oxidase C-terminal dimerisation region (PF10590)	PF10592	PF10593	U6-snRNA interacting domain of PrP8 (PF10596)	U5-snRNA binding site 2 of PrP8 (PF10597)	RNA recognition motif of the spliceosomal PrP8 (PF10598)	26S proteasome subunit RPN7 (PF10602)	Polyketide cyclase / dehydrase and lipid transport (PF10604)	PF10605	PF10607	ParA/MinD ATPase like (PF10609)	PF10611	Ligated ion channel L-glutamate- and glycine-binding site (PF10613)	PF10614	Protein of unknown function (DUF2470) (PF10615)	PF10617	PF10618	PF10620	PF10625	PF10626	PF10627	PF10628	He_PIG associated, NEW1 domain of bacterial glycohydrolase (PF10632)	NPCBM-associated, NEW3 domain of alpha-galactosidase (PF10633)	Fe2+ transport protein (PF10634)	DisA bacterial checkpoint controller linker region (PF10635)	Hemin uptake protein hemP (PF10636)	Oxoglutarate and iron-dependent oxygenase degradation C-term (PF10637)	PF10639	Misato Segment II tubulin-like domain (PF10644)	PF10645	PF10646	PF10647	PF10648	PF10649	PF10650	Domain of unknown function (DUF2479) (PF10651)	PF10652	PF10665	PF10670	Toxin co-regulated pilus biosynthesis protein Q (PF10671)	S-adenosylmethionine-dependent methyltransferase (PF10672)	PF10675	PF10676	PF10677	PF10679	PF10681	PF10684	PF10685	PF10686	PF10688	PF10691	Protein of unknown function (DUF2498) (PF10692)	Protein of unknown function (DUF2500) (PF10694)	PF10696	PF10698	Molybdenum cofactor biosynthesis protein F (PF10703)	Aminoglycoside-2''-adenylyltransferase (PF10706)	PF10707	PF10708	PF10709	PF10712	PF10713	PF10719	PF10720	PF10721	Putative bacterial sensory transduction regulator (PF10722)	Replication regulatory protein RepB (PF10723)	PF10724	PF10725	Rossmann-like domain (PF10727)	Domain of unknown function (DUF2520) (PF10728)	PF10730	PF10733	PF10734	PF10739	PF10741	PF10744	PF10748	PF10749	PF10752	PF10753	PF10754	PF10755	PF10756	PF10757	PF10758	PF10759	PF10762	Protein of unknown function (DUF2592) (PF10766)	PF10767	PF10769	PF10772	PF10774	PF10775	PF10776	PF10777	PF10783	Plasmid stability protein (PF10784)	PF10785	PF10791	PF10792	PF10796	PF10797	Biofilm development protein YmgB/AriR (PF10798)	PF10799	PF10800	PF10801	PF10806	PF10809	PF10816	PF10820	PF10823	Protein of unknown function (DUF2580) (PF10824)	PF10825	PF10829	PF10830	PF10832	PF10851	PF10861	PF10865	PF10881	PF10899	PF10908	PF10914	PF10921	PF10923	PF10926	Protein of unknown function (DUF2810) (PF10928)	PF10933	PF10935	PF10936	PF10937	YfdX protein (PF10938)	PF10939	PF10945	PF10946	PF10947	PF10953	PF10954	PF10956	PF10959	PF10966	PF10969	PF10973	PF10974	PF10975	Protein of unknown function (DUF2790) (PF10976)	PF10977	PF10978	PF10979	Protein of unknown function (DUF2787) (PF10980)	Protein of unknown function (DUF2789) (PF10982)	PF10983	PF10984	PF10985	PF10986	Protein of unknown function (DUF2807) (PF10988)	PF10989	PF10990	Protein of unknown function (DUF2815) (PF10991)	Protein of unknown function (DUF2817) (PF10994)	PF10995	Beta-Casp domain (PF10996)	PF10997	PF10998	PF11000	PF11004	PF11006	PF11008	Protein of unknown function (DUF2847) (PF11009)	PF11010	PF11011	PF11013	PF11014	PF11017	PF11023	PF11026	PF11028	PF11036	PF11041	PF11042	PF11045	PF11046	PF11051	PF11062	PF11064	PF11066	PF11067	PF11069	PF11070	PF11071	PF11074	PF11076	Protein of unknown function (DUF2622) (PF11080)	PF11086	PF11101	Group 4 capsule polysaccharide formation lipoprotein gfcB (PF11102)	PF11103	Type IV pilus assembly protein PilM; (PF11104)	PF11112	PF11117	PF11122	Protein of unknown function (DUF2892) (PF11127)	PF11130	PF11134	PF11136	PF11137	PF11138	PF11139	PF11140	PF11141	PF11142	PF11143	PF11148	PF11149	PF11150	PF11152	PF11153	PF11154	Domain of unknown function (DUF2935) (PF11155)	PF11157	PF11158	PF11159	PF11160	PF11161	PF11162	PF11164	PF11167	PF11168	PF11170	PF11171	PF11172	Protein of unknown function (DUF2961) (PF11175)	Protein of unknown function (DUF2962) (PF11176)	PF11177	PF11181	PF11185	Protein of unknown function (DUF2974) (PF11187)	PF11188	PF11190	Protein of unknown function (DUF2782) (PF11191)	PF11196	PF11198	PF11199	PF11202	PF11203	PF11204	PF11209	PF11213	PF11218	PF11219	PF11220	Subunit 21 of Mediator complex (PF11221)	PF11225	PF11227	PF11228	PF11230	PF11231	PF11233	PF11236	PF11238	PF11239	PF11241	PF11248	PF11249	PF11251	PF11253	PF11254	PF11255	PF11256	Protein of unknown function (DUF3048) (PF11258)	PF11259	PF11262	PF11264	Protein of unknown function (DUF3067) (PF11267)	PF11268	PF11271	PF11272	PF11273	PF11275	PF11276	PF11284	PF11285	PF11288	PF11290	PF11292	PF11294	PF11296	PF11297	PF11298	PF11299	PF11303	PF11304	PF11305	Protein of unknown function (DUF3108) (PF11306)	PF11307	PF11308	PF11309	PF11311	PF11312	PF11324	PF11325	PF11326	PF11327	PF11329	PF11338	PF11339	PF11340	Protein of unknown function (DUF3144) (PF11342)	PF11343	PF11345	PF11348	PF11349	PF11350	PF11351	PF11352	PF11354	PF11358	PF11360	PF11361	PF11363	Protein of unknown function (DUF3168) (PF11367)	PF11369	PF11374	PF11376	PF11377	PF11379	PF11380	PF11382	PF11387	PF11391	PF11393	PF11394	Protein of unknown function (DUF2874) (PF11396)	PF11397	Protein of unknown function (DUF2813) (PF11398)	Disulphide bond corrector protein DsbC (PF11412)	Regulatory protein Mnt (PF11423)	Tn7 transposition regulator TnsC (PF11426)	Colicin D (PF11429)	PF11443	PF11444	PF11445	PF11449	PF11452	PF11453	PF11454	PF11459	GLUT4 regulating protein TUG (PF11470)	PF11471	PF11489	PF11490	Archaeal transcriptional regulator TrmB (PF11495)	Class II histone deacetylase complex subunits 2 and 3 (PF11496)	PF11500	Protein of unknown function (DUF3219) (PF11514)	Yeast phosphatidylinositol-4-OH kinase Pik1 (PF11522)	Protein of unknown function (DUF3225) (PF11533)	Calcium binding (PF11535)	Cytoplasmic dynein 1 intermediate chain 2 (PF11540)	Nuclear pore localisation protein NPL4 (PF11543)	Spindle pole body component Spc42p (PF11544)	Outer membrane protein Omp28 (PF11551)	Protein of unknown function (DUF3231) (PF11553)	PF11559	PI31 proteasome regulator N-terminal (PF11566)	PF11573	Protein of unknown function (DUF3235) (PF11574)	PF11575	Protein of unknown function (DUF3237) (PF11578)	Protein of unknown function (DUF3239) (PF11580)	Protein of unknown function (DUF3240) (PF11582)	P-aminobenzoate N-oxygenase AurF (PF11583)	Domain of unknown function (DUF3244) (PF11589)	PF11597	Copper binding periplasmic protein CusF (PF11604)	Vacuolar protein sorting protein 36 Vps36 (PF11605)	Domain of unknown function (DUF4352) (PF11611)	Type II secretion system (T2SS), protein J (PF11612)	PF11617	Protein of unknown function (DUF3251) (PF11622)	Protein of unknown function (DUF3252) (PF11623)	Protein of unknown function (DUF3253) (PF11625)	TRF2-interacting telomeric protein/Rap1 - C terminal domain (PF11626)	C terminal SARAH domain of Mst1 (PF11629)	PF11635	DnaA N-terminal domain (PF11638)	PF11640	C-terminal region of Pasteurella multocida toxin residues 569-1285 (PF11647)	P22 tail accessory factor (PF11650)	P22 coat protein - gene protein 5 (PF11651)	PF11655	PF11658	PF11659	PF11662	PF11663	PF11667	PF11678	PF11679	Protein of unknown function (DUF3276) (PF11680)	PF11681	PF11684	PF11692	PF11694	PF11695	PF11696	V-ATPase subunit H (PF11698)	Mif2/CENP-C like (PF11699)	PF11700	Myosin-binding striated muscle assembly central (PF11701)	PF11702	PF11705	CGNR zinc finger (PF11706)	Ribosome 60S biogenesis N-terminal (PF11707)	PF11708	PF11709	PF11710	PF11711	PF11712	Peptidase C80 family (PF11713)	Nucleoporin Nup120/160 (PF11715)	Mycothiol maleylpyruvate isomerase N-terminal domain (PF11716)	RNA binding activity-knot of a chromodomain (PF11717)	PF11718	DNA replication and checkpoint protein (PF11719)	Peptidase inhibitor I78 family (PF11720)	Di-glucose binding within endoplasmic reticulum (PF11721)	Homotrimeric ring hydroxylase (PF11723)	YvbH-like oligomerisation region (PF11724)	PF11725	PF11726	DUF939 C-terminal domain (PF11728)	PF11730	PF11731	PF11732	TilS substrate C-terminal domain (PF11734)	PF11735	Protein of unknown function (DUF3299) (PF11736)	PF11737	Protein of unknown function (DUF3298) (PF11738)	PF11739	PF11740	AMIN domain (PF11741)	PF11742	PF11743	PF11745	PF11747	PF11750	PF11751	Velvet factor (PF11754)	PF11756	Cobalamin synthesis G N-terminal (PF11760)	PF11761	L-arabinose isomerase C-terminal domain (PF11762)	PF11764	PF11767	PF11769	Lsr2 (PF11774)	PF11775	Domain of unknown function (DUF3315) (PF11776)	PF11777	PF11780	Cytochrome c bacterial (PF11783)	PF11784	PF11785	PF11786	PF11787	39S mitochondrial ribosomal protein L46 (PF11788)	PF11790	Aconitate B N-terminal domain (PF11791)	4-hydroxyphenylacetate 3-hydroxylase N terminal (PF11794)	PF11795	PF11797	IMS family HHH motif (PF11798)	impB/mucB/samB family C-terminal domain (PF11799)	PF11800	PF11801	PF11804	Domain of unknown function (DUF3327) (PF11806)	PF11807	PF11808	PF11809	PF11810	PF11812	PF11813	PF11814	PF11815	PF11816	PF11817	PF11818	PF11819	PF11821	PF11827	PF11828	PF11831	PF11832	PF11836	ERAP1-like C-terminal domain (PF11838)	PF11841	PF11842	PF11843	Domain of unknown function (DUF3364) (PF11844)	PF11845	PF11846	PF11847	PF11849	PF11850	Domain of unknown function (DUF3372) (PF11852)	PF11853	PF11855	PF11856	Domain of unknown function (DUF3378) (PF11858)	PF11860	PF11861	PF11862	PF11863	PF11864	PF11865	PF11867	PF11868	PF11870	PF11871	PF11872	Domain of unknown function (DUF3393) (PF11873)	PF11874	PF11875	PF11876	PF11878	PF11880	PF11882	PF11884	PF11885	PF11887	PF11888	Domain of unknown function (DUF3410) (PF11890)	Domain of unknown function (DUF3412) (PF11892)	PF11893	Protein of unknown function (DUF3414) (PF11894)	Domain of unknown function (DUF3415) (PF11895)	Domain of unknown function (DUF3416) (PF11896)	PF11897	PF11898	PF11899	PF11902	PF11903	PF11904	PF11905	PF11906	PF11907	PF11911	PF11913	PF11915	PF11916	PF11917	Domain of unknown function (DUF3437) (PF11919)	PF11920	PF11922	PF11923	Protein of unknown function (DUF3442) (PF11924)	PF11927	PF11931	PF11937	Domain of unknown function (DUF3458) (PF11940)	Domain of unknown function (DUF3459) (PF11941)	PF11942	PF11943	PF11944	PF11946	PF11948	PF11950	PF11951	Domain of unknown function (DUF3470) (PF11953)	PF11954	PF11957	Domain of unknown function (DUF3472) (PF11958)	PF11959	PF11960	SpoIIAA-like (PF11964)	PF11965	Recombination protein O N terminal (PF11967)	PF11968	PF11970	CAMSAP CH domain (PF11971)	PF11972	PF11973	PF11974	Family 4 glycosyl hydrolase C-terminal domain (PF11975)	Ubiquitin-2 like Rad60 SUMO-like (PF11976)	Zc3h12a-like Ribonuclease NYN domain (PF11977)	PF11981	PF11982	PF11983	PF11984	PF11985	Influenza A Proapoptotic protein (PF11986)	Translation-initiation factor 2 (PF11987)	Retrograde transport protein Dsl1 C terminal (PF11989)	PF11990	PF11992	PF11994	PF11997	PF11998	Protein of unknown function (DUF3494) (PF11999)	PF12000	MgsA AAA+ ATPase C terminal (PF12002)	Domain of unknown function (DUF3497) (PF12003)	PF12005	PF12006	Protein of unknown function (DUF3501) (PF12007)	Type I restriction and modification enzyme - subunit R C terminal (PF12008)	Telomerase ribonucleoprotein complex - RNA binding domain (PF12009)	PF12010	PF12013	PF12014	PF12017	PF12018	Type II transport protein GspH (PF12019)	PF12021	PF12025	Domain of unknown function (DUF3513) (PF12026)	PF12028	PF12029	PF12030	PF12034	PF12040	PF12044	PF12048	PF12051	PF12054	PF12055	PF12059	Domain of unknown function (DUF3543) (PF12063)	Domain of unknown function (DUF3546) (PF12066)	PF12068	PF12072	PF12073	PF12074	PF12077	PF12080	PF12081	PF12083	PF12084	PF12089	PF12090	PF12091	PF12094	PF12096	PF12098	PF12099	PF12100	PF12101	Domain of unknown function (DUF3578) (PF12102)	SpoU, rRNA methylase, C-terminal (PF12105)	Splicing factor SF3a60 binding domain (PF12108)	Nuclear protein 96 (PF12110)	Polyribonucleotide phosphorylase C terminal (PF12111)	Protein of unknown function (DUF3579) (PF12112)	Stage III sporulation protein D (PF12116)	Rifampin ADP-ribosyl transferase (PF12120)	Protein of unknown function (DUF3582) (PF12122)	D domain of beta-TrCP (PF12125)	PF12127	PF12128	PRP8 domain IV core (PF12134)	RNA polymerase recycling family C-terminal (PF12137)	PF12138	Protein of unknown function (DUF3588) (PF12140)	PF12145	Putative lysophospholipase (PF12146)	PF12147	Eukaryotic translation initiation factor 4G1 (PF12152)	PF12156	Protein of unknown function (DUF3591) (PF12157)	PF12158	HsdM N-terminal domain (PF12161)	Stage V sporulation protein AA (PF12164)	PF12166	PF12167	PF12168	DNA polymerase III subunits gamma and tau domain III (PF12169)	DNA polymerase III tau subunit V interacting with alpha (PF12170)	Zinc-finger double-stranded RNA-binding (PF12171)	Rubredoxin-like zinc ribbon domain (DUF35_N) (PF12172)	Restriction endonuclease NotI (PF12183)	Acyl-CoA dehydrogenase C terminal (PF12186)	Domain of unknown function (DUF3597) (PF12200)	Domain of unknown function (DUF3598) (PF12204)	PF12215	U1 small nuclear ribonucleoprotein of 70kDa MW N terminal (PF12220)	PF12221	PF12222	PF12225	PF12228	Putative peptidoglycan binding domain (PF12229)	Pre-mRNA splicing factor PRP21 like protein (PF12230)	PF12231	PF12234	Bacteriophage head to tail connecting protein (PF12236)	PF12239	Trans-2-enoyl-CoA reductase catalytic region (PF12241)	NAD(P)H binding domain of trans-2-enoyl-CoA reductase (PF12242)	PF12243	PF12244	Bacterial Ig-like domain (group 3) (PF12245)	PF12246	PF12247	PF12249	PF12250	PF12253	PF12254	Insecticide toxin TcdB middle/C-terminal region (PF12255)	Insecticide toxin TcdB middle/N-terminal region (PF12256)	PF12257	PF12259	PF12262	Histone-binding protein RBBP4 or subunit C of CAF1 complex (PF12265)	PF12270	PF12271	PF12275	PF12276	PF12277	PF12281	Signal transduction histidine kinase (PF12282)	PF12291	Hydrophobic surface binding protein A (PF12296)	PF12298	PF12300	PF12307	PF12311	PF12318	Type 5 capsule protein repressor C-terminal domain (PF12320)	PF12323	Helix-turn-helix domain of alkylmercury lyase (PF12324)	PF12325	PF12326	FtsZ family, C-terminal domain (PF12327)	PF12329	PF12331	PF12333	PF12339	PF12340	Protein of unknown function (DUF3639) (PF12341)	PF12343	Ultra-violet resistance protein B (PF12344)	PF12345	CLASP N terminal (PF12348)	PF12350	PF12353	PF12356	PF12358	PF12359	PF12362	PF12363	PF12365	PF12368	PF12384	PF12388	PF12389	PF12390	Protocatechuate 3,4-dioxygenase beta subunit N terminal (PF12391)	PF12392	PF12395	PF12396	PF12397	PF12400	Protein of unknown function (DUF2662) (PF12401)	PF12404	Ribose-5-phosphate isomerase (PF12408)	PF12409	PF12411	PF12412	PF12417	PF12418	PF12419	PF12421	PF12423	Plasma membrane calcium transporter ATPase C terminal (PF12424)	PF12430	PF12431	ICP0-binding domain of Ubiquitin-specific protease 7 (PF12436)	Glutamine synthetase type III N terminal (PF12437)	PF12439	PF12447	PF12449	PF12450	PF12451	PF12455	PF12456	PF12457	PF12458	PF12460	PF12461	PF12462	Maltose acetyltransferase (PF12464)	Proteasome beta subunits C terminal (PF12465)	PF12466	PF12471	PF12473	PF12476	PF12477	PF12482	PF12486	PF12487	PF12500	PF12501	PF12502	PF12505	PF12508	PF12511	PF12512	Mitochondrial degradasome RNA helicase subunit C terminal (PF12513)	PF12519	PF12520	PF12528	PF12529	PF12531	PF12532	PF12536	PF12537	DNA transporter (PF12538)	Chromosome segregation protein Csm1/Pcs1 (PF12539)	PF12541	PF12542	Lysine-2,3-aminomutase (PF12544)	PF12545	PF12550	PF12551	PF12553	PF12555	PF12556	Cob(I)alamin adenosyltransferase N terminal (PF12557)	PF12564	PF12566	Acetyltransferase (GNAT) domain (PF12568)	NMDA receptor-regulated protein 1 (PF12569)	PF12570	PF12571	2-oxoisovalerate dehydrogenase E1 alpha subunit N terminal (PF12573)	Tripeptidyl peptidase II (PF12580)	PF12584	PF12585	PF12588	PF12589	Protein of unknown function (DUF3763) (PF12592)	PF12596	PF12597	PF12600	Fertility inhibition protein N terminal (PF12602)	Tail fiber protein gp37 C terminal (PF12604)	PF12605	PF12607	PF12612	PF12615	PF12616	PF12617	PF12619	PF12621	RNA repair, ligase-Pnkp-associating, region of Hen1 (PF12623)	PF12624	Polymerase A arginine-rich C-terminus (PF12626)	Catalytic cysteine-containing C-terminus of GTPase, MnmE (PF12631)	PF12632	PF12633	PF12634	PF12635	PF12637	DNase/tRNase domain of colicin-like bacteriocin (PF12639)	Conjugative transposon protein TcpC (PF12642)	PF12647	PF12648	PF12656	PF12657	Putative zinc-finger of transcription factor IIIC complex (PF12660)	Human growth factor-like EGF (PF12661)	Complement Clr-like EGF-like (PF12662)	PF12671	PF12673	PF12674	RING-H2 zinc finger (PF12678)	SnoaL-like domain (PF12680)	Glyoxalase-like domain (PF12681)	PDDEXK-like domain of unknown function (DUF3799) (PF12684)	PF12686	Acid Phosphatase (PF12689)	GspL periplasmic domain (PF12693)	Alpha/beta hydrolase family (PF12695)	PF12699	MacB-like periplasmic core domain (PF12704)	PF12709	Domain of unknown function (DUF3806) (PF12713)	Abhydrolase family (PF12715)	Tropomyosin like (PF12718)	Nuclear condensing complex subunits, C-term domain (PF12719)	Flavodoxin domain (PF12724)	PF12725	PF12726	PBP superfamily domain (PF12727)	PF12729	PF12732	PF12733	PF12735	twin BRCT domain (PF12738)	PF12739	Susd and RagB outer membrane lipoprotein (PF12741)	Anticodon binding domain of tRNAs (PF12745)	PF12751	PF12752	PF12757	PF12759	Transposase zinc-ribbon domain (PF12760)	PF12761	PF12762	PF12765	Pyridoxamine 5'-phosphate oxidase (PF12766)	PF12767	PF12768	Domain of unknown function (DUF3814) (PF12769)	PF12770	PF12773	Microtubule-binding stalk of dynein motor (PF12777)	PF12779	P-loop containing dynein motor region D4 (PF12780)	PF12787	Type VI secretion lipoprotein (PF12790)	PF12792	PF12793	PF12794	PF12795	Ankyrin repeats (3 copies) (PF12796)	4Fe-4S binding domain (PF12797)	4Fe-4S binding domain (PF12798)	Leucine Rich repeats (2 copies) (PF12799)	4Fe-4S binding domain (PF12800)	PF12801	MobA-like NTP transferase domain (PF12804)	PF12806	PF12808	PF12811	PF12812	Meiotic cell cortex C-terminal pleckstrin homology (PF12814)	PF12816	PF12821	Protein of unknown function (DUF3816) (PF12822)	PF12823	Mitochondrial ribosomal protein subunit L20 (PF12824)	PF12825	PF12828	Transcriptional regulation of mitochondrial recombination (PF12829)	PF12830	MFS_1 like family (PF12832)	Helix-turn-helix domain (PF12833)	PF12834	Integrase (PF12835)	4Fe-4S binding domain (PF12837)	4Fe-4S dicluster domain (PF12838)	Domain of unknown function (DUF3819) (PF12842)	PF12843	PBP superfamily domain (PF12849)	Calcineurin-like phosphoesterase superfamily domain (PF12850)	PF12853	PF12855	PF12857	PF12859	Anaphase-promoting complex subunit 11 RING-H2 finger (PF12861)	PF12862	Protein of unknown function (DUF3822) (PF12864)	Protein of unknown function (DUF3823) (PF12866)	DinB superfamily (PF12867)	PF12868	tRNA_anti-like (PF12869)	Lumazine-binding domain (PF12870)	PF12871	OST-HTH/LOTUS domain (PF12872)	Protein of unknown function (DUF3826) (PF12875)	Sugar-binding cellulase-like (PF12876)	Protein of unknown function (DUF3828) (PF12883)	Protein of unknown function (DUF3829) (PF12889)	Dihydro-orotase-like (PF12890)	Glycoside hydrolase family 44 (PF12891)	T surface-antigen of pili (PF12892)	Anaphase-promoting complex subunit 4 WD40 domain (PF12894)	PF12896	Alanine-glyoxylate amino-transferase (PF12897)	Stc1 domain (PF12898)	PF12899	Pyridoxamine 5'-phosphate oxidase (PF12900)	PF12901	Protein of unknown function (DUF3830) (PF12903)	Putative collagen-binding domain of a collagenase (PF12904)	Endo-alpha-N-acetylgalactosaminidase (PF12905)	RING-variant domain (PF12906)	PF12911	PF12915	HD containing hydrolase-like enzyme (PF12917)	TcdA/TcdB catalytic glycosyltransferase domain (PF12919)	PF12920	PF12922	Ribosomal RNA-processing protein 7 (RRP7) (PF12923)	PF12927	PF12928	PF12929	Vesicle coat trafficking protein Sec16 mid-region (PF12932)	PF12935	PF12936	F-box-like (PF12937)	PF12942	EGF domain (PF12947)	HeH/LEM domain (PF12949)	TaqI-like C-terminal specificity domain (PF12950)	PF12951	PF12955	PF12957	PF12960	PF12964	PF12965	Domain of Unknown Function with PDB structure (DUF3857) (PF12969)	Alpha-N-acetylglucosaminidase (NAGLU) N-terminal domain (PF12971)	Alpha-N-acetylglucosaminidase (NAGLU) C-terminal domain (PF12972)	ChrR Cupin-like domain (PF12973)	Domain of Unknown Function with PDB structure (DUF3861) (PF12977)	Domain of Unknown Function with PDB structure (DUF3863) (PF12979)	Domain of Unknown Function with PDB structure (DUF3864) (PF12980)	PF12982	Domain of unknown function (DUF3870) (PF12986)	PF12987	Domain of unknown function, B. Theta Gene description (DUF3872) (PF12988)	PF12990	PF12991	PF12996	Inhibitor of growth proteins N-terminal histone-binding (PF12998)	PF12999	PF13000	PF13001	Bacteroidetes-Associated Carbohydrate-binding Often N-terminal (PF13004)	PF13005	PF13006	PF13007	PF13009	PF13011	Maintenance of mitochondrial structure and function (PF13012)	PF13013	KH domain (PF13014)	PF13018	PF13019	PF13020	HD domain (PF13023)	PF13031	PF13032	Protein of unknown function (DUF3897) (PF13036)	PPR repeat family (PF13041)	PF13075	PF13079	PF13084	2Fe-2S iron-sulfur cluster binding domain (PF13085)	Polyphosphate kinase N-terminal domain (PF13089)	Polyphosphate kinase C-terminal domain (PF13090)	PLD-like domain (PF13091)	Kinetochore complex Sim4 subunit Fta1 (PF13092)	PF13093	PF13094	PF13095	Thioredoxin-like domain (PF13098)	PF13099	PF13100	PF13101	Phage integrase SAM-like domain (PF13102)	TonB C terminal (PF13103)	PF13116	PF13136	SAF-like (PF13144)	PPIC-type PPIASE domain (PF13145)	PF13148	PF13151	PF13154	PF13163	PF13166	PF13167	PF13170	Tetratricopeptide repeat (PF13174)	Tetratricopeptide repeat (PF13176)	PDZ domain (PF13180)	Tetratricopeptide repeat (PF13181)	PF13182	4Fe-4S dicluster domain (PF13183)	NusA-like KH domain (PF13184)	GAF domain (PF13185)	Iron-sulfur cluster-binding domain (PF13186)	4Fe-4S dicluster domain (PF13187)	PAS domain (PF13188)	Cytidylate kinase-like family (PF13189)	Thioredoxin domain (PF13192)	AMP-binding enzyme C-terminal domain (PF13193)	PF13194	PF13195	PF13196	Glycosyl hydrolase family 66 (PF13199)	PF13200	Putative glycoside hydrolase xylanase (PF13201)	EF hand (PF13202)	PF13203	Protein of unknown function (DUF4038) (PF13204)	PF13208	PF13211	PF13212	PF13218	PF13223	PF13224	PF13226	PF13227	PF13228	Glutamine amidotransferases class-II (PF13230)	PF13232	rRNA-processing arch domain (PF13234)	PF13236	4Fe-4S dicluster domain (PF13237)	PF13239	PF13240	Putative NAD(P)-binding (PF13241)	PF13244	4Fe-4S dicluster domain (PF13247)	PF13250	PF13251	PF13252	PF13254	PF13257	PF13259	PF13262	PF13264	PF13265	PF13271	PF13273	PF13274	PF13276	YmdB-like protein (PF13277)	Putative amidotransferase (PF13278)	PF13280	PF13281	PF13282	PF13283	PF13284	Phosphohydrolase-associated domain (PF13286)	PF13287	DXP reductoisomerase C-terminal domain (PF13288)	1-deoxy-D-xylulose-5-phosphate synthase (PF13292)	PF13296	DNA polymerase Ligase (LigD) (PF13298)	PF13299	PF13300	Acetyltransferase (GNAT) domain (PF13302)	PF13303	AAA domain (PF13304)	WHG domain (PF13305)	Leucine rich repeats (6 copies) (PF13306)	Helicase C-terminal domain (PF13307)	YARHG domain (PF13308)	PF13310	PF13311	PF13312	PF13313	PF13315	PF13316	PF13317	PF13318	PF13320	PF13323	PF13327	PF13329	PF13331	PF13332	PF13335	Acetyl-CoA hydrolase/transferase C-terminal domain (PF13336)	PF13337	PF13338	PF13339	PF13340	PF13342	Haloacid dehalogenase-like hydrolase (PF13344)	Domain of unknown function (DUF4098) (PF13345)	PF13346	Tyrosine phosphatase family C-terminal region (PF13348)	PF13349	Tyrosine phosphatase family (PF13350)	PF13351	Domain of unknown function (DUF4102) (PF13356)	PF13359	UvrD-like helicase C-terminal domain (PF13361)	Beta-galactosidase, domain 3 (PF13363)	Beta-galactosidase jelly roll domain (PF13364)	PF13366	PF13367	PF13368	Alginate export (PF13372)	PF13373	RnfC Barrel sandwich hybrid domain (PF13375)	CoA binding domain (PF13380)	Adenine deaminase C-terminal domain (PF13382)	PF13386	PF13387	PF13391	HNH endonuclease (PF13392)	HNH endonuclease (PF13395)	PF13396	Domain of unknown function (DUF4109) (PF13397)	LytR cell envelope-related transcriptional attenuator (PF13399)	PF13400	AsnC-type helix-turn-helix domain (PF13404)	EF-hand domain (PF13405)	Transglycosylase SLT domain (PF13406)	Periplasmic binding protein domain (PF13407)	Recombinase zinc beta ribbon domain (PF13408)	Glutathione S-transferase, N-terminal domain (PF13409)	MerR HTH family regulatory protein (PF13411)	Winged helix-turn-helix DNA-binding (PF13412)	Helix-turn-helix domain (PF13413)	Glutathione S-transferase, N-terminal domain (PF13417)	Haloacid dehalogenase-like hydrolase (PF13419)	PF13422	Ubiquitin carboxyl-terminal hydrolase (PF13423)	PAS domain (PF13426)	PF13427	PF13430	L-lysine 6-monooxygenase (NADPH-requiring) (PF13434)	Cytochrome c554 and c-prime (PF13435)	PF13436	PF13438	Glycosyltransferase Family 4 (PF13439)	PF13441	Cytochrome C oxidase, cbb3-type, subunit III (PF13442)	Cro/C1-type HTH DNA-binding domain (PF13443)	RING-type zinc-finger (PF13445)	PF13446	PF13448	Esterase-like activity of phytase (PF13449)	PF13453	SH3-like domain (PF13457)	Periplasmic binding protein (PF13458)	Cell-wall surface anchor repeat (PF13461)	Thioredoxin (PF13462)	Winged helix DNA-binding domain (PF13463)	PF13464	STAS domain (PF13466)	Ribbon-helix-helix domain (PF13467)	Glyoxalase-like domain (PF13468)	PF13470	Cupredoxin-like domain (PF13473)	Glycosyl transferase 4-like (PF13477)	XdhC Rossmann domain (PF13478)	Putative zinc-finger (PF13490)	PF13491	GAF domain (PF13492)	Domain of unknown function (DUF4118) (PF13493)	Phage integrase, N-terminal SAM-like domain (PF13495)	PF13496	EF-hand domain pair (PF13499)	PF13503	Leucine rich repeat (PF13504)	Outer membrane protein beta-barrel domain (PF13505)	Glycosyl transferase family 21 (PF13506)	Acetyltransferase (GNAT) domain (PF13508)	PF13511	Amino acid permease (PF13520)	Sterol carrier protein domain (PF13530)	2OG-Fe(II) oxygenase superfamily (PF13532)	Glutamine amidotransferase domain (PF13537)	UvrD-like helicase C-terminal domain (PF13538)	PF13544	PF13547	PF13548	Bacteriophage related domain of unknown function (PF13554)	PucR C-terminal helix-turn-helix domain (PF13556)	PF13557	PF13559	PF13562	PF13566	PF13567	Outer membrane protein beta-barrel domain (PF13568)	PF13569	PF13571	PF13572	PF13573	PF13575	Pentapeptide repeats (9 copies) (PF13576)	Glycosyl transferase 4-like domain (PF13579)	SIS domain (PF13580)	Histidine kinase-like ATPase domain (PF13581)	PF13584	Type I restriction enzyme R protein N terminus (HSDR_N) (PF13588)	Domain of unknown function (DUF4136) (PF13590)	PF13592	SBF-like CPA transporter family (DUF4137) (PF13593)	PF13595	PF13598	Pentapeptide repeats (9 copies) (PF13599)	PF13600	Winged helix DNA-binding domain (PF13601)	Leucyl-tRNA synthetase, Domain 2 (PF13603)	PF13605	Ankyrin repeat (PF13606)	PF13612	PF13613	AAA domain (PF13614)	PF13617	PF13618	PF13619	PF13628	PF13630	Cytochrome b(N-terminal)/b6/petB (PF13631)	PF13634	PF13635	pre-rRNA processing and ribosome biogenesis (PF13636)	PIN domain (PF13638)	Ring finger domain (PF13639)	2OG-Fe(II) oxygenase superfamily (PF13640)	PF13643	PF13644	Lipocalin-like domain (PF13648)	PF13651	Domain of unknown function (DUF4146) (PF13652)	PF13655	HipA N-terminal domain (PF13657)	Domain of unknown function (DUF4147) (PF13660)	Toprim domain (PF13662)	PF13663	PF13664	PF13665	ThiC-associated domain (PF13667)	PF13670	Acetyltransferase (GNAT) domain (PF13673)	Type IV pili methyl-accepting chemotaxis transducer N-term (PF13675)	TIR domain (PF13676)	PF13677	PF13679	PF13681	Chemoreceptor zinc-binding domain (PF13682)	PF13687	PF13689	Chemotaxis phosphatase CheX (PF13690)	tRNase Z endonuclease (PF13691)	PF13695	PF13698	PF13699	PF13700	PF13707	PF13708	Domain of unknown function (DUF4159) (PF13709)	PF13711	PF13715	Divergent CRAL/TRIO domain (PF13716)	GNAT acetyltransferase 2 (PF13718)	Udp N-acetylglucosamine O-acyltransferase; Domain 2 (PF13720)	SecD export protein N-terminal TM region (PF13721)	PF13722	Possible tRNA binding domain (PF13725)	PF13731	PF13732	PF13741	PF13742	4Fe-4S dicluster domain (PF13746)	PF13747	PF13748	ATP-dependent DNA helicase recG C-terminal (PF13749)	PF13750	Putative flagellar system-associated repeat (PF13753)	Bacterial Ig-like domain (group 3) (PF13754)	PF13755	PF13756	PF13757	PF13761	PF13763	PF13764	PF13769	Domain of unknown function (DUF4170) (PF13773)	Regulated-SNARE-like domain (PF13774)	PF13776	PF13777	PF13778	PF13779	PF13781	PF13783	Fic/DOC family N-terminal (PF13784)	PF13785	Domain of unknown function (DUF4179) (PF13786)	PF13788	N-terminal domain of ribose phosphate pyrophosphokinase (PF13793)	PF13796	Heavy-metal resistance (PF13801)	Galactose mutarotase-like (PF13802)	PF13803	Eisosome component PIL1 (PF13805)	PF13809	PF13810	PF13811	Pentatricopeptide repeat domain (PF13812)	PF13814	Haem-containing dehydratase (PF13816)	PF13821	Alcohol dehydrogenase GroES-associated (PF13823)	PF13826	PF13827	PF13828	PF13829	PF13830	PF13834	PF13835	PF13839	ACT domain (PF13840)	Glycosyl transferase family 41 (PF13844)	PF13845	Methyltransferase domain (PF13847)	PF13852	Leucine rich repeat (PF13855)	PF13858	FlgD Ig-like domain (PF13860)	FlgD Tudor-like domain (PF13861)	PF13862	Nucleotide hydrolase (PF13869)	PF13871	Myb/SANT-like DNA-binding domain (PF13873)	Nucleoporin complex subunit 54 (PF13874)	PF13875	PF13876	PF13878	PF13880	PF13886	PF13890	PF13892	PF13902	Thioredoxin-like (PF13905)	PF13906	PF13907	PF13910	PF13915	PF13924	PF13926	PF13931	GidA associated domain 3 (PF13932)	PF13933	PF13934	Helix-turn-helix domain (PF13936)	PF13937	Domain of unknown function (DUF4213) (PF13938)	PF13939	PF13941	PF13942	Lipocalin-like domain (PF13944)	PF13945	PF13946	PF13948	ALIX V-shaped domain binding to HIV (PF13949)	UDP-glucose 4-epimerase C-term subunit (PF13950)	PF13952	PapC C-terminal domain (PF13953)	PapC N-terminal domain (PF13954)	PF13957	PF13959	PF13960	PF13961	PF13966	Domain of unknown function (DUF4221) (PF13970)	Bacterial transcriptional repressor (PF13972)	PF13976	SopA-like catalytic domain (PF13979)	SopA-like central domain (PF13981)	PF13982	PF13983	PF13984	PF13985	YedD-like protein (PF13987)	PF13988	PF13989	PF13990	PF13991	PF13992	PF13993	PF13994	YebF-like protein (PF13995)	PF13996	PF13997	DNA packaging protein FI (PF14000)	PF14002	PF14004	PF14005	PF14007	Iron/zinc purple acid phosphatase-like protein C (PF14008)	EspG family (PF14011)	PF14013	PF14014	PF14015	PF14017	PF14018	PF14019	PF14020	PF14021	PF14022	PF14023	PF14024	PF14025	PF14026	PF14027	PF14028	PF14029	PF14030	Putative serine dehydratase domain (PF14031)	PknH-like extracellular domain (PF14032)	PF14033	PF14036	PF14037	PF14039	PF14040	Capsule assembly protein Wzi (PF14052)	PF14054	PF14057	PF14058	Domain of unknown function (DUF4251) (PF14059)	PF14060	PF14062	PF14063	HmuY protein (PF14064)	PF14065	PF14066	PF14067	PF14072	PF14076	PF14078	PF14080	PF14081	PF14082	PF14087	PF14088	PF14091	PF14092	PF14093	PF14094	Polysaccharide lyase (PF14099)	PF14100	PF14102	PF14103	PF14107	PF14108	PF14109	PF14110	PF14112	Domain of unknown function (DUF4285) (PF14113)	PF14114	PF14117	PF14121	PF14123	PF14124	PF14125	PF14126	PF14127	PF14128	PF14129	PF14130	Domain of unknown function (DUF4298) (PF14131)	PF14134	PF14136	PF14137	PF14155	PF14158	PF14159	PF14165	PF14168	PF14175	PF14177	PF14183	PF14187	PF14188	PF14189	PF14191	PF14195	PF14196	PF14197	PF14198	PF14199	Ricin-type beta-trefoil lectin domain-like (PF14200)	Ribosomal L18 C-terminal region (PF14204)	PF14206	PF14213	PF14214	PF14217	PF14220	PF14221	PF14222	PF14224	PF14225	non-haem dioxygenase in morphine synthesis N-terminal (PF14226)	PF14228	PF14229	GXWXG protein (PF14231)	Domain of unknown function (DUF4334) (PF14232)	PF14234	PF14235	PF14236	PF14237	PF14238	PF14239	PF14240	PF14241	PF14242	PF14244	PF14247	PF14248	PF14250	PF14252	PF14253	PF14255	PF14256	PF14257	PF14258	PF14260	PF14261	PF14262	PF14264	PF14265	PF14266	PF14267	PF14268	PF14271	PF14272	PF14273	Domain of unknown function (DUF4361) (PF14274)	PF14275	PF14279	PF14280	PF14281	PF14282	PF14283	PF14284	DHHW protein (PF14286)	PF14287	PF14288	PF14289	PF14291	PF14292	PF14293	PF14294	PAN domain (PF14295)	PF14297	PF14298	Domain of unknown function (DUF4375) (PF14300)	PF14301	PF14302	PF14303	Transcription termination and cleavage factor C-terminal (PF14304)	PF14305	PUA-like domain (PF14306)	PF14308	Fibronectin type III-like domain (PF14310)	PF14311	PF14312	PF14315	PF14316	PF14317	PF14318	PF14319	PF14321	GxGYxY sequence motif in domain of unknown function (PF14323)	PINIT domain (PF14324)	PF14325	PF14326	Hinge domain of cleavage stimulation factor subunit 2 (PF14327)	PF14328	PF14329	PF14330	PF14331	PF14332	PF14333	PF14334	Domain of unknown function (DUF4392) (PF14336)	PF14337	PF14338	PF14339	PF14340	PF14341	PF14342	PF14343	PF14344	PF14345	Domain of unknown function (DUF4398) (PF14346)	PF14347	PF14348	PF14349	PF14350	PF14351	PF14355	PF14356	Domain of unknown function (DUF4406) (PF14359)	PF14360	PF14361	PF14362	PF14367	C-terminal topoisomerase domain (PF14370)	PF14371	PF14376	PF14377	Exosome complex exonuclease RRP4 N-terminal region (PF14382)	PF14384	PF14386	PF14388	PF14390	PF14391	Zinc knuckle (PF14392)	PF14393	PF14398	PF14399	PF14400	PF14401	PF14402	PF14403	PF14410	PF14411	Thg1 C terminal domain (PF14413)	Domain of unknown function (DUF4424) (PF14415)	PF14417	PF14418	PF14420	PF14427	C2 domain in Dock180 and Zizimin proteins (PF14429)	PF14431	PF14436	Ataxin 2 SM domain (PF14438)	PF14441	PF14449	PF14451	PF14452	PF14462	Prokaryotic homologs of the JAB domain (PF14464)	PF14472	PF14474	PF14475	Prion-inhibition and propagation (PF14479)	PF14480	Cut8 dimerisation domain (PF14483)	PF14485	Domain of unknown function (DUF4432) (PF14486)	PF14487	Domain of unknown function (DUF4434) (PF14488)	QueF-like protein (PF14489)	Helix-hairpin-helix containing domain (PF14490)	Elongation Factor G, domain II (PF14492)	PF14493	PF14494	Cytochrome c-550 domain (PF14495)	C-terminal novel E3 ligase, LRR-interacting (PF14496)	Glutathione S-transferase, C-terminal domain (PF14497)	Glycosyl hydrolase family 65, N-terminal domain (PF14498)	Glycosyl-hydrolase 97 N-terminal (PF14508)	Glycosyl-hydrolase 97 C-terminal, oligomerisation (PF14509)	PF14510	Iron-containing redox enzyme (PF14518)	Lysine-specific metallo-endopeptidase (PF14521)	Cytochrome c7 (PF14522)	Wzt C-terminal domain (PF14524)	Integron-associated effector binding protein (PF14526)	LAGLIDADG-like domain (PF14528)	Endonuclease-reverse transcriptase (PF14529)	Domain of unknown function (DUF4439) (PF14530)	Ubiquitin-specific protease C-terminal (PF14533)	Domain of unknown function (DUF4440) (PF14534)	AMP-binding enzyme C-terminal domain (PF14535)	PF14538	Domain of unknown function (DUF4442) (PF14539)	Domain of unknown function (DUF4443) (PF14544)	MCM N-terminal domain (PF14551)	Tautomerase enzyme (PF14552)	Ubiquitin-like domain (PF14560)	Phosphoribosyl synthetase-associated domain (PF14572)	Domain of unknown function (DUF4445) (PF14574)	Ephrin type-A receptor 2 transmembrane domain (PF14575)	Elongation factor Tu domain 4 (PF14578)	Helix-hairpin-helix motif (PF14579)	PF14581	Oligogalacturonate lyase (PF14583)	PF14594	Variant SH3 domain (PF14604)	PF14613	Domain of unknown function (DUF4450) (PF14614)	PF14616	PF14618	PF14619	Ribonuclease-III-like (PF14622)	PF14630	PF14632	SH2 domain (PF14633)	PF14636	Holliday-junction resolvase-like of SPT6 (PF14639)	Helix-turn-helix DNA-binding domain of SPT6 (PF14641)	PF14657	Phage integrase, N-terminal SAM-like domain (PF14659)	PF14662	PF14663	PF14664	PF14666	Polysaccharide biosynthesis C-terminal domain (PF14667)	PF14668	Dual specificity protein phosphatase, N-terminal half (PF14671)	Sporulation initiation phospho-transferase B, C-terminal (PF14682)	Polysaccharide lyase family 4, domain III (PF14683)	Tricorn protease C1 domain (PF14684)	Tricorn protease PDZ domain (PF14685)	Polysaccharide lyase family 4, domain II (PF14686)	PF14690	Dihydroprymidine dehydrogenase domain II, 4Fe-4S cluster (PF14691)	Ribosomal protein TL5, C-terminal domain (PF14693)	Argininosuccinate lyase C-terminal (PF14698)	PF14699	DNA-directed RNA polymerase N-terminal (PF14700)	PF14703	Transposase DNA-binding (PF14706)	Respiratory nitrate reductase alpha N-terminal (PF14710)	Respiratory nitrate reductase beta C-terminal (PF14711)	Soluble lytic murein transglycosylase L domain (PF14718)	NiFe/NiFeSe hydrogenase small subunit C-terminal (PF14720)	Apoptosis-inducing factor, mitochondrion-associated, C-term (PF14721)	PF14727	PF14728	Domain of unknown function (DUF4468) with TBP-like fold (PF14730)	Ubiquitin/SUMO-activating enzyme ubiquitin-like domain (PF14732)	PF14737	DNA ligase OB-like domain (PF14743)	Pyrroline-5-carboxylate reductase dimerisation (PF14748)	Acyl-coenzyme A oxidase N-terminal (PF14749)	Reductase C-terminal (PF14759)	Rnk N-terminus (PF14760)	PF14773	PF14775	Maltose transport system permease protein MalF P2 domain (PF14785)	DNA polymerase beta thumb (PF14791)	DNA polymerase beta palm (PF14792)	Domain of unknown function (DUF4478) (PF14793)	Domain of unknown function (DUF4479) (PF14794)	PF14796	Nudix N-terminal (PF14803)	Tetrahydrodipicolinate N-succinyltransferase N-terminal (PF14805)	PF14806	Patch-forming domain C2 of tRNA-guanine transglycosylase (PF14810)	Bifunctional transglycosylase second domain (PF14814)	NUDIX domain (PF14815)	Nitrile reductase, 7-cyano-7-deazaguanine-reductase N-term (PF14819)	Threonine synthase N terminus (PF14821)	Sirohaem biosynthesis protein C-terminal (PF14823)	Sirohaem biosynthesis protein central (PF14824)	FACT complex subunit SPT16 N-terminal lobe domain (PF14826)	Sensory domain of two-component sensor kinase (PF14827)	PF14831	Putative oxalocrotonate tautomerase enzyme (PF14832)	NAD-binding of NADP-dependent 3-hydroxyisobutyrate dehydrogenase (PF14833)	FliG N-terminal domain (PF14842)	PH domain associated with Beige/BEACH (PF14844)	beta-acetyl hexosaminidase like (PF14845)	Ras-binding domain of Byr2 (PF14847)	YidC periplasmic domain (PF14849)	DNA-binding domain of Proline dehydrogenase (PF14850)	Fis1 N-terminal tetratricopeptide repeat (PF14852)	Fis1 C-terminal tetratricopeptide repeat (PF14853)	PF14856	Alkyl sulfatase dimerisation (PF14863)	Alkyl sulfatase C-terminal (PF14864)	Photosynthesis system II assembly factor YCF48 (PF14870)	PF14871	N-terminal domain of BNR-repeat neuraminidase (PF14873)	Death-like domain of SPT6 (PF14878)	PF14880	PF14881	Effector protein (PF14891)	PF14902	Short tail fibre protein receptor-binding domain (PF14928)	Quinohemoprotein amine dehydrogenase, alpha subunit domain II (PF14930)	Mitochondrial function, CLU-N-term (PF15044)	PF15071	Exocyst complex component SEC3 N-terminal PIP2 binding PH (PF15277)	Domain of unknown function (DUF4595) with porin-like fold (PF15283)	PF15306	PF15377	PF15407	PF15418	PF15420	PF15428	PF15456	PF15459	PF15460	PF15461	PF15463	PF15469	PF15474	PF15508	MvaI/BcnI restriction endonuclease family (PF15515)	linker between RRM2 and RRM3 domains in RBM39 protein (PF15519)	PF15521	PF15523	Putative toxin 46 (PF15526)	PF15528	PF15530	PF15532	PF15538	PF15540	PF15577	PF15579	PF15584	PF15586	PF15588	PF15593	PF15594	Immunity protein 37 (PF15598)	PF15602	PF15607	PF15608	PF15610	WSTF, HB1, Itc1p, MBD9 motif 1 (PF15612)	PF15613	PF15614	PF15615	PF15616	PF15624	PF15632	PF15633	PF15635	PF15636	PF15637	PF15638	PF15643	Papain fold toxin 1 (PF15644)	Dermonecrotoxin of the Papain-like fold (PF15645)	PF15648	PF15649	PF15652	PF15656	PF15657	PF15659
PHYLLO09	9578	0	1	0	35	170	18	0	35	0	3	10	6	0	49	0	0	2	0	0	1	1	0	0	14	0	0	3	0	5	0	0	4	1	1	1	5	1	0	0	0	0	0	0	3	0	0	0	0	1	0	0	11	23	31	0	106	1	5	0	52	0	1	0	5	20	0	3	1	0	4	1	0	0	1	2	5	1	0	1	0	0	29	48	14	14	0	11	0	6	0	18	11	12	5	5	7	0	14	1	0	44	0	24	0	20	19	0	6	2	0	0	3	1	1	3	1	8	0	0	12	1	4	0	0	37	15	16	0	1	2	0	0	1	0	5	0	29	6	1	1	5	10	2	1	7	2	1	3	4	1	0	2	3	0	0	0	0	18	7	1	0	0	9	0	8	9	9	3	6	2	6	8	1	1	1	0	0	1	0	4	1	1	5	8	1	3	0	0	0	0	5	0	0	1	0	5	16	0	0	4	1	0	3	2	1	0	4	0	1	15	0	3	0	56	76	0	3	0	6	1	0	1	3	14	1	15	13	6	0	13	3	2	0	0	0	5	0	10	0	9	0	4	4	1	2	0	1	7	0	0	0	4	0	5	0	2	2	20	1	0	0	0	0	1	0	6	5	4	0	5	1	4	1	5	0	0	5	0	10	13	0	6	1	31	15	2	0	2	4	4	0	0	0	5	3	9	0	0	1	2	6	17	7	0	0	0	8	3	9	13	1	1	1	1	2	0	8	0	5	0	9	0	1	2	1	1	2	0	0	0	1	0	1	0	0	0	0	0	5	15	6	0	12	20	2	0	0	2	0	1	1	0	3	8	0	2	6	1	3	0	1	1	0	0	0	5	7	3	13	0	1	4	4	0	4	11	2	1	13	3	4	3	2	1	2	21	12	4	5	52	0	0	0	0	2	0	2	80	0	4	1	11	0	78	9	0	1	0	6	11	17	1	0	0	1	0	0	0	7	19	5	1	0	10	1	3	6	44	0	2	3	0	0	2	3	8	0	1	3	28	0	3	7	8	5	9	7	11	0	0	15	16	3	28	8	1	80	3	2	0	0	0	0	0	0	0	0	0	0	2	0	0	0	0	1	1	2	0	0	4	1	0	1	0	0	0	0	2	0	0	3	1	0	1	0	0	0	0	0	0	1	0	0	0	0	0	1	0	4	2	2	0	0	17	29	30	1	12	6	2	46	1	6	28	2	18	0	8	1	0	2	2	0	2	2	3	3	15	17	1	10	0	5	2	15	7	3	0	0	1	1	2	4	3	3	0	6	10	1	3	2	0	8	12	1	0	0	0	4	0	5	0	16	3	0	17	7	0	7	0	0	2	4	8	0	1	3	2	3	2	0	1	2	0	0	1	0	0	0	0	0	4	11	0	1	2	0	0	1	3	0	9	0	3	0	6	0	5	0	0	0	0	0	1	0	1	0	0	1	0	0	4	0	4	9	0	0	0	2	0	0	5	0	2	2	0	0	0	0	2	3	22	2	1	0	1	6	0	4	12	0	0	0	0	1	6	0	14	1	2	0	1	4	24	4	0	16	4	1	9	9	4	2	2	2	0	0	5	1	0	0	9	0	0	0	0	0	3	0	0	1	1	0	0	0	6	0	16	0	0	4	5	1	1	6	7	1	23	55	10	0	0	9	0	0	0	2	0	6	3	0	0	0	0	0	5	0	2	0	1	6	0	1	5	0	0	0	0	0	2	4	8	4	5	4	0	3	2	0	2	1	1	9	2	2	5	6	3	7	0	1	0	6	2	3	1	1	1	0	9	1	0	0	0	3	0	1	1	0	0	0	0	5	11	0	1	0	0	1	1	2	6	3	0	1	0	0	0	0	1	0	5	1	6	2	3	0	6	2	0	0	1	3	1	4	0	0	0	0	1	0	4	0	0	1	1	0	0	0	8	1	2	0	0	0	1	1	1	2	0	0	0	1	0	0	2	2	0	0	0	0	1	0	0	0	0	1	0	0	0	0	2	0	0	1	1	0	0	0	1	2	1	0	0	8	0	3	0	0	2	0	6	0	0	0	2	0	0	1	3	2	0	0	0	1	0	1	0	0	0	1	1	14	0	8	2	0	11	0	1	0	1	2	2	1	0	0	0	0	0	0	0	1	0	3	0	0	2	2	0	0	1	0	0	0	0	5	1	2	0	5	5	3	2	0	0	0	0	0	19	0	6	0	0	2	0	3	0	0	0	1	0	0	0	0	1	0	12	4	0	13	0	0	0	5	19	8	0	4	3	2	0	0	0	0	0	0	2	0	1	0	0	0	0	1	1	5	6	0	9	1	1	0	13	1	0	0	0	0	12	0	0	0	0	1	4	11	5	4	0	0	1	0	1	0	0	2	2	0	0	0	0	3	0	0	8	0	0	3	0	0	0	3	1	0	9	3	13	1	0	9	0	2	1	0	6	1	0	3	11	0	2	0	0	1	2	0	4	1	0	4	2	1	3	2	2	4	2	1	3	0	0	1	0	0	7	0	6	3	16	17	4	2	5	7	4	1	7	4	0	0	13	2	17	4	5	3	0	3	4	0	1	9	0	7	16	0	0	6	4	2	0	2	0	0	0	0	0	14	0	11	4	4	6	5	1	2	17	1	0	2	6	0	1	0	6	0	0	5	1	0	0	0	6	4	0	16	0	1	3	3	0	0	0	0	2	2	0	0	0	0	0	0	2	1	0	0	1	0	2	0	0	2	3	0	3	0	1	0	0	2	5	4	0	0	0	4	0	2	3	2	1	0	0	5	0	0	0	13	0	1	0	4	2	0	0	3	1	0	1	0	0	0	0	0	0	0	0	0	0	0	0	4	0	1	1	0	0	1	5	0	4	0	7	1	0	3	0	1	2	0	2	1	0	0	0	0	0	2	4	0	0	3	14	0	1	0	0	0	0	0	0	0	0	2	0	1	2	0	1	0	1	0	0	3	0	0	0	0	0	1	4	4	0	0	0	1	0	0	1	4	2	0	0	1	1	1	0	1	0	2	0	2	9	0	0	0	1	0	0	2	1	9	1	0	0	0	0	0	0	1	0	0	5	0	0	3	0	0	0	1	0	0	0	0	0	0	0	0	1	3	1	9	1	6	0	5	0	0	1	0	1	0	10	1	0	0	0	0	0	0	1	1	0	0	1	1	0	0	0	0	0	0	0	0	1	0	1	1	1	0	0	3	0	0	0	2	0	0	1	0	0	0	1	0	1	0	0	0	4	2	0	0	0	0	1	4	0	3	0	0	0	0	0	0	0	1	0	0	1	2	0	1	1	0	0	0	3	0	1	0	0	1	1	5	0	0	0	1	0	0	12	1	0	1	0	0	0	4	1	0	0	0	0	0	0	1	0	0	0	0	0	7	1	7	0	0	0	0	0	0	0	0	0	0	0	0	0	0	3	0	4	0	0	1	4	0	0	0	0	7	0	0	0	0	0	0	1	0	0	0	12	0	0	0	1	0	0	0	0	0	0	0	0	0	0	0	0	0	2	19	8	0	15	1	0	0	0	0	0	12	0	0	1	0	0	0	0	0	0	0	5	1	5	0	9	0	0	3	0	1	1	1	1	0	4	0	0	0	4	0	2	3	0	0	0	1	0	0	0	3	0	0	4	2	0	2	0	0	0	0	2	3	1	0	0	0	0	1	0	3	2	0	8	0	0	0	0	0	0	0	0	0	0	7	4	0	0	0	1	1	0	0	1	2	0	0	0	1	1	0	0	0	0	2	2	2	0	1	3	6	0	0	107	1	1	0	0	2	3	0	1	11	2	1	1	0	1	1	0	3	0	0	4	1	0	1	9	0	0	3	3	3	0	3	0	0	1	0	0	4	2	4	0	0	0	1	1	0	0	2	0	0	3	0	0	1	0	0	0	1	1	0	0	0	2	0	1	0	1	8	1	1	0	0	0	2	1	4	0	3	1	0	0	0	0	0	4	0	6	10	1	0	0	2	1	1	7	0	0	0	0	0	0	0	0	1	12	0	0	0	0	1	0	4	0	0	0	1	0	2	1	3	0	1	0	0	0	1	0	1	0	1	2	2	1	16	0	2	0	0	0	0	0	1	4	6	0	1	1	1	0	0	0	4	0	0	1	2	1	2	0	1	7	12	0	5	1	0	4	0	0	4	0	0	1	2	1	4	4	15	23	20	7	5	6	14	9	0	1	30	10	4	5	6	8	14	5	0	3	8	0	0	0	1	0	2	0	4	14	15	2	3	0	3	14	6	0	0	5	0	1	18	0	8	0	0	0	0	0	7	9	2	0	0	3	3	0	0	15	0	8	0	1	0	0	3	10	0	0	4	3	10	11	0	9	9	9	2	4	0	0	1	4	0	0	2	4	6	10	1	0	8	0	1	0	0	0	0	5	1	6	6	1	0	0	0	8	2	1	0	0	0	0	2	7	1	0	2	0	0	0	0	0	0	0	0	13	0	1	0	8	0	0	0	0	0	0	1	0	0	0	0	1	0	0	0	0	2	0	0	2	0	0	6	0	0	0	0	3	0	0	3	0	4	0	0	4	0	0	1	1	0	7	7	2	0	1	0	0	0	3	0	0	0	0	1	0	0	0	0	0	0	1	0	0	0	1	0	6	0	0	0	6	6	1	0	0	0	15	1	0	0	0	1	0	3	30	2	0	0	0	2	0	0	1	3	0	0	0	0	0	1	0	1	0	0	0	1	1	6	0	0	2	5	1	0	0	5	2	1	0	0	0	0	4	0	0	1	0	0	0	0	2	0	0	0	0	0	0	0	2	0	4	4	0	2	1	0	0	0	2	0	0	0	0	0	0	0	2	1	0	0	0	1	0	1	2	0	2	2	0	0	1	3	1	2	0	0	0	0	0	0	0	1	0	0	0	3	1	2	0	0	0	3	0	0	12	1	0	0	0	0	0	0	1	0	0	0	0	0	17	0	0	0	0	0	0	1	1	0	0	0	0	0	3	1	0	0	0	0	0	1	0	0	2	0	1	0	0	5	4	1	1	3	0	4	4	1	1	0	1	2	9	9	4	1	1	1	44	1	3	0	2	0	2	6	0	7	1	4	3	3	4	0	0	0	0	0	0	0	0	0	0	0	7	1	0	0	0	0	0	0	2	2	0	0	2	0	1	0	0	1	1	0	0	4	2	0	0	0	0	0	0	0	0	1	0	2	1	0	0	0	0	4	1	4	0	0	0	0	0	0	0	0	0	0	0	0	1	0	0	0	0	1	1	0	2	3	3	0	3	1	1	0	3	0	0	0	3	0	0	0	2	0	0	0	0	1	0	0	1	0	0	0	0	0	0	0	0	0	0	0	3	0	2	0	3	2	6	0	2	1	0	1	0	0	9	0	0	6	6	0	0	0	6	5	1	1	0	0	4	0	4	0	2	1	5	0	0	0	0	1	0	1	0	0	0	0	12	0	0	0	0	0	0	1	0	0	1	4	2	0	0	0	8	1	4	3	0	1	0	0	0	0	0	1	1	0	0	0	0	0	1	5	0	0	2	0	0	0	0	0	0	0	0	0	0	0	0	0	0	1	0	0	1	0	0	0	0	0	0	0	0	0	1	1	1	1	1	0	0	1	0	1	0	3	0	0	1	0	0	0	0	2	0	0	0	4	1	0	5	0	0	0	0	0	0	0	0	0	1	0	0	0	1	0	4	0	0	0	0	0	0	0	0	0	2	0	0	0	0	2	2	0	3	8	7	6	1	0	3	0	2	0	0	2	0	0	1	8	3	0	1	0	0	4	0	2	0	0	0	0	0	0	0	0	10	0	0	2	0	0	0	0	0	0	0	0	0	0	0	0	0	0	0	0	0	0	0	3	0	0	0	0	0	1	0	0	1	2	2	0	0	1	0	0	0	0	3	0	0	38	0	0	0	1	0	0	0	0	0	0	0	3	1	0	2	0	2	0	0	0	0	0	6	1	0	2	1	0	0	0	2	1	0	0	0	0	0	4	0	2	0	2	0	0	0	0	0	0	0	3	0	1	0	0	0	0	0	0	1	0	0	0	0	0	0	0	0	1	0	1	0	0	0	0	1	0	0	0	0	0	0	3	0	2	0	0	0	2	0	0	0	0	0	0	0	0	2	0	3	0	0	0	0	0	0	0	0	0	0	1	0	0	0	0	0	1	0	0	0	0	0	0	0	0	0	0	0	0	0	1	0	0	1	0	0	0	1	0	0	0	0	0	1	0	0	0	0	0	0	0	0	0	0	2	0	0	3	0	0	0	0	0	0	0	0	0	0	0	0	0	0	0	0	0	0	0	0	2	0	0	2	1	0	1	0	0	0	0	0	0	0	0	5	0	0	0	0	0	4	10	0	0	0	0	0	2	0	0	0	2	2	0	0	0	0	0	0	0	0	0	0	1	0	0	0	0	0	0	5	1	0	0	1	0	0	0	0	0	1	1	0	0	0	0	0	0	1	0	0	0	0	2	0	0	0	0	1	1	0	1	0	0	0	0	7	0	0	0	3	0	0	0	0	0	0	0	0	0	0	0	0	0	1	0	0	0	1	7	1	0	0	0	0	0	6	0	0	1	0	0	2	0	0	0	0	0	2	0	0	0	1	0	1	0	0	0	0	0	0	0	0	0	1	0	1	0	0	1	4	12	7	2	0	1	0	0	0	6	7	8	0	6	0	1	0	0	0	0	0	0	0	0	0	0	10	0	0	0	1	0	3	0	0	0	0	0	0	0	0	2	0	0	1	0	0	0	0	0	0	0	0	2	0	0	0	6	0	1	0	9	0	0	0	1	1	0	8	0	0	0	0	0	0	0	0	0	0	0	0	0	0	0	1	0	0	0	0	0	6	1	0	0	0	0	4	0	0	0	1	0	0	0	0	0	0	0	0	0	0	4	0	0	0	0	0	1	1	0	0	0	0	0	0	18	0	0	1	0	1	0	0	0	0	5	0	0	0	0	0	0	1	0	0	0	0	3	0	0	3	0	0	0	0	0	0	0	0	0	0	0	0	0	1	0	0	0	0	2	0	0	0	0	2	0	0	0	0	0	0	0	0	0	9	0	0	0	0	1	1	0	0	0	0	0	0	5	0	0	1	0	0	0	0	0	0	0	0	4	5	0	4	0	0	0	0	0	0	0	1	0	1	0	0	0	0	0	0	0	0	0	0	0	0	0	3	0	0	0	0	2	0	0	0	0	0	0	0	0	0	0	2	0	0	0	0	1	0	0	0	0	1	0	0	0	0	0	0	0	0	0	0	1	0	0	0	0	0	0	0	1	0	0	0	1	2	1	0	1	0	0	0	0	0	0	0	0	4	0	0	0	1	1	0	0	0	0	3	1	1	4	0	0	0	0	0	1	0	1	1	0	2	1	2	6	0	3	0	8	5	0	0	0	0	0	2	0	0	0	3	0	5	4	3	2	2	0	0	0	0	1	0	3	0	0	0	0	0	0	0	0	0	0	0	0	0	1	0	0	0	0	1	0	6	0	0	0	0	0	0	0	0	1	2	0	0	0	0	0	0	0	8	0	5	0	6	0	0	1	0	0	2	1	1	0	0	0	0	0	0	0	0	0	0	0	0	0	0	0	0	0	0	0	5	0	5	1	0	5	0	0	0	3	0	0	0	0	6	1	1	0	0	0	0	0	0	0	0	0	11	0	0	0	0	0	0	0	0	0	0	4	9	1	0	11	0	1	0	0	0	0	0	0	0	0	0	0	0	0	0	0	0	0	1	0	0	0	0	0	0	1	0	0	1	0	0	0	0	3	3	0	0	1	0	0	1	0	0	0	0	2	2	0	0	0	0	0	0	0	0	1	0	3	0	0	0	0	0	0	0	1	0	0	0	5	0	0	1	0	0	0	0	1	0	0	0	3	0	0	0	1	0	0	0	1	0	0	0	10	1	0	0	0	0	0	0	9	0	0	1	0	0	0	0	0	0	0	0	0	0	0	0	0	0	0	0	0	0	0	0	0	0	0	0	0	0	1	0	0	0	0	2	0	0	0	2	6	0	1	0	1	2	0	4	0	0	1	0	0	0	0	2	0	0	1	0	0	0	0	0	0	0	0	0	1	1	0	0	1	2	0	0	2	0	0	1	0	3	0	0	0	0	0	0	1	0	0	0	1	0	0	0	0	0	0	0	1	0	0	0	0	0	0	0	0	0	0	0	0	1	0	0	1	0	0	0	0	4	0	0	0	0	0	0	0	1	2	0	0	0	0	0	0	0	0	0	0	0	0	1	0	1	0	0	0	1	0	0	0	0	0	0	1	0	0	0	0	0	0	0	0	0	0	0	0	1	1	0	0	0	0	0	0	3	0	0	0	0	0	0	0	0	0	0	0	0	1	0	0	0	0	0	0	0	1	0	0	0	0	2	0	0	0	3	0	0	0	0	1	0	0	0	0	0	1	0	0	0	0	0	0	0	0	0	0	1	0	0	0	0	1	1	0	0	0	0	0	0	0	0	0	0	0	0	1	0	3	0	0	6	1	0	0	0	0	0	4	0	0	2	0	1	0	2	2	0	0	1	8	0	0	0	2	0	0	0	0	0	4	2	0	0	0	0	2	1	0	0	0	0	0	1	1	0	1	0	0	1	0	1	0	1	1	0	0	0	0	0	0	0	0	1	0	0	0	1	0	0	0	0	0	0	0	0	0	4	0	0	0	2	0	0	1	0	0	0	0	0	0	1	2	0	0	0	0	0	3	0	0	0	0	0	0	0	0	0	0	4	0	0	0	0	0	0	0	0	0	0	2	0	2	0	0	0	0	8	0	0	0	0	0	0	0	0	0	0	0	0	0	0	0	0	0	0	0	1	0	0	0	0	0	1	1	0	0	0	0	0	0	0	1	0	0	0	0	0	0	3	0	1	0	0	0	1	2	5	4	1	1	0	0	0	0	0	0	0	1	0	0	1	0	0	0	0	0	0	0	0	0	0	0	0	1	0	0	0	1	0	0	0	0	0	0	0	0	0	0	0	2	1	0	0	0	0	0	0	0	0	0	0	0	0	0	0	0	0	0	0	0	0	0	0	1	0	0	3	2	1	0	0	0	1	0	0	0	6	0	0	1	1	0	1	0	0	0	0	0	0	0	0	0	0	0	0	1	0	0	1	0	0	0	0	0	0	0	0	0	0	0	0	0	0	0	0	0	0	0	1	0	1	0	0	0	0	0	0	1	0	0	0	0	0	0	0	0	0	0	0	2	0	0	0	0	0	0	0	0	0	0	1	0	0	0	0	0	0	0	0	0	0	0	0	0	0	0	0	0	0	0	0	0	0	0	0	1	0	5	0	0	0	4	0	11	0	1	0	0	0	0	0	0	1	0	1	0	0	2	0	0	0	1	0	1	0	0	0	0	0	0	0	0	0	0	1	0	1	0	0	0	1	0	0	0	0	0	0	0	0	0	0	0	1	0	0	0	0	0	0	0	0	0	0	0	0	0	0	0	1	4	0	0	0	1	0	0	1	0	0	0	0	0	0	0	0	0	0	0	0	2	0	0	1	0	0	0	5	0	0	0	0	3	1	1	0	0	2	0	2	3	0	0	1	2	6	7	0	0	1	1	0	0	0	0	3	0	2	0	2	2	4	4	0	0	2	0	1	0	0	0	2	0	0	0	3	0	0	0	0	0	0	0	6	0	0	0	0	1	0	0	0	1	0	0	0	1	0	2	0	0	0	0	0	2	0	2	0	1	2	0	0	1	1	0	1	0	0	0	0	0	0	0	0	2	2	2	2	0	4	2	0	1	0	1	0	0	6	0	0	1	0	4	0	0	0	3	0	0	0	3	0	0	6	0	1	3	1	1	7	0	13	0	70	1	1	3	2	1	0	0	1	0	0	1	4	0	0	0	1	91	0	7	0	10	2	1	14	2	7	2	4	2	5	5	17	0	0	1	0	0	0	0	0	1	0	0	0	0	0	0	1	0	0	0	1	0	0	0	0	0	0	0	0	0	0	0	0	0	2	2	0	1	0	0	0	0	0	0	0	0	0	0	0	0	0	0	0	0	0	0	0	0	1	0	0	0	0	0	0	5	0	0	0	0	0	0	0	0	0	0	0	6	0	0	0	0	1	0	0	0	1	2	0	0	0	0	0	1	0	0	0	0	0	0	0	2	1	0	0	0	0	1	0	0	0	0	0	0	5	0	1	0	16	0	0	0	2	0	5	0	0	0	0	2	36	3	1	11	0	0	0	0	0	2	0	0	0	0	0	1	0	2	0	2	1	5	0	2	2	1	0	0	0	0	0	1	0	0	0	0	0	0	0	0	0	0	0	0	1	0	7	0	0	0	0	1	0	0	0	0	0	0	0	0	1	0	0	0	0	0	0	0	0	0	0	3	1	0	0	0	0	0	0	0	0	3	0	0	1	0	0	0	0	0	1	0	0	0	0	0	3	52	4	6	0	1	12	17	0	1	5	0	2	1	1	0	7	0	0	3	0	6	1	2	0	0	0	0	0	0	1	8	0	0	0	0	0	0	1	0	0	0	0	0	0	0	0	0	0	3	0	0	0	1	0	0	0	0	23	0	3	0	0	0	0	0	1	1	0	0	9	0	0	0	0	0	0	0	0	0	2	2	0	0	0	0	1	1	2	0	0	1	1	0	0	1	1	0	0	0	5	0	0	0	0	0	0	0	0	0	1	0	0	0	1	0	0	3	0	0	1	2	5	0	1	33	23	0	8	0	0	0	4	0	1	4	0	0	1	1	1	0	0	1	1	0	0	0	0	0	0	0	0	6	0	0	2	0	1	2	0	0	0	0	0	1	1	0	0	0	0	0	1	0	0	0	0	1	0	3	0	0	1	2	1	0	1	1	2	2	3	2	1	0	0	0	0	0	0	0	0	0	0	0	0	0	0	1	0	0	0	0	0	0	0	0	0	0	0	0	0	0	0	0	0	0	0	0	0	0	0	0	0	0	0	0	0	0	0	0	0	0	0	0	0	0	0	0	0	0	0	1	0	0	1	0	0	0	0	0	0	0	0	0	0	0	0	0	0	0	0	8	0	0	0	1	0	0	9	4	0	0	0	3	0	0	0	0	0	0	0	0	0	0	0	0	0	0	0	0	0	1	0	0	1	0	0	0	0	0	0	0	0	0	0	0	0	0	0	0	0	0	0	0	0	0	0	1	0	0	2	0	0	0	0	0	0	0	0	0	0	0	0	1	0	0	0	2	0	0	0	0	0	0	0	0	0	0	0	0	0	0	0	0	0	0	0	0	1	0	0	0	0	0	0	0	0	0	0	0	0	0	0	1	0	0	0	0	0	0	1	0	0	1	0	0	0	0	0	0	1	1	0	0	0	0	0	0	0	0	0	0	0	0	0	0	0	0	0	0	0	0	1	0	0	0	0	0	0	0	0	0	1	0	1	0	0	0	0	0	0	0	0	0	0	0	0	0	0	0	0	0	0	0	0	0	0	0	0	0	0	0	0	0	0	10	0	0	0	0	0	0	0	0	0	0	0	0	0	0	0	0	0	1	0	0	0	0	0	0	0	3	0	0	0	0	0	1	0	1	0	0	0	0	0	0	0	0	2	0	0	0	1	0	0	0	0	0	1	1	0	0	0	0	0	0	0	0	0	0	0	0	0	0	0	1	0	0	0	0	0	0	0	0	0	3	0	0	0	0	0	1	0	0	0	0	1	2	2	4	0	0	0	0	0	0	0	0	0	0	0	0	0	0	0	0	0	1	0	1	11	3	1	0	4	0	0	0	0	0	1	1	0	0	0	3	0	0	0	0	1	0	0	1	0	4	4	0	0	0	4	0	3	0	0	0	0	0	1	0	0	0	0	2	0	0	0	0	4	0	0	0	0	0	0	0	0	0	0	0	0	5	1	0	0	0	0	0	0	0	0	0	0	0	0	0	0	0	0	0	0	0	0	0	0	0	0	0	0	0	0	0	0	0	0	0	0	0	0	0	0	0	1	0	0	0	0	0	0	0	0	0	0	1	0	0	0	1	0	0	0	0	0	0	0	0	0	0	0	0	0	0	0	0	0	0	0	0	0	0	0	0	0	0	0	0	0	0	0	0	1	0	0	0	0	0	0	0	0	0	0	0	0	0	0	1	0	0	0	0	3	0	0	1	0	0	0	0	0	0	0	1	0	0	0	0	0	0	1	3	0	0	0	0	0	0	0	0	0	0	0	0	0	0	0	0	0	1	1	0	0	0	0	0	0	0	0	0	1	0	0	0	0	0	0	0	0	0	0	0	0	0	2	0	0	0	0	1	0	1	0	0	0	0	0	0	0	0	0	0	0	0	0	1	0	0	0	1	0	0	0	0	2	1	0	0	0	0	0	0	0	0	0	0	0	0	0	0	0	0	0	0	0	0	2	0	0	1	0	0	0	0	0	0	0	0	0	0	0	1	0	0	0	0	0	0	0	1	0	0	0	0	0	0	0	0	0	0	0	0	3	1	0	0	1	0	0	0	0	2	1	1	0	0	0	0	0	0	0	0	1	1	0	0	0	0	0	0	1	0	1	0	0	0	0	0	0	1	0	0	0	0	0	0	0	0	0	0	0	0	0	0	0	0	1	0	0	1	0	0	0	0	0	0	0	0	0	0	0	0	0	1	0	0	0	0	0	0	0	0	0	0	0	0	0	4	0	0	0	0	0	0	0	0	0	2	5	0	0	0	0	0	0	0	1	0	0	1	0	0	0	0	0	0	0	1	3	0	0	0	0	0	0	0	0	0	0	0	0	0	0	0	0	0	0	0	0	0	0	0	0	0	0	0	0	0	0	0	0	1	0	0	0	0	0	0	0	1	0	0	0	0	0	0	0	0	0	0	0	0	0	0	0	0	1	0	0	0	0	0	0	0	0	0	1	0	0	0	0	0	0	0	0	0	0	1	0	0	0	0	1	0	0	0	0	0	0	0	0	0	0	1	1	0	0	2	0	0	0	0	4	0	0	0	0	0	0	2	2	1	1	0	0	0	0	0	3	0	0	0	2	1	0	0	1	0	0	16	0	0	0	0	0	0	0	0	0	0	0	0	0	0	6	0	0	0	0	0	1	0	0	0	0	0	0	0	0	0	0	0	1	0	0	0	0	0	0	0	6	0	0	0	0	0	0	0	0	0	0	0	0	0	0	0	0	1	0	0	0	0	0	0	1	0	2	2	0	0	1	0	0	0	1	3	1	1	4	0	0	0	0	0	0	0	0	0	0	0	0	0	0	0	0	1	0	0	0	0	0	0	0	0	0	0	0	0	0	3	0	0	0	0	0	0	0	0	0	0	0	0	0	1	0	0	0	0	0	0	0	0	0	0	2	0	0	0	0	0	0	0	0	0	0	0	0	0	0	0	0	0	0	0	0	0	0	0	0	0	0	0	0	0	0	0	0	0	0	0	0	0	0	0	0	0	0	0	0	0	0	0	0	0	0	0	0	0	0	0	0	0	0	0	0	0	0	0	0	0	0	0	0	0	0	0	0	0	0	0	0	0	0	1	0	0	1	0	0	0	0	0	0	0	0	0	0	0	0	1	1	1	0	0	0	0	0	0	0	0	0	0	0	0	0	0	1	0	0	0	0	0	0	0	0	0	0	0	0	1	1	0	0	0	0	0	0	0	0	0	0	1	0	0	0	0	0	0	0	0	0	0	0	0	0	0	0	0	0	0	0	0	0	0	0	0	0	0	0	0	0	0	0	0	0	0	0	0	0	0	0	1	0	0	0	0	0	0	0	1	0	0	0	0	0	0	0	0	0	1	0	0	0	0	0	0	0	0	0	0	0	0	0	0	0	0	0	1	0	0	0	0	0	0	0	0	0	0	1	0	0	0	0	0	0	0	0	0	0	0	0	0	0	0	0	0	0	0	0	0	0	0	0	0	0	0	0	0	0	0	0	0	0	0	0	0	0	0	0	0	0	0	0	0	1	0	0	0	0	0	0	0	0	0	0	0	0	0	0	0	1	0	0	0	1	0	0	0	0	0	0	0	0	0	0	0	0	0	0	0	0	0	0	0	0	0	0	1	0	0	0	0	0	0	0	2	0	0	0	0	0	0	0	0	0	0	0	0	0	0	0	0	0	0	0	0	0	0	1	0	0	0	0	0	0	0	0	0	0	0	0	0	0	0	0	0	0	0	0	0	0	0	0	0	0	0	0	0	1	0	0	2	0	0	0	0	0	1	0	0	0	0	0	0	0	1	0	0	0	0	0	0	3	0	0	0	0	0	2	2	3	0	2	4	0	0	0	2	0	0	0	0	1	6	0	0	0	0	2	1	1	0	0	0	0	0	2	0	1	0	0	0	0	0	1	0	0	0	0	0	1	0	0	0	0	0	0	0	0	3	0	0	1	0	0	0	0	0	0	0	0	0	0	0	1	0	0	0	2	0	6	0	0	0	0	0	1	0	0	0	0	0	0	1	0	0	0	0	0	0	0	5	2	0	0	0	0	0	0	3	2	0	1	0	0	0	0	2	3	0	0	0	0	0	4	0	0	0	0	0	0	0	0	0	6	0	1	0	0	0	0	0	0	2	0	0	0	0	1	0	0	1	0	0	0	0	1	0	0	0	0	0	0	0	0	0	0	0	0	0	0	0	0	1	0	0	0	0	0	0	0	0	0	0	0	0	0	0	0	0	0	0	0	0	0	0	0	0	0	0	0	0	0	0	1	0	0	0	0	0	0	0	0	1	0	0	0	0	2	0	0	0	0	0	0	0	0	0	0	0	0	0	1	0	0	0	0	0	0	0	0	0	0	0	0	0	0	0	0	0	0	0	1	1	0	0	0	0	0	0	0	1	0	0	0	0	0	0	0	0	1	0	0	0	3	0	0	0	0	1	0	0	6	0	1	0	0	0	0	1	0	0	0	0	0	0	0	0	0	3	0	0	1	0	2	0	0	0	0	0	0	2	1	0	0	0	0	0	1	0	0	0	0	0	0	0	0	0	0	0	0	0	4	0	0	0	0	0	0	0	0	0	0	0	0	0	0	0	0	1	0	0	0	0	0	3	0	0	0	0	0	0	0	6	0	0	0	0	0	0	0	0	0	0	0	0	0	0	0	0	0	1	0	0	0	0	0	0	0	0	0	0	0	0	0	1	0	3	0	2	0	0	0	0	0	0	0	0	0	0	1	1	0	0	0	0	0	0	6	9	0	0	0	0	9	0	10	0	0	0	0	0	0	0	0	0	17	0	0	0	0	0	1	0	0	0	0	0	2	0	4	0	0	0	1	0	1	0	1	0	1	1	0	0	0	0	0	5	1	0	0	1	0	8	3	0	0	0	1	0	0	1	0	0	0	0	0	0	1	18	0	0	0	5	0	0	8	6	0	0	2	0	0	1	0	0	2	0	0	0	0	0	0	1	0	0	0	0	0	0	0	0	0	0	0	0	0	0	0	0	6	0	0	0	0	1	0	0	0	0	0	0	0	1	1	0	0	1	1	0	0	0	0	0	0	1	1	0	0	0	0	0	0	1	0	0	0	0	0	0	0	0	0	1	0	0	0	1	0	0	0	0	0	0	0	0	0	0	0	0	0	0	2	2	2	10	0	0	0	0	1	0	0	0	0	0	2	0	1	0	1	0	0	0	0	3	0	2	0	9	3	0	7	1	13	0	0	18	0	3	36	0	6	1	0	0	0	0	0	0	0	0	0	0	3	0	0	0	0	0	0	0	0	1	0	1	1	2	1	0	0	0	0	0	0	0	0	0	1	0	0	5	0	1	2	0	1	0	0	1	1	3	7	4	4	0	0	6	0	7	1	1	8	0	1	1	0	0	0	0	0	0	0	0	0	1	0	2	1	6	0	0	0	3	0	1	0	0	1	0	1	0	5	0	9	0	0	0	1	2	0	0	2	10	2	0	0	0	0	1	2	0	1	0	2	1	1	7	1	3	4	1	0	3	5	0	1	46	0	0	0	1	0	1	0	0	3	1	1	0	0	4	0	0	19	1	2	0	0	0	0	0	0	0	2	0	0	3	5	1	3	0	2	0	0	9	0	1	0	13	0	0	13	2	6	0	0	0	1	1	0	0	0	0	0	0	0	0	0	0	0	4	0	4	2	0	0	0	0	0	1	0	0	0	9	1	0	3	0	7	0	0	0	1	0	3	0	2	0	2	2	4	1	0	0	1	0	0	1	0	10	0	0	0	3	0	1	7	2	0	1	1	0	0	0	0	0	0	0	0	1	0	0	0	0	23	0	0	0	3	4	0	0	3	0	0	0	0	0	0	0	0	1	0	0	0	0	0	0	0	0	0	0	0	0	0	0	0	1	0	0	0	1	0	0	1	0	0	0	0	0	0	0	0	0	2	0	0	0	0	0	0	1	0	6	0	0	2	1	1	0	2	1	0	0	1	0	0	0	0	0	0	0	0	1	0	0	0	0	0	1	0	0	0	5	0	0	1	0	0	0	0	0	0	0	0	0	0	1	0	2	3	1	0	0	1	0	0	0	4	0	0	0	0	0	0	0	0	0	0	0	0	0	0	0	0	0	2	0	0	0	0	0	0	0	0	0	0	0	0	0	0	0	0	0	0	0	0	0	0	0	1	0	0	0	0	0	0	0	0	0	0	0	0	0	0	0	0	0	0	2	0	0	0	0	1	0	0	0	0	0	0	0	0	0	1	0	0	0	0	0	0	0	0	1	0	1	0	0	0	0	0	0	0	0	0	0	0	0	0	0	0	0	0	0	0	0	0	0	0	0	0	0	0	0	0	0	0	0	0	0	0	0	0	0	0	0	0	0	0	0	0	0	0	0	0	0	1	0	0	0	0	0	0	0	0	0	0	0	1	0	0	3	0	0	0	0	0	0	0	0	0	0	0	1	0	0	0	0	0	1	0	0	1	0	0	0	0	0	0	0	0	0	0	0	0	0	9	0	0	0	0	0	0	1	0	0	0	0	0	0	0	1	0	0	0	0	0	1	0	1	1	0	1	0	0	0	0	1	0	0	1	0	0	0	1	0	0	0	0	0	0	0	0	1	0	0	0	1	0	0	0	0	0	0	0	0	0	0	0	0	0	0	0	0	0	0	1	0	0	0	0	0	1	0	0	0	0	0	0	0	1	0	0	0	0	0	1	1	13	0	0	0	1	1	1	1	1	1	2	0	0	4	0	1	12	0	1	1	1	0	0	0	1	0	0	1	0	1	0	16	0	0	0	0	0	0	0	0	0	0	0	0	0	0	1	0	0	4	0	0	0	0	3	0	0	0	0	0	0	0	0	3	2	4	0	0	1	1	1	0	0	1	1	0	0	0	0	0	0	1	0	1	0	0	0	3	0	0	1	0	0	1	0	0	0	2	0	1	1	0	0	0	0	0	0	4	0	1	0	0	1	5	0	0	0	2	2	0	0	0	0	0	0	0	0	0	0	0	0	1	0	0	0	1	0	0	0	0	0	0	0	0	1	0	0	0	0	0	0	0	0	0	0	0	0	0	0	0	0	0	0	0	0	0	0	0	0	0	0	0	0	0	0	0	0	0	0	0	0	0	0	0	0	0	0	0	0	0
PHYLLO10	18192	0	0	0	63	360	46	0	137	0	0	16	19	0	57	1	0	2	0	1	0	0	0	0	24	0	0	3	2	2	3	0	0	12	0	7	4	0	0	0	0	0	0	0	3	0	0	0	0	3	0	0	4	27	37	0	214	1	3	0	21	0	1	4	8	20	0	3	1	0	3	2	0	0	0	0	0	0	0	0	0	0	47	70	14	18	1	16	0	4	0	24	13	17	5	13	26	0	20	0	0	90	0	34	0	14	33	0	2	1	3	0	4	9	2	17	28	4	0	0	22	2	20	0	3	58	33	35	3	7	4	2	0	1	2	0	0	64	5	0	3	25	13	2	0	6	5	1	6	8	0	1	0	3	0	0	0	0	19	10	6	0	0	19	0	13	8	15	14	4	0	5	6	5	4	0	0	1	7	0	4	2	10	4	1	36	7	0	0	0	0	4	0	1	1	1	7	12	1	0	4	3	1	6	3	11	0	15	0	1	20	3	8	0	67	98	0	46	1	9	0	6	5	5	34	0	25	11	8	1	8	5	0	8	0	0	5	0	39	0	6	3	20	9	0	2	0	2	10	7	0	0	25	4	18	1	1	4	16	1	0	3	2	0	1	0	7	6	32	3	3	1	11	1	7	0	0	13	0	6	14	0	3	6	39	21	0	0	2	0	14	0	0	0	21	0	23	0	1	4	0	8	18	1	0	0	0	33	7	7	42	1	10	2	2	3	0	4	0	10	0	7	3	1	0	1	0	2	6	0	0	12	0	0	6	0	0	0	0	1	52	4	1	96	78	2	0	0	9	2	0	2	2	5	9	0	1	16	3	3	1	8	1	2	0	0	4	11	2	9	0	7	1	4	1	6	11	4	2	22	6	9	7	3	0	1	28	19	22	1	70	0	0	0	0	0	0	10	181	0	5	1	12	0	72	21	0	0	3	8	34	26	0	0	0	0	1	0	0	8	35	7	0	0	21	1	6	22	68	0	2	4	1	0	1	6	34	2	3	2	40	1	11	14	10	16	20	10	13	0	4	20	29	6	27	8	3	197	7	2	0	0	0	0	0	0	0	0	0	0	1	0	0	0	0	2	2	0	0	0	8	0	0	5	1	0	0	0	0	1	0	0	1	0	4	0	0	1	0	0	0	0	0	0	0	0	0	0	0	2	0	3	0	0	21	44	15	4	29	3	4	82	2	13	24	0	79	0	38	1	0	0	3	1	1	0	18	3	8	23	2	4	0	3	8	20	9	2	0	0	0	2	3	7	4	3	1	28	13	19	6	4	0	10	6	0	0	0	0	12	2	2	0	10	9	1	35	4	2	10	0	0	36	6	7	0	4	2	6	6	1	0	4	1	0	0	0	1	0	0	0	0	6	16	1	3	3	0	0	2	0	0	11	0	4	8	3	1	14	0	2	0	0	0	2	0	1	0	0	1	0	1	6	1	3	29	2	0	0	10	0	0	9	0	4	0	0	1	1	0	2	0	101	0	1	0	7	9	0	1	19	2	1	0	1	4	9	0	62	1	8	0	1	3	27	10	3	22	8	0	15	14	2	10	7	6	0	0	15	7	2	1	21	0	0	0	2	0	1	0	0	1	6	0	0	0	3	4	7	8	0	16	11	3	5	9	11	6	41	106	3	0	0	13	4	0	0	1	0	7	6	0	0	0	0	4	12	0	1	0	0	43	3	3	33	0	2	2	0	0	8	12	11	5	4	8	0	5	10	0	3	1	4	10	2	0	2	8	3	6	0	3	0	40	2	2	0	0	4	0	10	5	2	0	0	40	2	1	0	0	0	2	0	6	22	0	3	0	0	2	1	3	8	3	4	2	0	0	0	2	0	0	14	1	9	1	40	0	10	3	0	0	5	10	2	3	2	0	0	0	0	0	1	0	0	0	0	0	0	0	12	0	4	0	0	0	4	1	5	6	3	4	0	0	0	0	8	4	0	2	4	0	1	1	0	0	0	4	0	7	3	0	5	3	5	2	2	0	0	0	0	1	0	0	3	11	0	7	2	0	2	1	2	0	1	0	1	0	0	1	2	1	0	0	0	2	0	1	0	4	4	1	5	14	2	10	1	0	21	0	0	0	2	3	7	7	1	0	1	0	0	0	0	3	0	0	0	1	1	1	3	0	0	3	3	0	0	7	0	3	0	2	0	3	0	0	0	3	0	0	38	0	8	0	0	6	0	3	2	0	0	1	0	0	0	2	4	0	9	7	0	34	0	0	0	3	28	7	0	10	2	2	0	1	0	0	0	0	5	0	1	0	1	0	0	0	1	13	5	0	10	0	3	0	21	5	0	0	3	0	5	0	0	0	0	6	7	13	4	8	0	0	1	0	1	0	0	6	6	0	0	0	0	3	0	0	22	0	0	1	0	0	0	3	2	0	2	1	69	0	1	36	0	1	1	1	3	0	0	17	10	0	6	0	1	2	2	1	1	3	0	8	3	2	8	2	4	12	4	0	1	0	2	1	2	0	6	0	5	4	18	14	6	5	10	2	7	6	14	7	0	3	17	3	14	3	2	5	3	6	8	0	3	27	0	16	39	0	0	2	5	3	2	1	0	1	0	0	0	4	3	12	6	27	10	14	4	0	30	31	0	1	11	4	7	0	11	0	1	24	5	0	1	0	7	5	0	36	0	2	0	4	0	0	0	0	4	0	0	0	0	1	0	0	2	3	0	1	5	0	2	0	0	1	3	0	9	0	2	0	1	0	1	29	0	0	0	23	0	3	9	2	0	3	0	1	0	0	0	28	1	1	0	5	4	0	0	1	5	0	1	0	0	0	0	0	0	2	0	2	0	0	4	3	0	0	1	0	2	0	2	0	6	1	3	5	1	10	1	0	0	0	3	6	0	0	0	0	0	2	15	0	0	8	37	0	2	0	1	0	0	0	0	1	0	4	0	0	1	0	37	0	2	0	0	2	0	3	0	0	0	1	8	6	0	0	0	1	0	1	0	1	0	1	0	0	1	2	0	5	1	0	0	3	18	2	0	0	0	0	2	0	4	28	0	2	0	0	0	0	0	0	2	0	16	0	0	8	0	0	0	0	0	0	0	0	0	0	0	3	0	1	5	37	4	2	0	9	0	0	0	2	4	1	11	0	1	0	1	0	1	1	0	0	0	0	0	0	0	0	0	0	0	0	0	0	0	0	4	0	0	0	0	1	2	1	0	1	0	0	0	2	1	0	5	0	0	1	0	0	6	2	0	1	0	0	0	2	0	12	1	0	1	0	0	0	0	3	0	0	2	1	0	0	0	3	2	0	1	6	0	0	0	0	0	16	0	0	3	1	0	0	17	1	2	2	0	0	0	3	2	0	0	0	0	0	0	0	0	0	0	0	0	8	0	7	0	0	0	1	1	0	0	0	0	0	0	1	0	0	3	0	5	2	7	0	4	0	0	0	3	14	0	0	0	1	1	1	7	0	0	0	19	3	0	1	1	0	0	0	0	0	0	0	0	0	0	0	0	0	5	18	2	1	21	7	0	0	0	0	0	67	0	0	0	0	0	2	0	0	0	2	8	2	0	7	4	1	3	2	0	0	0	1	0	1	6	0	2	0	4	0	0	1	0	0	0	2	1	0	0	11	0	2	3	3	0	0	0	1	0	3	1	4	2	0	1	0	2	0	0	1	4	6	9	4	0	0	2	0	0	0	0	0	0	15	1	2	0	0	0	4	1	0	2	0	3	1	0	3	5	0	0	0	2	0	8	2	0	0	1	32	0	1	263	0	4	1	2	6	0	0	1	8	4	2	5	0	1	5	3	1	0	0	5	1	0	1	14	0	1	3	3	1	20	1	0	5	0	0	0	10	0	0	0	0	0	1	4	1	0	7	13	1	0	0	0	2	0	0	0	0	0	0	0	1	4	1	0	0	3	12	0	0	2	0	0	2	2	1	2	1	3	0	0	2	0	1	6	3	5	3	1	0	0	0	0	1	3	4	0	0	0	0	2	0	0	3	34	0	0	2	1	0	1	7	0	0	1	3	1	3	0	5	1	4	0	0	1	10	1	0	1	2	0	0	0	24	0	1	1	1	2	0	0	1	8	12	0	1	7	0	0	3	3	8	0	0	1	0	0	6	0	19	8	9	0	0	1	2	10	0	0	29	0	1	4	0	0	7	7	22	75	74	4	5	8	11	9	4	0	35	20	1	13	9	16	34	18	0	1	10	0	0	0	0	0	1	0	4	16	11	0	4	0	7	35	2	2	0	7	0	33	25	0	33	0	0	0	0	0	11	17	6	0	0	2	2	0	0	12	0	25	0	0	0	0	3	14	0	0	7	1	39	15	0	7	7	7	9	6	0	0	4	4	2	0	0	6	18	7	4	0	6	1	3	1	0	0	0	4	2	5	10	0	0	0	0	10	2	3	0	0	1	0	2	3	0	0	8	0	0	0	0	0	1	0	0	24	1	0	1	9	0	0	0	0	0	0	8	1	0	0	0	0	0	0	0	0	0	0	0	2	0	0	3	0	0	0	0	5	3	0	2	0	4	0	0	2	2	0	3	0	0	1	9	1	0	1	0	0	0	2	0	0	0	0	0	0	0	0	0	0	1	2	0	0	0	1	2	13	0	1	4	7	7	0	1	0	0	29	0	0	0	0	7	0	5	107	11	0	3	0	0	0	0	0	6	0	0	0	0	0	4	0	1	0	1	0	4	0	4	0	0	3	0	1	0	0	0	2	0	1	0	5	0	8	0	0	0	0	0	0	0	0	2	0	0	0	1	0	0	1	0	4	3	0	0	0	0	0	0	3	0	0	0	0	0	0	1	4	4	0	0	0	0	2	0	4	1	4	4	0	1	0	2	6	7	0	1	0	0	0	0	1	6	0	0	2	1	0	7	0	0	0	0	0	0	12	0	0	0	1	0	1	4	0	0	0	0	0	0	70	0	0	0	0	0	0	9	4	0	0	0	0	0	1	8	0	0	0	1	0	1	0	0	2	0	1	31	5	6	11	5	3	1	0	1	2	0	0	0	2	3	10	13	4	0	0	0	93	0	9	0	0	0	0	9	2	8	0	11	11	7	10	0	0	0	0	0	0	0	0	0	0	0	38	0	0	0	0	0	0	0	4	1	0	1	5	0	1	0	1	0	0	0	0	17	9	1	1	0	1	0	1	0	0	0	1	2	1	0	0	0	0	3	0	2	0	0	0	0	0	1	1	0	0	2	0	2	1	0	0	0	0	0	5	0	5	1	1	0	1	0	0	0	5	0	0	0	2	0	0	0	0	0	0	0	0	1	0	0	2	0	0	0	0	0	0	0	14	0	0	0	3	3	0	0	9	11	8	7	0	7	0	0	0	0	8	0	3	9	9	0	0	3	10	9	1	0	0	1	1	0	3	0	1	8	2	8	1	0	0	2	1	0	0	0	1	2	53	0	0	0	4	0	12	1	0	0	0	15	1	3	0	0	4	1	6	4	0	0	0	0	0	0	0	2	0	0	0	0	0	4	0	0	0	0	2	0	0	1	0	1	1	0	0	0	0	0	0	0	0	1	0	0	0	0	0	0	0	0	0	3	0	1	0	0	0	1	0	0	0	0	0	0	0	2	0	0	2	0	0	2	0	0	0	1	0	0	3	0	0	0	0	0	0	0	0	0	0	0	2	0	0	0	2	0	3	0	1	0	0	1	2	1	0	0	2	0	0	0	0	0	8	1	7	6	23	3	1	1	12	0	0	0	0	4	2	1	0	2	3	7	1	0	1	3	0	2	0	0	0	0	1	0	0	0	9	0	0	4	1	1	0	1	0	0	0	0	0	0	0	3	0	0	0	0	0	0	1	1	0	0	0	0	1	0	0	0	0	8	8	2	0	0	0	0	0	0	2	0	0	58	0	0	0	1	0	0	0	0	0	0	0	5	0	0	9	0	0	1	0	0	0	0	2	0	0	0	0	1	0	0	1	7	0	0	0	0	0	5	0	0	0	4	0	0	0	0	0	0	0	5	1	0	1	0	0	0	0	0	3	0	0	0	1	0	0	1	0	0	0	0	0	0	1	0	0	0	0	0	0	0	0	4	0	3	0	3	0	4	0	0	0	0	0	0	0	1	10	0	1	0	0	0	0	0	0	0	0	0	0	0	0	0	2	0	0	0	0	0	0	0	0	0	0	0	0	0	0	0	0	0	0	1	2	1	0	0	0	1	0	5	0	0	0	0	0	0	0	0	1	0	0	0	0	2	6	0	4	0	0	0	0	0	0	0	0	0	1	0	0	0	0	1	3	0	1	0	5	1	0	51	0	0	0	6	0	0	0	0	1	0	5	0	9	0	0	0	0	0	0	9	0	0	1	0	1	1	0	0	1	2	3	0	0	0	0	2	1	0	0	0	3	2	1	0	1	0	1	0	14	0	1	0	0	0	1	0	0	0	2	0	2	1	3	0	1	0	0	0	2	0	0	12	0	0	0	0	0	5	0	4	3	1	0	0	12	0	0	0	2	0	0	0	0	0	0	0	0	0	0	0	0	1	0	0	0	0	0	0	0	2	0	0	1	1	3	0	0	0	0	0	3	1	2	0	1	1	0	0	0	0	1	28	0	0	0	0	0	0	0	0	1	0	0	0	0	1	0	0	6	31	7	3	0	1	3	0	0	22	17	17	0	17	0	0	2	0	0	0	0	0	0	0	0	0	11	0	0	0	0	0	24	0	0	0	0	2	0	0	0	0	0	0	1	0	0	0	0	0	0	0	0	1	1	1	0	40	0	0	0	15	0	0	0	0	7	0	33	0	0	0	0	0	0	0	0	0	0	0	0	0	0	0	4	0	0	0	0	0	17	0	0	0	0	0	2	0	0	0	0	0	0	0	0	0	0	0	0	1	0	0	0	0	0	0	8	3	0	0	0	0	0	0	0	25	0	0	1	0	0	0	0	0	0	9	0	0	0	0	0	0	0	0	0	0	0	17	0	0	4	0	0	0	0	0	0	0	0	0	0	0	0	0	0	0	0	0	3	0	0	0	1	0	3	0	0	3	0	3	0	2	3	0	3	0	0	1	0	1	7	0	1	0	0	0	1	8	1	0	0	0	0	0	0	0	1	1	0	8	8	0	9	0	0	0	0	0	0	1	0	0	0	0	0	1	0	0	0	0	0	0	0	0	0	0	2	4	0	0	0	0	0	0	0	1	0	0	0	0	1	0	2	0	0	0	0	1	0	0	0	0	1	1	0	0	0	0	0	0	0	0	1	0	0	0	0	1	0	0	0	0	2	0	0	2	3	0	1	0	0	2	0	0	0	1	0	0	33	0	0	0	1	1	0	0	0	2	5	0	1	2	0	0	0	0	0	0	0	3	5	0	6	1	6	15	2	11	0	10	1	0	0	0	12	0	4	2	0	0	0	0	13	1	1	1	7	2	1	3	0	5	0	2	0	0	0	0	1	0	0	0	0	3	0	0	0	1	0	0	0	0	1	0	3	0	0	0	0	1	0	0	0	0	0	4	0	0	0	0	2	0	14	0	5	0	2	0	0	1	0	0	0	0	0	0	0	1	2	0	0	2	1	7	1	0	0	0	0	1	0	0	0	0	21	0	1	2	0	2	0	0	0	1	0	0	0	0	4	1	1	0	1	1	0	0	0	0	1	0	42	1	0	0	1	0	0	0	0	0	1	1	44	3	0	6	0	0	0	0	0	0	0	0	0	2	0	1	2	0	1	0	0	0	6	0	0	0	0	0	3	1	6	0	0	1	0	0	0	3	2	0	0	0	0	0	2	0	0	0	0	2	2	1	1	0	0	0	0	0	0	0	0	2	0	4	0	0	1	0	0	0	0	0	0	11	1	0	3	0	1	0	0	0	0	0	0	4	0	0	0	0	0	0	0	0	0	0	2	13	0	0	0	0	0	1	0	4	1	0	0	1	0	4	0	0	0	0	0	0	1	0	0	0	0	0	0	0	0	0	0	1	0	0	0	0	0	3	0	0	7	0	5	0	0	1	15	3	0	1	1	1	0	0	4	0	0	3	0	0	0	1	0	0	0	0	1	0	0	0	0	0	0	0	0	0	0	0	0	0	4	0	0	0	0	0	0	0	4	2	0	0	0	0	0	1	0	0	0	0	0	1	0	0	1	2	0	9	1	0	0	0	0	0	1	0	0	0	0	0	1	1	0	0	0	0	0	0	2	0	0	2	0	1	0	0	0	1	0	0	0	0	0	0	0	0	0	0	0	0	5	1	1	0	0	0	0	1	0	0	0	0	0	3	1	0	1	0	0	0	0	0	0	0	0	1	5	5	0	0	0	0	0	0	2	0	0	0	0	0	0	0	0	0	2	0	0	3	1	0	0	0	0	0	0	0	0	0	0	2	11	0	0	0	5	0	0	0	0	1	1	0	0	0	0	0	0	1	3	0	0	0	2	0	0	0	0	0	0	0	0	0	0	0	1	0	0	0	0	0	1	2	0	0	0	4	0	5	0	0	9	1	0	0	0	0	0	5	0	0	9	0	2	0	1	0	0	0	1	8	0	0	0	1	0	0	0	0	0	8	8	0	0	0	0	1	2	0	0	0	0	0	0	0	0	0	0	0	1	0	0	0	0	0	0	0	0	0	0	0	0	0	0	0	0	0	0	0	0	0	0	0	0	1	1	0	10	1	0	0	13	0	0	0	0	0	0	0	0	0	5	0	0	0	0	0	1	4	0	0	0	0	1	0	0	1	0	0	2	0	0	0	0	0	0	2	0	0	1	7	0	0	0	1	0	0	5	0	0	0	0	0	0	9	1	0	0	1	0	0	0	9	0	0	0	0	0	0	0	1	0	4	0	0	0	0	0	2	0	0	0	0	0	0	0	0	0	0	12	0	3	0	4	0	0	0	10	3	3	0	1	3	0	0	0	0	0	0	0	0	0	0	0	0	0	0	1	0	0	0	0	0	0	0	0	0	0	0	0	0	0	0	0	0	0	3	0	0	0	0	1	0	0	0	0	0	0	0	1	1	1	0	1	0	0	0	0	1	0	0	0	0	1	0	0	0	7	6	0	0	0	0	0	0	1	2	10	0	0	0	0	0	0	0	0	0	0	0	0	1	0	0	0	0	0	1	0	0	0	0	0	0	0	0	0	0	0	1	0	0	2	0	1	0	0	0	0	0	2	0	0	0	1	1	0	0	0	3	0	0	0	1	0	0	0	0	0	14	0	0	0	0	0	0	0	0	0	0	0	0	0	0	0	0	1	0	0	3	0	0	0	0	0	1	0	0	2	5	0	0	0	0	0	0	0	0	0	3	0	0	0	2	0	17	0	0	0	0	0	0	0	1	0	0	1	0	0	1	0	0	1	0	0	0	0	0	0	0	0	0	0	0	0	0	0	0	0	0	0	0	0	0	1	0	0	0	0	0	0	0	0	0	0	0	1	0	0	0	0	0	0	0	0	0	0	0	0	0	1	7	1	2	0	0	0	0	0	0	0	0	0	0	0	0	0	0	0	0	0	0	0	0	0	0	0	0	5	0	0	1	0	2	6	2	0	0	3	0	0	2	0	0	16	20	5	4	3	0	0	0	3	0	0	0	3	0	2	0	0	0	8	8	4	0	5	0	0	0	0	0	2	0	0	0	1	0	0	1	0	0	0	0	4	0	0	0	0	0	0	0	0	1	0	0	0	0	1	0	0	0	0	0	0	0	2	0	1	0	0	0	0	0	0	0	0	0	0	0	0	0	0	0	0	0	0	0	0	0	0	0	0	2	0	1	0	0	5	0	1	1	1	35	0	0	0	4	0	0	1	7	0	0	12	0	0	1	2	5	23	0	17	0	168	5	1	2	2	2	0	0	0	0	0	3	8	0	0	0	1	219	0	12	0	18	2	2	42	2	0	5	15	36	11	11	33	0	0	1	0	2	0	0	0	0	0	0	0	0	0	0	3	0	0	0	1	0	0	0	0	0	3	1	0	1	0	0	1	0	1	1	0	0	0	1	0	0	0	0	2	0	0	0	0	0	0	0	0	0	0	0	0	0	0	0	0	0	0	0	0	5	1	0	1	0	1	0	0	1	1	0	0	5	0	1	0	0	0	0	3	0	0	4	0	1	0	0	1	0	0	0	0	0	0	0	0	1	6	0	0	0	0	0	1	0	1	0	0	0	7	0	6	0	24	0	0	0	2	0	40	0	0	0	0	6	46	1	2	57	0	0	0	0	0	0	0	7	0	0	0	0	0	5	0	3	0	5	0	0	3	2	0	0	0	0	0	0	0	0	0	0	0	0	0	0	0	0	0	0	0	0	4	1	0	0	0	0	0	1	0	0	0	0	0	0	0	0	0	0	0	0	0	0	0	0	0	4	1	0	0	5	0	0	0	0	0	5	0	0	0	0	0	0	0	0	0	0	1	0	0	3	1	71	8	0	0	2	21	35	0	5	1	0	0	4	0	1	3	0	0	5	1	25	3	2	0	0	0	0	0	1	1	6	1	1	0	0	0	0	2	0	0	0	0	0	0	0	0	0	0	2	0	0	0	2	2	0	1	0	0	1	4	0	1	1	1	0	2	0	0	0	15	0	0	0	0	1	0	1	0	0	7	0	0	0	0	0	0	0	0	2	0	11	0	0	0	3	0	0	0	1	4	0	1	0	1	0	0	0	1	0	0	0	0	0	0	0	0	6	1	0	1	5	4	0	6	121	57	0	2	0	0	0	4	0	2	6	0	0	0	0	1	0	0	0	0	0	0	0	0	1	0	0	0	5	0	1	6	0	1	4	0	0	0	1	0	0	0	0	0	0	0	0	1	0	0	0	0	2	2	1	0	0	3	1	1	0	0	12	0	10	4	12	1	0	1	0	0	0	0	0	0	0	0	0	0	0	0	0	0	0	0	0	0	0	0	0	0	0	0	0	0	0	0	0	0	0	0	0	0	0	0	0	0	0	0	0	0	0	0	1	0	0	0	0	0	0	0	0	0	0	0	0	0	0	0	0	0	0	0	0	0	0	0	0	0	0	0	0	0	0	0	0	0	0	0	5	50	0	5	2	0	0	0	3	0	0	0	0	0	0	0	0	0	0	0	0	0	0	0	0	3	2	0	0	3	0	1	0	0	0	0	0	0	0	0	0	0	0	0	0	1	0	0	0	0	0	0	1	3	0	0	0	0	0	0	0	0	0	1	0	0	0	1	1	0	0	0	0	0	0	0	0	0	0	0	3	0	0	0	0	2	0	0	0	0	0	0	0	0	0	0	0	0	0	0	0	0	0	0	4	0	0	0	0	0	0	0	0	0	1	1	0	0	1	0	0	0	2	2	0	0	2	0	0	0	0	0	0	0	0	0	0	0	0	0	0	0	0	0	0	1	0	0	0	0	0	1	1	0	0	0	0	3	0	0	0	0	0	0	0	0	0	0	0	0	0	0	0	0	0	1	0	0	0	0	0	0	0	0	0	0	0	0	0	0	54	3	0	0	0	0	0	0	0	0	0	0	0	1	1	0	0	0	0	0	0	0	0	0	0	0	2	0	0	0	0	1	1	0	0	0	0	0	0	0	0	0	0	1	0	0	1	1	0	0	0	0	0	0	1	0	0	0	0	0	0	0	0	0	0	2	0	0	0	0	0	0	0	0	0	2	0	0	0	0	0	0	0	0	0	0	1	0	0	0	0	0	0	0	1	1	0	0	0	0	0	2	0	1	2	0	0	0	0	0	0	0	0	2	1	14	5	0	0	28	0	0	0	0	0	1	2	0	1	0	0	0	0	0	0	0	2	0	0	1	0	0	0	0	0	4	0	4	0	2	0	0	0	0	0	0	0	3	6	0	0	0	1	8	0	0	0	0	0	0	1	0	0	0	0	1	2	1	0	0	0	0	0	0	0	0	0	0	0	1	0	0	0	0	0	0	0	0	1	0	0	0	0	0	0	0	0	0	0	0	0	0	0	0	0	0	0	0	0	0	0	0	1	1	0	0	0	0	0	0	0	0	2	0	0	0	0	0	0	0	0	0	0	0	0	0	0	0	0	0	0	4	1	2	1	0	0	0	0	0	0	0	0	0	0	2	0	0	0	0	0	0	0	0	0	0	0	0	0	0	0	0	1	0	0	2	0	0	1	0	0	1	8	0	0	2	0	2	0	2	0	0	0	0	0	0	0	0	0	0	0	0	0	0	0	0	0	0	0	0	1	1	0	0	0	0	0	0	0	0	0	0	0	0	0	0	0	0	0	0	0	0	0	0	0	0	0	0	1	0	0	0	1	0	2	0	0	1	1	2	0	0	0	0	0	2	1	0	1	0	0	0	0	0	0	0	0	0	1	0	0	0	2	0	0	0	0	0	0	0	0	0	0	0	0	0	0	0	0	1	0	1	0	0	0	0	0	2	0	0	0	0	0	0	1	0	0	0	0	0	0	0	0	0	0	0	0	0	0	2	0	1	0	0	0	1	0	0	0	1	0	0	1	10	1	0	0	1	0	1	2	0	0	0	0	0	0	0	7	0	0	0	0	0	0	0	0	0	0	0	0	0	0	0	1	0	0	0	0	0	0	0	0	0	0	0	0	0	0	1	1	0	0	0	0	0	0	0	0	0	0	0	0	0	1	0	6	0	2	0	0	1	0	1	0	3	0	0	0	0	10	0	0	0	0	0	0	0	0	0	1	33	0	0	0	0	0	0	0	1	0	2	0	0	0	0	0	0	0	0	0	14	0	0	0	0	0	0	0	0	0	0	0	0	0	0	0	0	0	0	0	0	0	0	0	0	0	0	0	0	0	0	0	0	2	0	0	0	0	0	0	0	0	2	0	2	0	0	0	0	0	0	0	0	0	0	0	0	0	0	0	0	0	0	0	0	0	0	0	0	5	1	0	1	0	0	0	0	0	0	0	0	0	0	0	0	0	0	0	0	0	0	0	0	3	0	0	0	0	0	0	0	0	0	0	17	0	0	0	0	0	0	4	1	0	1	0	0	0	0	0	3	2	6	1	5	6	0	0	3	0	0	42	0	0	0	0	3	0	0	1	0	0	0	0	0	0	6	1	0	0	0	0	0	0	0	0	0	0	0	0	0	0	2	0	2	0	0	0	0	2	0	0	11	0	0	0	0	1	0	0	0	0	0	0	0	2	1	0	0	4	0	5	0	1	0	0	0	0	3	5	0	2	0	0	0	0	0	1	31	0	7	0	0	0	0	0	0	0	0	0	0	0	0	2	0	0	0	0	0	0	0	0	1	0	0	0	0	1	0	1	0	1	0	0	0	0	0	0	2	0	0	0	0	0	0	0	0	0	0	0	0	0	0	0	0	0	0	0	0	0	0	0	0	0	0	0	0	0	0	0	0	0	0	0	0	0	0	0	1	0	0	0	0	0	0	0	0	0	0	0	0	0	0	0	1	0	0	0	0	0	0	0	0	0	0	0	0	0	0	0	0	0	0	0	0	0	0	0	0	0	0	0	0	0	0	0	0	0	0	0	0	0	0	0	0	0	0	0	5	0	0	0	0	0	0	0	0	1	0	0	0	0	0	3	0	0	0	1	0	0	0	0	0	1	0	0	0	0	4	0	0	1	0	0	0	0	0	2	0	0	1	0	0	0	0	0	0	0	0	3	0	0	0	0	1	0	0	0	4	0	0	0	0	0	0	0	0	0	0	0	0	0	0	0	0	0	0	0	0	0	0	0	0	0	0	0	0	0	0	0	0	0	0	0	1	0	0	0	0	0	0	0	1	0	0	1	0	0	0	0	1	0	0	0	0	0	0	0	0	0	0	0	1	0	0	0	0	0	0	0	0	0	0	0	0	0	0	0	0	0	0	0	0	0	1	2	1	0	0	0	0	0	0	0	0	1	0	0	0	0	0	0	0	0	0	0	0	0	0	0	0	0	0	0	0	0	0	0	0	0	0	0	0	0	0	0	1	2	0	1	0	0	1	0	0	1	0	0	0	0	0	0	0	0	0	0	0	1	0	0	0	0	0	0	0	0	0	0	0	1	0	0	0	1	0	0	0	0	0	1	0	0	0	0	0	0	0	5	0	0	0	0	1	0	1	0	0	0	0	0	1	0	0	0	0	0	0	0	0	3	0	0	0	0	1	0	0	0	0	0	0	0	0	0	0	0	1	0	0	0	0	1	0	0	0	0	0	0	0	0	1	0	3	3	0	0	0	0	1	2	0	0	0	0	2	0	0	0	0	0	1	0	0	0	0	0	0	0	0	0	9	0	1	0	4	13	0	0	0	0	0	0	0	0	1	1	0	0	0	0	5	0	0	1	0	0	0	0	0	0	7	1	0	0	0	0	0	0	0	0	0	0	0	0	0	0	0	0	0	2	0	0	5	0	0	0	0	0	0	2	0	0	0	0	0	1	1	0	0	0	1	0	13	0	0	0	0	0	1	1	0	0	0	0	0	0	0	0	0	0	0	0	0	4	4	0	0	0	0	0	1	3	0	4	0	1	0	0	0	0	1	0	0	0	0	0	8	1	0	0	0	0	0	0	0	0	17	0	0	2	0	1	0	0	0	5	0	0	0	0	1	0	0	0	0	0	0	1	0	1	0	0	0	1	2	1	0	0	0	0	0	0	0	0	0	10	0	0	0	1	1	0	0	0	0	0	0	0	0	0	0	1	0	0	0	0	0	0	0	0	0	0	0	0	0	8	3	0	0	0	0	0	2	0	0	1	0	0	0	0	6	0	0	0	0	0	0	0	0	0	1	0	0	0	0	0	0	0	0	0	2	2	0	1	10	0	0	0	0	0	0	0	0	0	0	0	0	0	0	0	0	0	0	0	0	0	0	0	0	0	0	4	0	0	0	0	2	0	0	0	0	0	0	0	6	0	1	0	0	0	0	0	0	0	0	0	0	2	0	0	0	37	0	0	0	1	0	0	0	1	0	0	0	12	0	0	1	0	0	0	0	4	0	2	0	2	0	0	0	0	0	0	0	1	1	0	0	0	1	0	0	0	0	0	0	2	0	0	0	0	1	0	0	0	0	0	0	4	0	0	0	0	0	0	0	1	0	0	0	0	0	0	0	0	0	0	0	0	0	0	0	0	0	0	0	0	0	0	0	0	0	4	0	0	0	0	0	0	0	4	0	4	0	1	0	0	0	0	0	0	0	0	0	0	0	0	0	0	0	0	49	10	0	0	0	2	15	0	24	0	0	0	0	1	0	1	0	0	14	1	0	1	0	0	2	0	0	0	0	0	0	0	0	1	0	0	0	0	0	0	3	0	3	0	1	0	0	2	2	1	1	0	4	0	3	3	10	0	0	0	0	0	0	0	0	0	0	0	0	0	2	62	0	0	0	7	0	0	6	3	0	0	3	0	0	0	1	0	11	0	0	0	0	1	0	0	0	0	0	0	0	0	0	0	0	0	0	0	0	1	0	0	6	0	0	0	0	0	0	0	0	0	0	0	0	0	0	0	0	1	0	0	0	0	0	0	4	1	1	0	0	0	0	1	0	0	1	0	0	0	0	0	0	0	0	0	0	0	0	1	0	0	1	5	0	0	4	0	0	1	0	0	0	0	2	7	8	10	0	0	0	0	3	0	2	2	2	1	25	0	1	5	0	0	0	0	1	4	0	9	1	12	2	0	5	2	23	1	2	15	0	9	61	1	0	0	0	0	0	0	0	1	0	0	0	0	0	0	0	1	0	2	0	1	0	1	1	0	2	8	1	0	0	1	0	0	0	1	0	0	1	0	1	5	0	1	5	0	0	0	0	2	0	6	5	10	5	0	0	5	0	14	68	0	6	0	2	0	0	0	0	0	0	0	0	0	0	0	0	4	4	1	3	1	0	1	4	0	0	0	1	0	1	2	2	0	18	0	0	2	0	1	0	0	3	3	0	0	0	2	0	2	1	0	0	1	2	0	3	5	1	3	6	7	1	10	10	0	0	59	0	0	1	0	0	6	12	0	4	1	0	0	0	4	0	0	15	0	1	1	1	3	0	0	0	0	0	0	0	8	23	1	0	0	0	0	0	6	0	5	1	9	0	1	6	7	48	0	0	0	0	1	0	0	0	4	3	1	0	0	1	0	0	9	1	0	0	4	1	0	0	0	0	3	0	5	13	1	0	0	0	10	0	0	0	1	0	3	0	2	0	2	0	2	1	0	0	0	0	0	1	0	4	0	0	6	1	2	0	33	0	1	2	0	0	0	0	0	0	0	0	0	0	0	0	0	0	141	0	0	2	4	5	0	0	0	0	0	3	0	0	0	0	13	24	0	0	0	0	0	0	0	0	0	0	0	0	0	0	0	3	0	0	0	3	0	0	1	0	0	1	0	0	2	1	0	0	1	0	0	0	0	0	1	0	0	4	1	0	6	2	5	0	3	3	0	0	0	0	0	0	0	0	0	0	0	0	0	2	2	0	0	0	0	0	0	9	0	0	1	0	0	0	0	0	0	0	0	0	0	6	0	9	8	0	0	0	0	0	0	1	0	0	0	0	0	0	0	0	0	0	0	1	0	0	0	0	0	0	1	0	0	0	0	0	0	0	0	0	0	0	0	2	0	0	1	0	0	0	0	0	0	0	0	0	0	0	1	0	1	1	2	0	0	0	1	0	0	1	0	0	0	0	0	0	0	0	1	0	0	1	0	1	0	0	0	0	0	1	0	0	0	0	0	1	0	1	1	2	0	0	0	0	0	0	0	1	0	0	0	0	0	0	0	0	0	0	0	0	0	0	0	0	0	0	0	0	0	0	0	0	0	0	0	0	0	0	1	0	0	0	0	0	1	0	1	0	0	0	0	0	0	0	0	0	0	0	0	0	1	0	0	0	0	0	1	0	0	0	0	0	0	0	0	0	0	0	0	0	0	0	0	0	3	0	1	3	0	0	0	0	0	0	2	0	0	0	0	0	15	0	0	0	0	0	0	0	0	0	0	0	0	0	1	0	0	9	0	0	0	0	1	0	0	0	0	0	0	0	0	0	0	0	6	0	0	0	0	0	0	0	3	0	0	0	0	0	0	0	0	0	0	0	0	0	0	0	0	0	0	0	2	0	0	2	0	0	0	0	1	1	0	0	0	0	0	0	0	2	0	0	0	0	0	0	0	0	0	0	45	1	54	2	0	0	2	0	4	4	4	0	3	0	0	7	0	2	0	0	0	1	1	0	3	0	0	0	0	3	0	0	1	32	0	0	0	0	0	2	0	0	0	3	0	0	0	0	0	0	0	0	0	0	0	0	5	0	0	0	0	2	0	1	0	5	2	3	0	0	1	0	1	0	1	0	0	0	0	0	0	0	0	2	0	3	0	0	0	0	0	0	1	0	0	0	3	0	0	3	3	45	1	0	1	0	0	0	0	5	3	0	0	0	10	10	0	0	0	0	0	0	0	0	0	0	0	0	0	0	0	0	0	0	0	0	0	0	0	0	0	0	0	0	0	0	0	0	0	0	0	0	2	0	0	0	0	0	0	0	0	0	0	0	1	0	0	0	0	0	1	0	0	0	0	0	0	0	2	1	0	0	0	0	0	0	0	0	2	0	0	0
PHYLLO11	2266	1	1	0	7	39	5	2	14	0	0	1	0	0	1	0	0	0	0	0	3	1	0	0	0	4	0	4	0	1	1	0	2	0	0	0	1	0	0	0	2	0	0	1	0	0	0	0	0	1	5	0	1	6	13	0	14	0	3	1	21	0	0	0	1	6	0	1	0	0	1	0	0	0	2	0	0	1	0	0	0	0	11	4	3	3	0	0	0	1	0	7	4	7	2	0	3	2	12	1	1	2	0	9	0	1	4	0	6	2	0	0	1	0	0	2	0	10	1	0	4	1	0	0	0	9	3	5	0	0	0	0	0	0	6	3	0	4	6	3	1	1	8	0	3	2	3	0	2	1	0	0	0	0	0	0	0	0	1	0	1	0	0	3	0	1	2	3	0	0	1	0	0	0	0	1	0	2	0	2	2	0	1	2	0	1	7	0	0	1	0	1	0	0	0	0	1	4	0	0	0	0	0	0	0	0	0	0	0	0	5	0	0	0	8	19	0	1	0	0	0	0	4	2	2	1	1	1	1	0	4	0	0	2	0	0	0	0	3	0	1	0	7	1	0	1	0	0	1	0	0	0	2	0	0	0	1	0	3	0	2	0	0	0	0	2	0	2	2	0	0	0	1	0	1	0	0	0	0	1	3	1	1	0	8	2	0	0	1	1	0	0	0	0	1	0	1	0	0	0	2	0	3	4	0	0	0	1	1	0	5	3	0	0	1	0	0	10	0	0	0	1	0	0	0	0	0	0	0	0	2	0	0	0	0	1	0	2	0	0	2	1	0	3	6	0	0	0	0	0	0	0	3	0	0	0	1	0	0	0	0	1	0	0	0	0	1	1	0	1	0	1	4	0	0	4	2	0	0	2	2	2	1	0	0	0	4	1	0	0	8	0	1	0	12	0	9	5	10	1	1	0	6	0	8	3	0	0	1	0	1	1	0	0	0	0	0	0	0	0	6	0	0	0	3	0	0	0	2	0	0	0	0	0	0	0	4	0	0	0	6	0	1	0	0	3	2	1	2	0	0	0	2	0	6	1	0	11	2	1	9	2	42	9	25	9	9	0	1	0	0	2	0	1	2	0	0	0	2	0	2	0	2	0	1	0	0	0	0	0	0	0	3	0	0	0	0	0	0	0	0	0	0	2	0	0	0	0	1	1	0	0	0	0	3	9	15	1	2	1	0	2	0	1	4	0	7	0	0	1	0	0	0	0	2	3	3	1	4	1	0	1	0	1	1	11	0	1	0	1	0	1	0	0	5	2	0	1	3	1	0	0	0	0	2	0	0	0	0	1	2	0	0	0	0	0	4	0	0	2	0	0	0	2	1	0	0	1	0	1	0	2	0	2	0	0	1	0	0	0	0	0	1	5	0	0	0	2	0	0	0	0	0	0	0	0	2	0	6	0	2	0	0	0	0	0	0	0	0	0	0	0	0	0	1	4	1	0	0	0	0	0	2	0	3	0	0	0	0	0	1	0	9	0	0	0	0	1	0	0	1	0	0	0	1	0	1	1	2	0	5	0	1	0	3	0	0	2	0	0	0	2	1	3	1	1	0	0	0	0	1	0	1	0	0	0	2	0	0	0	0	0	0	0	0	0	2	0	2	1	0	0	1	0	0	0	1	2	4	2	0	1	0	5	0	0	0	0	0	0	0	0	0	0	0	0	0	0	0	0	0	1	1	0	0	0	0	1	0	0	0	0	0	0	0	4	0	1	0	1	0	0	0	1	0	0	0	3	0	1	0	0	2	1	4	0	0	1	0	0	0	0	0	0	0	0	0	0	0	0	0	2	0	0	0	0	0	0	0	0	0	3	2	0	0	0	0	0	0	0	0	0	1	0	3	0	0	0	1	0	0	0	2	0	1	1	0	0	0	0	0	0	0	0	0	0	0	0	0	0	0	0	0	1	0	0	1	0	1	1	2	0	0	0	0	0	0	0	0	0	0	1	0	0	0	0	0	0	0	0	0	0	2	2	0	0	0	0	0	1	0	0	0	0	0	0	0	1	0	0	0	0	0	0	0	1	0	0	0	0	1	0	0	1	0	0	0	0	0	0	0	0	1	1	0	0	2	0	2	0	0	0	0	0	0	0	0	0	0	0	0	0	0	0	0	1	0	1	0	1	0	0	0	0	0	0	0	2	0	0	0	0	0	0	2	0	0	1	0	0	1	0	0	0	0	1	0	0	0	0	0	0	0	0	0	4	0	0	1	2	0	3	0	0	0	1	5	3	0	0	0	0	1	0	0	2	0	0	0	0	1	1	0	0	0	0	0	4	0	0	2	1	2	0	2	0	0	0	0	0	1	0	0	0	0	0	1	2	1	2	0	0	0	0	0	1	0	1	0	0	0	0	0	2	0	0	2	0	0	3	0	0	0	0	0	0	0	0	1	0	0	1	0	1	0	0	0	1	0	2	2	0	1	1	0	0	0	1	0	0	0	3	0	0	2	0	2	1	0	0	0	1	0	1	0	0	1	0	2	5	5	6	0	3	0	2	0	1	0	0	0	0	3	1	3	0	0	1	0	0	0	0	0	0	0	6	0	1	0	3	0	1	0	0	0	2	0	0	0	0	0	0	0	0	0	0	2	0	2	0	0	1	1	0	2	0	3	0	0	2	0	0	0	0	0	2	0	1	0	0	0	0	0	0	0	0	0	0	0	0	0	0	0	0	1	2	0	1	0	0	0	0	0	0	1	0	0	0	0	0	0	1	0	2	0	0	0	0	1	1	2	0	0	0	0	1	0	0	0	2	0	1	0	0	1	0	0	0	2	0	0	0	0	0	0	0	0	0	0	0	0	0	0	0	0	0	0	0	0	0	0	0	1	0	1	0	0	0	0	0	0	0	0	0	1	0	0	0	1	0	0	0	0	0	4	0	0	0	1	0	0	0	1	0	0	0	0	0	0	0	0	0	0	0	0	0	0	0	0	0	0	0	1	0	2	0	0	0	0	0	0	0	0	0	0	0	0	0	1	2	0	0	0	0	1	0	0	0	0	0	0	0	1	3	0	0	0	0	0	0	0	0	0	0	0	1	0	0	0	0	0	0	0	0	0	0	0	0	0	0	0	0	0	6	0	0	0	0	0	0	0	1	0	0	3	0	0	0	0	0	0	0	0	0	0	0	0	0	0	0	0	1	0	0	0	0	0	0	0	0	0	0	0	2	0	0	0	0	0	0	1	0	1	0	0	0	0	0	0	0	1	0	0	1	0	0	0	0	0	0	0	0	0	0	0	0	0	0	0	0	1	0	2	0	0	0	0	0	0	1	1	0	0	1	0	1	0	0	1	0	0	0	1	0	0	0	0	0	0	1	0	0	0	0	0	0	0	0	0	0	0	0	0	0	0	0	0	0	0	0	0	0	0	0	0	2	0	0	0	0	0	0	0	0	2	0	0	0	0	0	0	3	0	0	0	2	1	0	0	1	0	0	4	0	0	0	0	0	0	0	0	0	0	0	0	0	1	0	0	0	0	0	0	0	2	0	0	0	0	0	0	0	1	0	0	0	0	0	0	0	0	0	1	0	0	0	2	0	0	0	0	0	1	0	0	0	0	1	0	1	3	0	0	2	6	0	1	0	0	0	0	1	0	0	0	2	0	0	0	0	0	0	0	0	0	0	0	0	0	0	0	0	0	0	0	0	0	0	0	0	0	0	0	0	0	2	0	0	1	0	1	2	0	0	0	0	0	0	0	0	0	0	0	0	0	0	0	1	0	0	0	0	0	0	14	0	0	0	0	0	0	0	1	3	0	0	0	0	1	0	0	0	0	0	0	0	0	1	4	0	0	0	0	0	0	0	0	3	2	0	0	1	0	0	0	0	0	0	0	0	0	0	0	0	0	0	0	0	0	0	0	2	0	0	0	0	0	0	0	0	0	1	1	0	2	0	0	0	0	0	0	0	0	0	0	0	1	0	0	0	0	0	0	0	0	0	0	0	0	0	0	0	0	0	1	0	0	0	2	0	0	0	0	0	0	0	0	0	0	0	0	1	0	0	0	0	1	0	0	2	0	0	0	0	0	0	0	2	0	0	0	0	0	0	0	1	1	0	0	0	0	0	0	0	0	1	0	0	0	0	0	1	0	1	2	1	0	0	0	0	0	0	0	2	2	0	1	0	0	0	0	0	6	7	1	1	0	3	2	0	0	4	2	4	0	0	1	2	1	0	0	4	0	0	0	1	0	0	0	1	3	3	0	4	0	4	1	0	0	0	1	0	0	1	0	1	0	0	0	0	0	0	0	0	0	0	0	0	0	0	6	0	4	2	0	0	0	0	1	1	0	0	1	4	2	0	1	1	1	0	2	1	0	0	0	0	0	1	1	0	0	0	0	0	0	0	1	0	0	0	0	0	0	0	0	0	0	0	7	0	0	0	1	0	0	0	0	0	0	0	0	0	0	0	0	0	0	0	5	0	1	0	0	0	0	0	0	0	0	0	0	0	0	0	0	0	0	0	0	0	0	0	0	0	0	2	0	0	0	0	1	2	1	1	0	1	0	0	0	0	0	0	0	0	1	0	1	0	0	0	0	0	0	0	0	0	0	0	0	0	0	1	0	1	1	0	0	0	2	1	0	0	0	0	0	0	0	0	0	0	4	0	0	0	1	0	0	4	13	3	0	0	0	0	0	0	0	0	0	0	0	0	0	0	0	0	0	0	0	0	0	0	0	0	2	2	0	0	0	0	0	0	0	0	0	0	0	0	0	0	0	1	0	0	1	0	0	0	0	0	0	0	0	0	0	0	0	1	0	0	0	0	0	0	0	0	0	0	0	1	2	0	1	0	0	0	0	0	0	0	0	0	0	0	0	0	0	0	0	0	0	0	1	0	0	1	0	0	0	0	1	0	0	0	0	0	0	0	0	0	0	1	0	0	0	0	0	0	0	0	0	0	0	1	1	0	0	0	0	0	1	0	0	0	0	0	0	0	0	0	0	0	0	2	0	0	0	0	0	0	0	3	1	1	0	0	0	0	0	0	0	0	0	0	0	4	1	0	0	0	2	0	2	0	0	0	0	0	0	0	0	5	3	0	0	0	0	0	0	0	0	0	0	0	0	0	0	0	0	0	0	0	0	0	0	0	0	0	0	0	0	0	0	0	1	1	1	0	1	0	0	0	0	0	0	0	0	0	0	0	0	0	0	0	0	0	0	0	0	0	0	0	0	0	0	2	0	0	0	0	0	0	0	0	0	0	0	0	2	0	0	0	0	0	0	0	0	0	0	0	0	0	0	0	0	0	0	0	0	0	0	0	0	0	0	0	0	0	0	0	0	0	0	0	0	0	0	0	2	0	0	0	0	0	0	0	0	0	0	0	0	0	0	0	0	0	1	0	0	0	0	1	2	0	0	0	0	0	0	0	0	0	0	0	0	0	0	0	1	0	2	0	0	0	0	0	0	0	0	0	0	0	0	0	0	0	0	0	1	1	1	1	0	0	0	1	0	0	0	1	1	0	0	0	0	0	0	0	1	0	0	0	0	0	0	0	0	0	0	0	0	0	0	0	0	0	0	0	0	0	0	0	0	0	0	0	0	0	1	0	0	0	0	0	0	0	0	0	0	0	0	0	0	0	0	0	0	0	0	1	0	0	1	0	0	0	0	0	0	0	0	0	0	0	0	0	0	0	0	0	0	0	0	0	0	0	0	0	2	0	0	0	0	0	3	0	1	0	1	1	1	0	0	0	0	0	0	0	0	0	0	0	0	1	0	0	0	0	0	0	0	0	0	0	0	0	0	0	5	0	0	0	0	0	0	0	0	0	0	0	0	0	0	1	0	0	0	0	0	0	0	0	0	0	0	0	0	0	0	0	0	0	0	0	0	0	0	0	0	0	0	0	0	4	0	0	0	0	0	0	0	0	0	0	0	0	0	1	0	0	0	0	0	0	0	0	7	0	0	0	0	0	0	0	2	0	0	0	0	0	0	0	0	0	0	0	0	0	0	0	0	0	0	0	0	0	0	0	0	0	0	0	0	0	2	0	0	0	0	0	0	0	1	0	0	0	0	0	0	0	0	0	0	0	0	0	0	1	0	0	0	0	0	0	0	0	0	0	0	0	0	0	0	0	0	0	0	0	0	0	0	0	0	0	0	0	0	0	0	0	0	0	0	0	0	0	0	0	0	0	0	0	0	0	0	0	0	0	0	0	0	0	0	1	0	0	0	0	0	0	0	0	1	0	0	0	0	0	1	0	0	0	0	0	0	0	0	0	0	0	0	1	0	0	0	0	0	0	0	0	0	0	0	0	0	0	0	0	0	1	0	0	0	0	0	0	3	0	0	0	1	0	1	0	0	0	0	0	0	0	0	0	1	0	0	0	0	0	0	0	0	0	0	1	0	0	0	0	0	0	0	0	1	0	0	0	0	0	0	0	0	0	0	2	0	0	1	0	0	0	0	0	0	0	0	5	0	0	0	0	0	0	0	1	0	0	0	0	0	0	0	0	0	0	0	0	0	0	0	0	0	1	0	0	0	0	0	0	0	0	0	0	0	0	0	0	0	0	0	0	0	0	0	0	0	0	0	0	0	0	0	0	0	0	1	0	0	0	0	0	0	0	0	0	0	0	0	0	0	0	0	0	1	3	1	0	0	0	0	0	0	0	0	0	0	0	0	0	0	0	0	0	0	0	0	0	0	0	1	0	0	0	0	0	1	0	0	0	0	0	0	0	0	0	0	0	0	0	0	0	0	0	0	0	0	1	0	0	0	1	0	0	0	0	0	0	0	0	0	0	1	0	0	0	0	0	0	0	0	0	0	0	0	0	0	0	0	0	0	0	1	0	1	0	0	0	0	0	0	0	0	0	0	0	0	0	0	0	2	2	2	0	0	0	0	0	0	0	1	0	0	0	0	0	0	0	0	5	0	0	0	0	0	0	0	0	0	1	0	0	0	0	0	0	0	0	0	0	0	2	0	0	1	0	0	0	0	0	0	0	0	0	0	0	0	0	0	0	0	0	0	2	0	0	0	0	0	0	0	0	0	0	0	2	0	1	0	0	0	0	0	0	0	0	0	0	0	2	0	2	0	0	0	0	0	0	0	0	0	0	0	2	1	0	2	0	0	0	0	0	0	0	0	1	0	0	1	0	0	0	0	0	0	0	0	0	0	0	0	0	0	0	0	0	0	0	0	0	1	0	0	0	1	0	0	0	0	0	0	0	0	0	0	1	0	0	0	0	0	0	0	0	0	0	0	0	0	0	0	0	0	0	0	0	0	0	0	0	0	0	0	0	0	0	0	0	0	0	0	0	0	0	0	0	0	0	0	0	0	0	0	0	0	0	0	0	0	0	0	1	0	1	2	0	2	0	2	1	0	2	1	0	0	0	0	0	0	0	0	0	0	0	0	0	2	0	0	0	1	0	0	0	0	2	0	0	0	0	0	0	0	0	0	0	0	0	0	0	1	0	0	0	0	0	0	0	0	0	0	0	0	0	0	0	0	0	0	1	0	0	0	0	0	0	2	0	0	0	0	1	0	0	0	0	0	0	0	0	0	0	0	0	0	0	0	0	0	0	0	0	0	0	0	0	0	0	0	1	0	0	0	0	0	0	0	0	0	0	0	0	0	0	0	0	0	0	0	0	0	0	0	0	0	0	0	0	0	0	0	0	0	1	0	0	0	0	0	0	0	0	0	0	0	0	0	0	1	0	0	0	0	0	0	0	0	0	0	0	0	0	0	0	0	0	0	0	0	0	0	0	0	2	3	0	1	2	0	0	0	0	0	0	0	0	0	0	0	0	0	0	0	0	0	0	0	2	0	1	0	0	0	0	0	0	0	0	0	0	0	0	0	0	0	0	0	0	0	0	0	0	0	0	0	0	0	0	0	0	0	0	0	0	0	0	0	0	0	0	0	0	0	0	1	0	0	1	0	0	0	0	0	0	0	0	0	0	0	0	0	0	0	1	0	0	0	0	0	0	0	0	0	0	0	0	1	0	0	0	0	0	0	0	0	0	0	0	1	0	0	0	0	0	0	0	1	0	0	1	0	0	0	1	0	0	0	0	0	0	0	0	0	0	0	0	0	0	0	0	0	0	0	0	0	0	0	0	0	0	0	0	0	0	0	0	0	0	0	0	0	0	0	1	0	0	0	0	0	0	0	0	0	0	0	0	0	0	1	0	0	0	0	0	0	0	0	0	0	0	0	0	0	0	0	0	0	0	0	0	0	0	0	0	1	0	0	0	0	0	0	0	0	0	0	0	0	0	0	0	0	0	0	0	0	0	0	0	0	0	1	1	0	0	0	0	0	0	0	0	0	0	0	0	0	0	0	0	0	0	0	0	0	0	0	0	0	0	0	0	0	0	0	0	0	0	0	0	0	0	0	0	0	0	0	2	0	0	0	0	0	0	0	0	0	0	0	0	0	0	0	0	0	0	0	0	0	0	0	0	0	0	0	0	0	0	0	0	0	0	0	3	0	0	1	1	0	0	0	0	0	0	0	0	0	0	0	0	0	0	0	0	1	3	0	0	0	0	1	0	0	0	0	2	1	0	0	0	0	0	1	0	0	0	0	0	0	0	0	0	0	0	0	0	0	0	0	0	0	0	0	0	0	0	0	0	0	0	0	0	0	0	0	0	0	0	0	0	0	0	0	0	0	0	0	0	0	0	0	0	0	0	0	0	1	0	0	0	0	0	0	2	0	0	0	0	0	0	0	0	0	0	1	0	0	0	0	0	0	0	0	0	0	1	0	0	0	0	0	0	0	0	0	0	0	0	0	0	1	0	0	0	0	0	0	0	0	0	0	0	0	0	0	0	0	0	0	0	0	0	0	0	0	0	0	1	0	0	0	0	0	0	1	0	0	1	0	0	0	0	2	1	0	0	0	0	0	0	0	0	0	0	0	0	0	0	1	0	0	0	2	0	0	0	0	0	0	0	0	0	0	0	0	1	0	0	0	0	0	0	0	0	0	0	0	0	0	0	0	0	0	0	0	0	0	0	0	0	0	0	0	0	0	0	0	0	2	2	0	0	0	3	0	0	0	0	0	0	0	0	2	0	0	0	0	0	0	0	0	0	0	0	0	2	0	0	0	0	0	0	0	0	0	0	0	0	0	0	0	0	0	0	0	0	0	0	0	0	0	0	0	0	0	0	0	0	0	2	0	0	0	1	0	2	0	0	0	0	0	0	0	0	0	0	0	2	0	0	0	0	0	0	0	0	0	0	0	0	0	0	0	0	0	0	0	0	0	0	0	0	0	0	0	0	0	0	0	0	0	0	0	1	0	0	0	0	0	0	0	0	0	0	0	0	0	0	0	0	0	0	0	0	0	0	0	0	0	0	0	0	0	0	0	0	0	0	0	0	0	0	0	0	0	0	1	0	0	0	0	0	0	0	0	0	0	0	0	0	0	0	0	0	0	0	0	0	0	0	0	0	0	0	1	1	0	0	0	0	0	0	0	0	0	0	0	0	0	0	0	0	0	0	0	0	0	0	0	0	0	0	0	0	0	0	0	0	0	0	0	0	0	0	0	0	0	0	0	0	1	1	1	0	0	0	1	0	0	0	0	0	0	0	0	0	4	4	2	0	2	0	0	0	0	0	2	0	0	0	0	0	0	0	0	1	0	0	2	0	0	0	0	1	0	0	0	0	0	0	0	0	0	1	0	0	0	0	0	0	0	0	0	0	0	0	0	0	0	0	0	0	0	0	0	0	0	0	0	0	0	0	0	0	0	0	0	0	2	0	1	0	1	0	0	0	0	0	0	0	0	0	0	0	0	0	0	0	1	0	0	2	0	0	0	2	5	0	9	1	0	0	0	0	0	0	0	0	0	0	0	0	0	0	3	13	0	0	0	2	0	0	6	0	4	2	1	2	0	0	1	0	0	0	0	0	0	0	0	1	0	0	2	0	0	0	0	0	0	0	0	0	0	0	0	0	0	0	0	0	0	0	0	0	0	1	0	0	0	0	0	0	0	0	0	0	0	0	0	0	0	0	0	0	0	0	0	0	0	0	0	0	0	0	0	1	0	0	0	0	0	0	0	0	0	0	0	0	0	0	0	0	0	0	0	0	0	0	0	0	0	0	0	0	0	0	0	0	0	0	0	0	0	0	0	0	2	0	0	0	0	0	0	0	0	0	0	0	3	0	0	0	0	0	2	0	0	0	0	1	13	0	0	1	0	0	0	0	0	0	0	0	0	0	0	0	0	0	0	0	0	1	1	0	2	0	2	0	0	0	0	0	0	0	0	0	0	0	0	1	1	0	0	0	0	0	0	0	0	0	0	0	0	0	0	0	0	0	0	1	0	0	0	0	0	0	0	0	0	0	0	0	0	0	0	0	0	0	0	0	0	0	0	0	0	0	0	0	0	0	0	0	2	0	0	0	0	6	1	0	0	0	2	7	0	0	0	0	2	0	0	0	1	0	0	0	0	2	1	0	0	10	0	0	0	0	1	1	0	0	0	0	0	0	0	0	0	0	0	0	1	0	0	0	0	1	0	0	0	0	0	0	2	0	0	0	4	0	0	1	1	0	0	0	0	0	3	0	0	0	0	0	0	0	0	0	0	0	0	0	0	0	0	1	0	2	0	0	0	0	0	2	0	0	0	1	2	0	0	0	0	0	0	0	0	0	0	0	0	0	0	1	0	0	0	0	0	0	0	0	0	0	3	0	1	0	0	0	1	0	0	2	0	0	0	1	0	0	0	1	0	0	0	0	0	0	0	0	0	0	0	0	0	0	0	0	0	1	0	0	0	0	1	0	0	0	0	0	0	0	0	0	0	0	0	0	0	0	0	0	0	0	0	1	0	1	2	1	1	0	0	0	0	0	1	0	0	0	0	0	0	0	0	0	0	0	0	0	0	0	0	0	0	0	0	0	0	0	0	0	0	0	0	0	0	0	0	0	0	0	0	0	0	2	0	0	0	0	0	0	0	0	0	0	0	0	0	0	0	0	0	0	0	1	0	0	0	0	0	0	0	0	0	0	0	0	0	1	0	0	0	0	0	0	0	0	0	0	0	0	0	0	0	0	0	0	0	0	0	0	0	0	0	0	0	0	0	0	0	0	0	0	0	0	0	0	0	0	0	0	0	0	0	0	0	0	0	0	0	0	0	0	0	2	0	0	1	0	1	0	0	0	0	0	0	0	0	0	1	1	0	0	0	0	0	0	0	0	0	0	0	0	0	0	0	0	0	0	0	0	0	0	0	0	0	0	0	0	0	0	0	0	0	0	0	0	0	0	0	0	0	0	0	0	0	0	0	0	0	0	0	0	0	0	0	0	0	0	0	0	0	0	0	0	0	0	0	0	0	0	0	0	0	0	0	0	0	0	0	0	0	0	0	0	0	0	0	0	1	0	0	0	0	0	0	0	0	0	0	0	0	0	0	0	0	0	0	0	0	0	0	0	0	0	0	0	0	0	0	0	0	0	0	0	0	0	0	0	0	0	0	0	0	0	0	0	0	0	0	0	0	0	0	0	0	0	0	0	0	0	0	0	0	0	0	0	0	0	0	0	0	0	0	0	0	0	0	0	0	0	0	0	0	0	0	0	0	0	0	0	0	0	0	0	0	0	1	0	0	0	0	1	0	0	0	0	0	0	0	0	0	0	0	0	0	0	0	0	0	0	1	0	1	0	0	0	0	0	0	0	0	0	0	0	0	1	0	0	0	0	0	0	0	0	0	2	6	0	0	0	0	0	0	0	0	0	0	0	0	0	0	0	0	0	0	0	0	0	0	0	1	1	1	0	0	0	0	0	2	0	0	0	0	0	0	0	0	0	0	1	0	0	0	0	0	0	0	0	0	0	0	0	0	0	0	0	0	0	0	0	0	0	0	0	0	0	0	0	0	0	0	0	0	0	0	0	2	0	0	0	0	0	0	0	0	0	0	0	0	0	0	0	0	0	0	0	0	2	0	0	0	0	0	0	0	0	0	0	0	0	0	0	0	0	0	0	0	0	0	0	0	0	0	0	0	0	0	0	0	0	0	0	0	0	0	0	0	0	0	0	0	0	0	0	0	0	0	0	0	0	0	0	0	0	0	0	0	0	0	0	0	0	0	0	0	0	0	0	0	0	0	0	0	1	0	0	0	0	0	0	0	0	0	0	0	1	0	0	0	0	0	0	0	0	0	0	0	0	0	0	0	0	0	0	0	0	0	0	0	0	0	0	0	0	0	0	0	0	0	0	0	0	0	0	0	0	0	0	0	0	0	0	0	0	0	0	0	0	0	0	0	0	1	0	0	0	0	0	0	1	0	0	0	0	0	0	1	0	0	0	0	0	0	0	0	0	0	0	0	0	0	0	0	0	0	0	0	0	0	0	0	0	0	0	0	0	0	0	0	0	0	0	0	0	0	0	0	0	0	0	0	1	0	0	0	0	0	0	0	0	0	0	0	0	0	0	0	0	0	0	0	0	0	0	0	1	0	0	0	0	0	0	0	0	0	0	0	0	0	0	0	0	0	0	0	0	0	0	0	0	0	0	0	0	0	0	0	0	0	0	0	0	0	0	0	0	0	0	0	0	0	0	0	0	0	0	0	0	0	0	0	0	0	0	0	0	0	1	0	0	0	0	0	0	0	0	0	0	0	0	0	0	0	0	0	0	0	0	0	0	0	0	0	0	0	0	0	0	0	0	0	0	0	0	0	0	0	2	0	0	0	0	2	0	0	0	0	0	0	0	0	0	0	0	0	0	0	0	0	0	0	0	0	0	0	0	0	0	0	0	0	0	0	0	0	0	0	0	0	0	0	0	0	0	0	0	0	0	0	0	0	0	0	0	2	0	0	0	0	1	0	0	0	0	0	0	0	0	0	0	0	0	0	0	0	0	0	0	0	0	0	0	0	0	0	0	0	0	0	0	0	0	2	2	0	0	0	0	0	0	0	0	0	0	0	0	0	0	0	0	0	0	0	1	2	0	0	0	0	0	0	0	0	0	0	0	1	0	0	0	0	0	0	6	0	0	0	0	0	0	0	0	0	0	0	0	0	0	1	0	0	0	0	0	0	0	2	0	0	0	0	0	0	0	0	0	0	0	1	0	0	0	0	0	3	0	0	0	0	0	0	0	0	0	0	0	0	0	1	0	1	0	0	0	0	0	0	0	1	0	0	1	0	0	0	1	1	1	0	0	0	0	0	0	0	0	0	0	0	0	0	0	0	0	0	0	0	0	0	0	0	0	0	0	0	0	0	0	0	0	0	0	0	0	0	0	0	0	0	0	0	0	0	0	0	0	0	0	0	0	0	0	0	0	0	0	0	0	0	0	0	0	0	0	0	0	0	0	0	0	0	0	0	0	0	0	0	0	0	0	0	0	0	0	0	0	0	0	0	0	0	0	0	0	0	0	0	0	0	0	0	0	0	0	0	0	0	0	0	0	0	0	0	0	0	1	0	0	0	0	0	0	0	0	0	0	0	0	0	0	0	0	0	0	0	0	0	0	0	0	0	0	0	0	0	0	0	0	0	0	0	0	0	0	0	1	0	0	0	0	0	0	0	0	0	0	0	0	0	0	0	0	0	0	0	0	0	0	0	0	0	1	0	0	0	0	0	0	0	0	0	0	0	0	0	0	0	0	0	0	0	0	0	0	0	0	0	0	0	0	0	0	0	0	0	0	0	0	0	0	0	0	0	0	0	0	0	0	0	0	0	0	0	0	0	0	0	0	0	0	0	0	0	0	0	0	0	0	0	0	0	0	0	0	0	0	0	0	0	0	0	0	0	0	0	0	0	0	0	0	0	0	0	0	0	0	0	0	0	0	0	0	0	0	0	0	0	0	0	0	0	0	0	0	0	0	0	0	0	0	0	0	0	0	0	0	0	0	0	0	0	0	0	0	0	0	0	0	0	0	0	0	0	0	0	0	0	0	0	0	0	0	0	0	0	0	0	0	0	0	0	0	0	0	0	0	0	0	0	0	0	0	0	0	0	0	0	0	0	0	0	0	0	0	0	0	0	0	0	0	0	0	0	0	0	0	0	0	0	1	0	0	0	0	0	0	0	0	0	0	0	0	0	0	0	0	0	0	0	0	0	0	0	0	0	0	0	0	0	2	0	0	0	0	0	0	0	0	0	0	0	0	0	0	0	0	0	0	1	0	0	0	0	0	0	0	0	0	0	0	0	0	1	0	1	0	2	0	0	0	0	0	0	0	0	0	0	0	0	0	0	1	0	1	0	0	0	6	0	0	0	1	0	0	0	0	0	0	0	0	0	0	0	0	0	0	0	0	0	0	1	0	0	0	0	0	0	0	0	0	0	0	0	0	0	0	0	0	1	0	0	0	0	0	0	0	0	0	0	0	0	0	0	0	0	0	0	1	0	0	0	0	1	0	0	0	0	0	0	0	0	0	0	0	0	0	0	0	0	0	0	0	0	0	0	0	0	0	0	0	0	0	0	0	0	0	0	0	0	0	0	0	0	0	2	0	0	0	0	1	0	0	0	0	0	0	0	0	1	0	0	0	0	0	0	0	0	0	0	0	0	0	1	0	0	0	0	0	0	0	0	0	0	0	1	0	0	0	0	0	0	0	0	0	0	0	0	0	0	0	0	0	0	0	0	0	0	0	0	0	0	0	0	0	0	0	0	0	0	0	0	0	1	0	0	0	0	0	0	0	2	0	0	0	0	0	0	2	0	0	0	0	0	0	0	0	0	0	0	0	1	0	0	0	0	0	0	0	0	0	0	0	0	0	0	0	0	0	0	0	0	0	0	0	0	0	0	0	0	0	0	0	0	0	0	0	0	0	0	0	0	0	0	0	0	0	0	0	0	0	0	0	0	0	0	0	0	0	1	0	0	1	0	0	0	0	0	0	0	0	0	0	0	0	0	0	0	0	0	0	0	0	0	0	0	0	0	0	0	0	2	0	0	0	0	0	0	0	2	0	0	0	1	1	0	0	0	0	0	0	0	0	0	0	0	0	0	0	0	0	0	0	0	0	0	0	0	0	0	0	0	2	0	0	0	0	0	0	0	0	0	0	0	0	0	0	0	0	0	0	0	0	0	0	0	0	0	0	0	0	0	0	0	0	0	0	0	0	0	0	0	2	0	1	0	1	0	0	0	0	0	0	0	0	0	0	1	1	0	0	0	0	0	1	0	0	0	0	1	0	0	0	0	0	0	0	0	0	0	0	1	0	0	0	0	0	0	0	0	0	0	0	1	0	1	0	0	0	0	0	0	0	2	0	2	0	0	0	3	0	0	6	0	0	0	0	2	2	0	0	0	0	0	0	0	0	0	0	1	1	0	0	0	3	0	0	0	2	0	0	2	0	0	0	0	0	0	0	0	0	0	0	0	0	0	0	0	0	0	0	0	0	0	0	0	0	0	0	0	0	0	0	0	0	0	0	0	0	0	0	0	0	0	0	0	0	0	0	0	0	0	0	0	0	0	0	0	0	0	0	0	0	0	0	0	0	0	0	0	0	0	2	0	0	0	0	0	0	0	0	0	0	0	0	0	0	0	0	0	0	0	1	2	0	0	0	0	0	0	0	0	0	0	0	0	0	0	0	0	0	0	0	0	0	0	0	0	0	1	1	0	0	1	1	1	0	1	0	4	0	1	1	0	1	3	0	0	0	0	0	0	0	0	0	0	0	0	0	0	0	0	0	0	0	0	0	0	0	0	0	0	0	0	0	0	0	0	0	0	0	0	0	0	0	0	0	0	1	0	0	0	0	0	0	0	0	0	0	0	1	0	2	0	0	0	0	0	0	0	0	0	0	0	0	0	0	0	1	0	0	0	0	0	0	2	1	0	0	0	0	0	0	0	0	0	0	3	0	2	0	0	0	0	1	0	0	2	2	0	0	0	0	0	0	0	0	0	0	0	0	0	0	0	1	1	0	0	0	4	0	0	2	0	0	0	0	0	4	1	0	0	0	0	0	0	0	0	0	0	0	0	0	0	0	0	0	0	0	0	1	0	0	1	1	0	0	0	1	0	0	0	0	0	5	0	0	2	1	0	0	0	0	0	0	0	0	0	0	0	0	0	0	0	0	0	0	0	1	0	0	0	0	0	0	0	0	0	0	1	0	0	0	0	1	0	0	0	0	0	4	0	0	0	0	0	0	2	0	0	0	0	0	0	0	1	0	0	0	0	0	0	0	0	0	0	0	0	0	0	0	1	0	0	0	0	0	0	0	0	3	0	0	0	0	0	0	0	0	0	0	0	0	0	0	0	2	2	0	0	0	0	0	0	0	0	0	0	0	0	0	0	0	0	0	0	0	0	0	0	0	0	0	0	0	0	2	0	0	0	1	0	0	0	0	0	0	0	0	1	0	0	0	0	1	0	0	0	0	0	0	0	0	0	0	0	0	0	0	0	0	0	0	0	0	0	0	0	0	2	0	0	1	0	0	0	0	0	0	0	0	0	0	0	0	0	0	0	3	0	0	0	0	0	1	0	0	0	0	0	0	0	2	0	0	0	0	0	0	0	0	0	0	0	0	0	0	0	0	0	0	0	0	0	0	0	0	0	0	0	0	0	0	0	0	0	0	0	0	0	0	0	0	0	0	0	0	0	0	0	0	0	0	0	0	0	0	0	0	0	0	0	0	0	0	0	0	0	0	0	0	0	0	0	0	0	0	0	0	0	0	0	0	0	0	0	0	0	0	0	0	0	0	0	0	0	0	0	0	0	0	0	0	0	0	0	0	0	0	1	0	0	0	0	0	0	0	0	0	0	0	0	0	0	0	0	0	0	0	0	0	0	0	0	0	0	0	0	0	0	0	0	0	0	2	0	0	0	0	0	0	0	0	0	0	0	0	0	0	0	0	0	0	0	0	0	0	0	0	0	0	0	0	0	0	0	0	0	0	0	0	0	1	0	0	0	0	0	0	0	0	0	0	0	0	0	0	0	0	0	0	0	0	0	0	0	0	0	0	0	0	0	0	0	0	0	1	0	0	0	0	0	0	0	0	0	0	0	0	2	0	0	0	0	0	0	0	0	0	0	0	0	0	0	0	0	0	0	0	0	0	0	0	0	0	0	0	0	0	0	0	0	0	0	0	0	0	0	0	0	0	0	0	0	5	0	0	0	1	0	0	0	0	1	0	0	0	0	0	0	3	0	0	0	1	0	0	0	0	0	0	0	0	0	0	1	0	0	0	0	0	0	1	0	0	1	0	0	0	0	0	0	0	0	0	0	0	0	0	0	2	0	0	0	0	0	0	0	0	0	0	0	0	0	0	0	0	0	0	0	0	0	0	0	0	0	0	0	0	1	0	0	0	0	0	0	0	0	0	0	0	0	0	0	0	0	0	0	0	0	0	0	0	0	0	0	0	0	0	0	0	0	0	0	0	0	0	0	0	0	0	0	0	0	0	0	0	0	0	0	0	0	0	0	0	0	0	0	0	0	0	0	0	0	0	0	0	0	0	0	0	0	0	0	0	0	0	0	0	0	0	0	0	0	0	0	0	0	0	0	0	0	0	0	0	0	0	0	0	0	0	0	0	0
PHYLLO12	14206	0	0	0	57	217	21	0	55	1	1	18	8	0	23	1	0	1	1	0	3	0	0	0	6	0	0	5	4	13	2	0	4	4	6	6	2	0	1	0	0	0	0	0	3	0	0	0	0	5	18	0	9	36	39	7	90	6	6	0	27	0	0	4	5	55	0	12	4	0	4	3	0	0	0	1	5	0	0	0	0	0	56	34	8	12	0	13	0	5	1	24	14	19	7	5	20	1	59	7	3	57	0	24	2	21	28	3	1	4	0	0	6	3	0	9	6	6	0	1	14	1	25	1	4	57	9	25	2	1	0	2	0	0	3	4	0	50	11	2	1	33	19	0	3	4	3	1	6	2	1	0	1	4	0	1	0	0	17	8	7	2	2	22	0	15	13	23	2	8	2	6	3	1	2	2	0	0	4	2	5	2	9	4	0	3	10	0	0	0	4	1	0	1	0	3	4	23	0	1	0	0	0	14	2	11	0	5	2	0	14	2	2	0	71	105	0	11	3	14	1	1	12	12	27	8	28	13	20	0	13	5	1	10	1	0	4	0	12	1	1	4	19	4	0	0	0	4	8	1	0	1	32	2	11	0	4	3	19	0	0	2	0	1	0	0	7	7	9	5	9	4	3	2	3	0	0	18	0	12	14	9	5	1	30	14	6	0	11	1	10	0	0	0	15	0	22	1	2	7	0	5	45	2	0	0	0	22	5	18	26	0	12	0	1	1	0	13	0	20	0	15	2	1	0	0	0	0	3	1	1	10	0	2	1	0	0	3	0	1	13	4	1	23	29	5	0	1	10	7	1	1	2	5	16	0	5	6	3	2	4	2	2	2	0	0	10	14	3	7	0	3	0	8	1	5	13	2	0	18	9	8	5	8	1	1	32	31	6	0	67	0	0	0	5	2	3	4	94	0	4	0	12	0	99	27	0	0	3	3	24	39	1	0	2	3	1	0	0	10	33	6	0	0	20	4	7	17	36	0	2	3	0	0	0	5	26	2	2	2	36	1	1	8	6	18	10	3	15	0	8	10	15	7	29	9	3	72	4	7	8	1	19	6	29	11	35	1	2	1	3	1	3	0	1	0	0	2	2	1	15	1	1	0	4	0	0	0	1	5	0	2	0	0	3	0	0	2	0	0	0	1	0	0	0	0	1	1	0	5	0	3	0	0	14	38	78	8	26	2	6	57	1	18	17	0	20	0	22	3	0	0	0	0	10	10	8	4	12	13	0	10	0	2	3	55	2	2	0	0	1	5	3	3	9	2	2	6	13	10	2	8	0	14	12	0	4	0	0	7	2	5	1	21	5	0	24	4	0	7	0	0	4	3	8	2	3	5	5	6	1	2	2	2	0	0	0	2	0	0	0	0	7	5	1	4	2	2	0	0	0	0	7	0	2	1	9	0	10	0	3	0	2	0	0	1	2	1	0	7	0	1	2	0	5	4	2	0	0	0	0	1	6	0	22	0	0	0	0	0	2	1	55	4	1	0	0	7	0	2	29	0	0	1	1	0	12	0	19	1	18	0	2	12	35	2	4	19	5	3	8	10	1	13	1	1	0	0	10	0	2	0	11	0	1	0	2	0	2	0	0	3	0	0	0	0	8	0	6	2	0	19	6	7	2	7	14	3	17	53	3	4	0	21	5	0	0	5	0	14	4	0	0	1	0	0	1	0	1	0	0	7	3	0	6	0	1	2	1	0	7	6	4	6	5	8	0	5	11	0	2	15	2	7	4	1	0	9	2	8	1	7	0	4	3	6	0	2	7	0	13	1	1	0	1	0	0	0	0	0	0	1	0	1	13	0	3	0	0	1	1	2	16	8	2	3	1	0	0	4	0	0	13	1	10	0	7	1	8	2	0	1	5	6	2	5	0	0	1	0	0	0	5	0	0	1	3	0	0	0	6	0	2	1	0	0	5	0	2	3	5	2	1	0	0	0	7	4	0	2	5	0	0	1	0	0	0	4	0	1	0	0	14	1	1	4	3	0	0	0	2	0	0	0	1	8	4	0	3	0	2	1	9	0	1	3	3	0	1	7	1	0	0	0	0	2	0	0	1	7	2	0	2	22	6	1	0	0	35	0	2	1	0	6	4	0	0	0	0	0	0	0	0	2	0	3	0	2	6	6	0	2	1	2	4	1	1	5	0	1	0	5	0	8	3	0	0	1	0	0	38	0	2	2	0	3	0	17	5	0	1	0	0	0	0	1	0	0	5	6	3	15	0	0	0	2	16	11	0	9	6	0	0	0	4	0	0	0	5	0	0	0	0	0	0	0	3	15	2	0	11	1	0	0	5	1	2	1	0	2	6	0	0	0	1	4	11	9	5	13	0	0	0	0	0	1	0	4	3	0	0	0	0	10	0	0	16	0	0	9	0	0	0	4	4	0	1	0	15	0	0	5	0	0	1	0	5	1	1	19	14	0	7	1	8	2	2	1	4	6	5	6	3	0	5	4	3	6	10	2	9	0	0	1	0	0	5	0	15	7	20	12	3	13	9	11	4	6	7	11	2	3	6	0	27	5	5	12	0	1	10	0	0	8	0	13	21	0	2	8	6	4	0	1	0	1	3	0	0	24	1	8	7	12	9	9	8	1	15	2	1	1	12	0	4	3	0	0	2	20	0	0	0	0	4	10	0	22	0	1	1	2	0	3	0	1	0	1	0	0	0	2	0	0	0	1	0	0	8	2	1	0	2	1	0	0	10	0	3	0	0	4	0	2	2	0	0	4	0	0	2	7	3	5	0	3	0	0	0	29	3	1	1	10	10	0	0	1	0	1	1	0	0	0	0	0	0	0	0	1	0	0	3	9	0	4	4	0	2	0	3	0	4	1	7	2	0	7	1	0	1	0	1	1	0	0	0	0	3	0	2	0	0	4	19	3	8	0	0	0	0	0	0	0	0	4	0	0	0	2	0	0	0	0	0	2	0	1	1	0	0	0	3	5	0	0	0	0	0	0	0	3	1	0	0	0	0	0	0	7	0	0	0	1	7	0	0	0	0	0	1	0	10	20	0	1	0	0	0	4	0	2	2	0	5	0	0	1	0	0	1	0	0	0	0	0	0	0	0	3	0	5	4	25	1	3	0	0	0	0	0	1	3	0	20	0	0	0	0	0	0	0	1	0	0	0	0	1	0	0	0	0	0	0	0	0	0	0	1	0	0	2	0	5	0	1	0	0	0	0	0	0	2	1	1	1	0	2	0	0	15	0	0	2	0	0	4	1	0	6	1	0	0	2	2	0	2	0	0	0	1	1	0	0	0	0	2	0	2	10	1	0	0	0	1	10	0	0	2	0	0	0	17	0	1	0	0	0	0	1	3	2	2	0	0	1	0	0	0	0	0	0	0	11	0	12	0	0	0	1	6	0	0	2	0	0	0	1	0	0	7	0	1	2	4	1	4	1	0	1	0	18	0	0	0	0	0	0	0	1	0	0	16	3	0	0	1	0	0	3	0	0	0	0	0	0	1	0	0	0	6	0	0	0	6	26	0	0	0	0	0	16	5	0	3	0	0	2	0	0	0	3	6	2	0	5	8	1	1	3	0	1	1	2	1	1	3	1	1	0	18	2	3	6	4	0	0	5	2	0	0	4	0	9	2	2	0	3	0	0	0	0	3	5	0	2	0	0	1	0	0	3	0	3	4	8	4	0	0	0	0	1	0	2	0	6	0	3	0	0	1	2	0	0	1	0	0	5	0	9	5	2	0	0	0	0	9	4	1	0	1	10	0	1	125	0	4	5	2	0	3	0	2	6	9	0	1	0	1	4	1	2	0	0	0	0	1	1	18	0	0	3	3	1	3	1	0	2	1	0	0	8	0	3	0	1	0	1	5	0	3	1	8	0	1	0	2	2	0	2	0	2	0	0	0	1	2	0	2	0	1	6	0	0	0	0	1	2	2	0	3	4	5	1	0	2	2	8	1	0	7	2	0	0	0	2	2	1	5	3	1	0	0	0	1	0	1	0	17	0	0	0	2	0	0	1	0	1	0	1	1	4	0	2	0	3	0	0	2	2	0	0	6	0	3	0	0	16	0	2	2	3	6	2	0	1	7	7	0	0	0	0	0	1	2	2	1	0	0	1	1	0	0	10	6	5	0	0	5	0	12	0	1	3	1	5	2	0	0	3	3	10	28	25	4	4	16	23	15	4	0	26	10	0	9	15	18	27	9	0	1	6	0	0	0	0	0	6	0	2	11	9	0	4	0	7	22	6	0	0	7	0	0	10	0	25	0	0	1	0	0	2	4	1	2	0	6	6	0	0	12	0	19	0	0	0	0	3	14	1	1	0	4	11	15	0	15	15	13	10	3	1	0	4	5	1	0	0	8	0	18	7	0	11	5	4	0	0	0	0	8	5	0	2	0	4	0	0	4	0	1	0	0	2	0	3	5	0	0	10	0	0	0	0	0	1	0	0	18	1	0	0	5	0	0	0	0	1	0	7	0	0	0	1	2	0	0	0	0	0	0	0	0	4	0	7	0	0	0	0	6	3	0	1	0	5	0	0	3	0	0	3	1	0	1	7	0	0	0	0	0	0	3	0	0	0	0	0	0	0	0	0	1	3	9	0	0	0	4	0	8	0	0	6	2	4	2	0	0	0	16	0	0	1	0	2	1	11	47	3	0	0	0	1	0	0	0	3	1	1	0	0	0	6	0	0	4	5	1	0	0	5	0	1	5	7	0	0	0	0	1	0	1	0	2	0	2	0	0	0	0	3	2	0	2	0	0	0	0	0	0	0	0	0	1	5	3	0	1	0	0	2	0	0	0	0	0	0	0	0	4	3	0	0	0	0	1	0	0	0	7	5	1	3	0	1	1	2	0	0	0	0	0	0	0	7	2	0	0	4	0	4	2	0	0	2	0	1	16	0	0	1	0	0	1	0	0	0	0	0	1	0	2	0	1	0	0	2	2	9	3	0	0	0	0	0	0	0	0	0	0	1	0	0	1	0	2	0	0	0	0	0	7	3	5	2	0	1	1	1	1	0	0	3	14	18	10	0	0	0	61	0	12	0	1	0	1	10	0	2	0	3	3	5	1	0	0	0	0	0	0	0	0	5	0	0	12	0	1	0	0	0	0	0	0	0	5	1	5	1	3	0	0	0	0	0	2	8	7	2	1	0	0	0	1	0	0	1	0	3	5	0	0	0	0	4	0	0	0	0	0	0	1	1	4	0	0	4	0	0	3	0	0	0	0	6	3	0	5	1	1	0	1	0	1	0	2	2	0	0	1	0	0	2	1	0	0	0	0	1	0	0	1	0	0	0	0	0	0	0	0	0	0	3	1	2	1	0	2	3	5	0	11	0	0	0	0	0	17	0	2	7	6	0	0	0	6	5	2	1	0	0	2	0	7	2	6	14	2	9	1	0	0	1	0	0	4	0	0	0	12	0	0	0	5	0	1	0	0	0	3	10	0	1	0	0	5	2	6	9	0	3	1	0	0	0	1	5	0	1	0	0	0	1	0	0	0	0	0	0	1	2	0	0	0	0	0	0	0	0	0	0	0	0	0	0	0	1	1	0	0	2	1	1	0	0	2	0	0	1	0	0	0	1	1	0	0	1	0	1	0	0	0	1	0	1	0	0	0	5	12	0	1	2	0	0	0	0	0	0	1	0	1	0	0	0	0	0	2	0	0	0	0	0	0	0	0	0	0	0	1	0	0	1	3	0	5	5	11	5	0	1	4	0	0	0	0	0	0	0	0	7	5	5	6	0	0	13	0	1	0	0	1	0	0	0	0	0	11	0	5	1	2	0	0	0	0	0	0	0	0	0	0	0	4	0	0	0	0	0	1	0	0	0	0	0	0	0	0	0	0	2	0	1	0	0	4	0	0	0	2	0	0	50	0	0	0	3	0	0	2	2	0	0	0	1	0	0	14	0	2	0	2	0	1	0	15	0	1	1	0	0	0	1	3	3	0	1	0	0	0	3	1	0	0	4	0	0	0	0	0	0	0	2	0	0	0	0	0	0	0	0	0	0	0	0	0	0	0	3	0	0	0	0	0	0	1	0	1	0	0	0	0	0	0	2	0	0	0	5	0	9	0	0	0	0	0	0	0	0	0	0	2	0	0	0	0	0	1	0	2	0	2	2	0	0	1	1	0	1	0	0	1	2	0	0	0	0	0	1	0	1	0	1	4	1	2	0	1	2	1	0	0	2	0	0	2	4	0	0	2	0	0	2	0	0	0	4	1	0	1	0	0	0	0	0	0	0	0	0	1	2	1	0	0	1	2	1	0	0	1	1	0	2	0	1	1	0	0	0	0	0	0	0	5	0	14	0	0	0	2	0	3	15	0	2	0	0	0	0	1	2	0	0	0	0	1	2	0	0	0	1	2	1	0	0	0	0	0	5	0	0	9	0	0	0	1	1	2	1	1	0	2	0	1	1	0	0	0	1	0	0	0	0	0	1	0	0	1	2	0	2	2	3	4	0	0	0	12	0	0	0	1	0	0	0	0	0	0	0	0	0	1	0	0	0	2	0	0	0	0	0	0	0	0	0	0	0	7	0	0	0	0	0	2	0	1	0	0	0	0	0	0	0	0	1	1	0	0	0	0	0	0	0	0	0	0	0	0	0	0	2	3	13	8	1	0	5	3	0	0	15	11	12	0	12	1	1	0	0	0	0	0	1	0	0	0	0	7	0	0	0	5	0	3	0	1	0	0	4	0	0	0	0	0	0	1	0	0	0	0	0	0	0	0	2	1	1	0	3	0	0	0	0	0	0	0	0	9	0	23	0	1	0	0	2	0	0	0	0	0	0	0	0	0	0	0	0	1	0	0	1	6	0	0	0	0	0	1	2	0	1	0	1	0	0	0	0	1	1	1	0	0	2	0	0	0	0	0	1	0	0	0	0	0	0	0	38	0	0	4	0	5	0	0	0	0	17	0	0	0	0	0	0	0	0	0	0	0	17	0	0	4	0	0	0	0	0	0	0	0	0	0	0	0	0	1	0	0	0	0	6	2	0	0	5	0	0	0	1	0	0	0	0	4	2	7	0	0	0	0	3	4	1	0	0	0	0	0	20	1	2	0	0	0	0	1	0	0	0	2	16	23	0	22	0	0	0	0	0	0	0	0	0	0	0	0	0	0	0	0	0	0	0	0	0	0	0	1	6	0	0	1	0	0	0	5	2	0	0	0	0	0	0	4	0	0	1	3	0	0	2	0	0	0	0	2	0	0	0	0	0	0	0	3	0	0	0	1	2	0	0	0	0	0	0	0	0	3	0	2	0	0	0	0	2	0	0	0	0	10	0	0	2	0	2	0	0	2	0	3	0	1	7	0	0	0	0	0	0	0	3	8	1	8	0	8	19	0	12	0	14	5	0	0	0	1	0	4	6	0	3	3	1	2	2	2	0	0	2	0	0	0	3	0	3	0	0	0	0	0	1	0	0	1	0	1	1	0	0	0	0	0	0	0	0	3	0	0	0	0	0	0	0	0	0	2	2	2	2	0	0	3	0	12	0	3	0	3	0	0	0	0	0	0	1	0	0	0	0	2	0	0	5	0	0	0	0	0	2	0	0	0	0	0	1	4	0	3	1	0	4	0	1	0	0	0	0	0	0	11	0	1	0	1	0	0	0	0	1	0	0	1	0	0	1	0	0	0	0	0	0	0	0	12	0	0	4	0	0	0	1	0	0	0	0	0	0	0	0	4	0	1	0	0	0	4	1	0	0	3	0	7	2	13	0	0	0	0	0	0	4	4	0	0	0	0	0	0	0	0	0	0	2	2	0	3	0	0	0	0	0	0	1	0	3	0	0	0	0	0	0	0	0	1	0	1	5	0	0	1	0	0	0	0	2	0	0	0	5	0	0	0	0	0	0	0	0	0	0	0	1	0	0	0	0	0	0	0	8	0	1	0	0	0	5	0	0	1	0	0	0	1	0	0	1	0	1	0	0	0	0	0	4	0	0	0	0	0	0	0	0	5	2	2	4	1	0	6	3	0	4	0	0	3	0	4	0	0	1	0	0	0	0	0	0	1	3	0	0	0	0	1	0	0	0	0	1	0	0	0	1	1	0	0	0	0	0	0	0	3	0	0	0	0	0	1	0	0	0	0	0	2	0	0	0	0	2	2	6	1	0	0	0	0	0	0	0	0	0	0	0	0	0	0	0	0	1	1	0	0	0	1	1	0	0	0	0	1	0	0	0	0	0	0	0	0	0	0	0	0	0	7	0	0	0	0	0	0	0	2	0	0	0	0	0	0	1	0	0	0	0	1	0	0	0	1	7	5	5	0	0	0	0	0	0	0	0	0	0	0	0	0	0	0	0	0	1	0	1	0	0	0	0	0	0	0	0	0	0	0	0	0	0	0	0	0	0	0	0	0	1	0	0	0	1	0	0	0	1	2	0	0	0	0	0	0	0	0	0	0	0	1	0	0	0	0	5	0	0	0	0	0	0	0	0	0	0	0	2	0	0	5	2	0	0	1	0	0	5	0	0	0	0	0	0	0	0	0	0	1	5	1	0	0	1	0	0	0	0	0	2	1	0	0	0	0	2	4	0	0	0	0	0	0	0	0	0	1	0	0	0	0	0	0	0	0	0	0	0	1	0	0	1	0	0	0	0	2	0	1	0	1	0	0	0	2	0	2	0	0	0	0	0	0	0	0	0	0	0	0	0	5	2	1	0	1	0	0	0	0	0	0	2	1	0	0	0	0	0	2	0	1	0	0	0	0	1	1	0	2	0	1	0	0	0	0	0	3	0	0	3	0	1	0	8	2	0	0	0	3	0	0	8	0	0	0	0	0	0	0	0	1	1	0	0	0	0	0	0	0	0	0	2	0	0	0	0	0	0	5	0	2	1	2	0	1	2	6	5	3	0	2	1	0	0	3	0	0	1	0	0	0	0	0	0	0	0	0	0	0	0	0	1	0	0	0	0	1	0	0	0	0	0	0	0	0	0	0	0	0	0	1	0	0	0	1	1	1	0	0	0	0	0	2	0	0	0	0	1	0	0	0	0	1	1	0	0	2	8	0	1	0	4	0	0	0	0	3	0	0	0	0	0	2	0	0	0	0	3	0	6	0	0	0	0	0	2	1	2	1	0	0	0	0	0	0	0	0	1	0	0	1	0	3	0	0	0	0	0	0	0	0	0	3	1	1	0	0	1	0	0	2	0	0	0	0	0	0	0	0	0	0	0	1	0	0	0	0	0	0	0	1	0	0	0	1	0	0	0	0	0	0	0	2	0	0	0	3	3	0	0	0	0	0	0	0	9	0	5	0	0	0	1	0	8	0	0	0	0	0	0	0	0	1	2	0	0	0	6	0	0	0	2	0	0	0	0	0	0	0	0	0	2	0	0	0	0	0	0	0	0	0	0	0	0	0	0	0	0	0	0	1	0	0	0	0	0	0	1	0	0	0	0	0	0	0	0	0	0	0	0	2	0	0	0	0	0	0	0	0	0	0	0	0	0	1	0	0	0	0	2	0	0	2	0	0	0	2	0	0	0	0	0	1	4	0	0	3	0	2	0	1	1	1	1	2	2	1	0	0	1	1	0	1	0	0	0	1	0	2	2	8	8	0	0	5	0	1	0	0	0	0	0	0	0	1	0	0	2	0	0	0	0	8	0	0	0	0	0	0	0	0	2	0	0	0	0	0	0	0	0	0	1	0	0	5	0	0	0	0	0	1	2	0	0	0	0	0	0	0	0	0	0	0	0	0	0	0	0	0	0	0	0	0	0	0	0	4	0	1	0	0	9	0	1	0	5	0	0	0	8	0	0	9	0	0	1	4	2	2	0	18	0	166	2	2	0	3	3	1	1	0	0	0	3	2	0	0	0	0	72	0	10	0	8	2	1	29	10	13	4	9	8	15	13	23	1	0	2	0	0	0	0	2	2	0	0	0	0	0	0	1	0	0	0	0	2	0	0	0	0	0	0	0	1	0	0	0	0	5	5	0	0	0	0	0	0	0	0	1	0	0	0	0	0	0	0	0	0	0	0	0	0	0	0	0	0	0	0	0	2	0	0	0	0	0	0	0	0	0	0	0	12	0	2	0	0	2	0	2	0	1	3	1	0	0	0	0	0	1	0	0	0	0	0	0	4	0	0	0	0	0	0	0	0	0	0	0	0	10	0	3	0	15	1	0	1	1	0	2	0	0	0	1	4	49	4	2	2	2	0	0	0	0	2	0	1	0	0	0	0	0	8	0	0	3	2	0	3	0	2	1	0	2	0	0	0	0	0	0	0	0	0	0	2	2	2	0	0	0	0	12	0	0	0	0	0	3	1	0	0	0	0	0	0	0	0	0	0	0	0	0	0	0	0	0	4	1	0	1	0	0	0	0	0	0	6	0	0	0	0	0	0	1	0	0	0	0	0	0	7	0	34	9	3	0	0	18	38	0	5	2	1	0	1	0	0	7	0	1	4	1	6	7	0	0	9	1	0	0	0	2	0	2	2	0	0	0	0	0	0	0	0	0	0	0	0	0	0	0	0	1	0	0	5	5	0	1	0	0	0	19	0	0	0	1	0	0	0	0	1	20	0	5	0	0	0	0	0	0	0	2	2	0	0	0	0	0	2	1	3	1	4	1	0	0	3	0	0	1	0	8	0	2	0	0	0	2	0	1	1	0	0	0	0	0	0	0	2	0	0	1	5	2	0	1	23	19	0	3	0	1	0	2	0	2	5	2	3	1	3	4	2	2	0	1	0	1	0	0	1	0	0	0	5	0	0	3	0	0	10	0	1	0	1	0	0	1	0	0	2	0	0	1	0	0	0	0	1	2	0	3	2	2	1	1	0	0	6	2	2	12	9	1	0	2	0	0	0	0	1	0	0	0	0	0	0	0	0	0	0	0	0	0	0	0	0	0	0	0	2	0	1	0	0	0	0	0	0	0	0	0	0	0	0	0	0	0	0	0	0	0	0	0	0	0	0	0	0	0	1	0	0	0	0	0	0	0	0	0	1	0	0	0	1	0	0	0	0	0	0	0	2	0	1	0	0	2	0	11	5	0	0	0	7	0	0	0	0	0	0	0	0	2	0	0	0	0	0	0	0	1	0	0	0	1	0	0	0	0	0	1	0	0	0	0	0	0	2	0	0	1	0	0	2	0	0	0	0	0	0	2	0	0	0	0	0	0	0	0	0	0	0	0	0	1	0	0	0	0	1	0	0	0	0	0	0	0	0	0	0	0	0	0	0	0	0	0	0	0	0	0	0	0	0	0	0	0	0	1	0	0	0	0	0	0	0	0	0	0	0	0	0	0	0	0	0	0	0	0	0	0	0	0	0	0	0	0	0	0	0	0	0	0	0	0	0	0	0	0	0	0	1	2	0	0	0	0	0	0	1	0	0	5	0	0	0	0	0	0	0	0	0	0	0	0	0	0	1	0	0	0	0	0	0	0	0	0	0	0	0	0	0	0	0	1	11	0	0	0	0	0	0	0	0	1	1	3	3	0	0	0	0	0	0	1	0	0	0	0	0	0	3	0	1	0	0	1	4	0	0	0	0	0	3	0	0	0	0	1	0	2	0	2	0	0	0	0	0	1	0	0	0	0	0	0	0	0	0	0	0	1	0	1	0	1	2	0	0	0	0	0	0	0	0	0	0	0	0	0	0	0	1	0	0	0	0	0	0	2	2	2	0	0	0	0	0	3	1	0	3	0	0	0	2	0	1	3	0	0	4	14	5	0	1	13	0	0	0	0	0	0	1	0	0	1	2	0	0	0	0	1	0	0	0	0	5	5	2	0	0	2	0	4	0	0	1	0	0	0	0	0	0	2	4	0	0	0	0	7	0	0	0	0	0	0	2	0	2	0	0	0	6	0	0	0	0	0	0	0	0	0	0	0	0	0	0	0	0	0	0	0	0	0	0	0	0	0	1	0	0	0	0	0	0	0	0	0	0	0	0	0	1	0	0	0	0	0	2	0	0	0	0	0	0	0	0	1	0	0	0	0	0	0	0	0	0	0	0	0	0	0	0	0	0	0	0	0	1	1	0	1	0	0	0	0	0	0	0	0	0	0	0	0	0	0	0	0	0	0	0	0	0	0	0	0	0	0	1	0	0	0	0	3	0	0	0	0	3	0	0	0	0	0	0	0	0	0	0	0	1	0	0	0	0	1	0	0	0	0	0	0	0	0	0	0	0	1	0	0	0	0	0	0	0	0	0	0	0	0	0	0	0	0	0	0	0	0	0	0	0	0	0	0	0	0	1	0	0	0	0	0	0	0	0	0	0	0	0	0	0	0	0	0	0	0	0	0	0	0	0	0	0	0	0	0	0	0	0	0	0	2	0	2	0	0	0	0	0	0	0	0	0	0	0	2	0	0	0	1	0	3	0	0	0	0	0	0	1	0	0	0	0	0	0	0	0	0	0	0	0	0	0	0	0	0	0	2	0	0	0	0	0	0	0	0	0	0	0	1	1	0	0	0	0	0	0	0	0	2	0	0	0	0	0	0	0	0	0	0	0	0	0	0	0	0	0	0	0	0	0	0	0	0	1	0	0	0	0	0	0	0	1	0	0	0	0	0	0	0	0	3	0	0	0	1	0	0	0	0	0	0	5	0	2	0	1	0	0	0	0	1	0	0	0	0	13	0	0	0	0	0	0	0	0	2	2	0	0	0	0	0	0	3	0	0	2	2	0	0	4	0	2	0	0	0	6	14	0	0	0	0	0	0	0	0	0	2	2	0	0	0	0	0	0	0	0	0	0	0	0	0	0	0	2	0	0	0	0	0	1	0	0	0	0	0	0	0	6	0	0	0	0	0	0	0	0	0	1	1	0	0	0	0	0	0	0	0	0	1	0	0	0	2	0	0	0	0	0	0	0	0	0	0	0	0	0	1	0	0	0	0	0	0	0	0	0	0	2	0	1	0	3	1	0	0	0	0	0	0	0	11	0	0	0	1	0	0	1	5	1	0	0	0	0	0	0	4	1	2	2	7	5	0	0	4	0	0	29	0	0	0	0	0	0	0	0	0	0	0	0	0	0	12	0	0	0	0	0	0	2	0	0	0	0	0	1	0	0	1	0	8	0	1	0	0	0	0	0	9	0	0	1	0	0	0	0	0	0	0	0	0	0	1	0	2	0	0	1	0	3	0	2	1	0	8	6	3	0	4	2	2	2	0	4	0	1	7	0	0	0	0	0	0	0	0	0	0	0	0	0	0	1	0	0	0	0	0	0	0	0	0	0	0	0	0	0	0	4	0	0	0	0	0	0	1	0	0	0	0	0	0	0	0	0	0	0	0	0	0	0	0	0	1	0	0	0	1	1	0	0	0	0	0	0	1	0	0	0	0	0	0	0	0	0	0	1	0	0	1	0	0	0	0	0	0	0	0	0	0	0	0	0	0	0	0	0	0	0	0	0	1	0	0	0	0	0	0	1	0	0	0	0	2	0	0	0	0	0	0	1	0	0	0	2	0	0	0	0	0	0	0	0	1	2	2	0	0	0	0	0	1	1	0	0	0	0	0	0	0	2	0	1	0	0	0	0	0	0	0	0	0	0	0	0	0	0	0	0	0	0	0	0	0	0	0	0	0	0	0	1	0	0	0	1	0	2	1	0	0	1	1	0	0	0	0	0	0	0	0	0	0	0	0	0	0	0	0	1	0	0	0	0	1	0	0	0	0	0	0	0	0	0	0	0	0	0	0	0	0	0	0	0	0	0	0	0	0	0	3	0	0	0	0	0	0	0	1	1	0	0	0	0	1	1	0	0	0	0	0	2	0	0	1	0	0	0	0	1	0	0	0	0	0	0	0	0	0	0	0	0	0	0	0	1	0	0	0	0	0	0	0	0	0	0	0	0	2	0	0	0	0	0	0	0	1	0	0	1	0	0	0	0	0	1	2	0	0	0	0	0	0	0	0	0	0	5	0	0	2	0	0	0	0	0	0	0	0	0	0	0	1	0	0	1	0	0	0	0	0	0	0	0	0	0	0	0	0	0	0	0	0	0	0	0	1	1	0	0	0	0	0	0	0	0	0	4	0	0	0	0	0	0	0	0	0	0	1	0	0	0	0	0	0	0	0	0	0	0	0	0	0	0	0	0	0	0	0	0	0	0	1	0	0	0	0	0	0	0	0	0	0	2	0	0	0	0	4	0	0	6	0	0	1	0	0	0	0	0	0	0	0	1	1	0	0	0	0	0	0	0	0	0	0	0	0	0	0	0	0	0	5	10	0	0	0	0	0	2	0	0	1	0	0	2	0	1	2	0	0	0	0	0	1	0	1	0	2	0	0	0	1	0	0	0	0	0	0	0	0	0	0	4	1	0	0	3	0	1	0	0	2	0	0	2	1	0	0	0	0	0	0	1	0	5	1	0	2	6	8	0	0	0	0	0	0	1	0	0	0	0	0	0	2	0	0	4	0	0	0	7	1	0	0	0	0	0	0	1	1	0	0	0	0	0	0	0	1	0	0	0	0	0	1	2	0	0	0	1	0	0	0	0	7	1	0	1	0	0	0	0	3	3	0	2	2	0	1	0	0	1	0	0	0	0	0	0	0	0	2	1	0	0	1	0	1	0	0	0	0	0	0	2	0	0	0	0	0	0	0	0	0	0	0	0	0	0	0	0	0	0	0	0	0	0	0	0	0	0	0	0	2	4	0	0	0	2	1	0	0	0	0	3	0	0	1	0	7	1	2	0	0	0	0	0	0	0	0	0	1	1	0	1	2	0	0	0	1	1	0	0	6	0	0	0	0	0	1	0	0	1	0	0	0	0	0	0	0	0	0	0	0	0	0	0	0	0	0	2	4	0	0	0	5	0	0	0	0	0	0	0	8	0	0	0	0	0	0	0	1	0	0	0	0	0	0	0	0	1	0	0	0	1	0	0	0	0	0	0	0	6	0	1	0	0	2	0	2	4	0	0	0	0	0	1	1	0	1	0	0	0	0	0	0	0	0	0	0	0	2	0	1	0	0	2	0	0	0	0	0	0	0	0	0	0	0	2	0	0	0	0	1	1	0	0	0	1	0	0	0	1	0	0	0	2	1	0	0	0	0	0	0	0	0	0	0	0	0	0	0	2	0	0	0	0	0	0	0	2	0	2	0	0	3	0	0	0	2	0	0	0	0	0	0	0	0	0	0	9	0	0	1	0	15	0	16	0	0	0	0	0	1	0	1	0	5	0	0	0	0	1	0	0	0	1	0	0	0	0	0	2	0	0	0	0	2	1	3	0	3	0	0	9	2	5	4	7	2	0	2	0	3	5	7	1	0	0	1	0	3	0	0	0	0	0	0	2	1	65	0	0	0	6	0	0	1	5	0	0	3	0	0	0	0	0	1	0	0	0	0	0	0	0	0	0	0	0	0	0	0	0	0	0	0	0	0	0	0	0	7	1	0	3	3	0	0	0	0	0	0	0	0	1	0	0	0	0	0	0	1	0	0	0	0	0	0	1	0	0	0	0	0	0	0	0	0	0	0	0	0	1	0	1	8	1	1	1	0	0	1	11	0	3	0	0	0	0	0	0	0	0	4	9	11	14	0	0	0	0	1	0	0	0	0	0	2	0	1	2	0	0	0	0	1	2	0	4	2	13	2	0	6	1	8	2	0	10	0	1	48	1	2	0	0	0	1	0	0	1	0	0	0	0	0	1	0	0	1	6	0	1	0	1	0	0	2	2	4	1	2	0	0	0	0	0	0	0	0	0	0	29	0	13	0	0	0	0	0	5	0	2	3	13	1	0	0	5	0	2	0	0	4	0	0	0	0	0	0	0	0	0	0	0	0	4	0	7	1	4	0	1	0	3	0	0	2	0	0	0	1	0	9	2	18	0	0	0	2	5	2	0	0	3	3	0	0	2	0	0	3	1	0	0	5	0	2	13	1	3	10	4	1	13	11	0	0	32	0	0	1	0	0	5	1	0	10	0	0	0	0	1	0	0	3	0	2	0	1	1	0	0	0	4	2	2	0	6	5	1	0	0	1	0	2	4	0	6	1	24	0	0	11	9	6	0	0	0	6	2	2	0	1	5	0	2	0	0	0	0	0	7	2	1	2	0	0	0	1	0	0	0	0	0	11	0	0	0	0	10	0	1	0	2	0	7	0	0	1	5	2	6	4	0	0	0	0	4	3	2	9	0	0	0	4	0	4	2	0	2	1	0	0	0	2	0	2	0	1	0	1	0	0	0	1	9	0	1	3	3	0	1	0	0	0	1	1	0	0	2	0	5	8	1	1	0	0	0	0	0	0	0	0	0	0	1	0	0	0	0	0	0	1	0	0	3	2	0	1	0	0	0	0	0	0	4	0	0	0	0	0	0	1	0	4	3	0	4	1	7	0	0	0	0	0	0	0	0	0	0	0	0	0	0	0	0	0	0	0	0	0	0	0	0	7	0	2	7	0	0	0	0	0	0	0	0	0	1	3	0	1	1	0	0	0	0	0	0	1	9	0	0	0	0	0	0	0	3	0	0	0	0	0	0	0	0	0	0	0	0	0	0	0	0	0	0	0	0	0	2	0	0	0	1	0	0	0	0	0	0	0	1	0	0	0	0	0	0	0	0	0	0	0	0	0	0	0	0	2	0	0	0	0	0	0	0	0	0	0	0	0	0	0	0	0	0	0	0	0	0	0	0	0	0	0	0	0	0	0	0	0	0	1	0	0	0	0	0	0	0	0	0	0	0	0	0	0	0	0	0	0	0	0	0	0	0	0	0	0	0	4	0	0	0	0	5	0	0	0	0	0	0	0	0	0	0	0	0	0	0	0	0	0	0	2	0	0	0	0	1	0	0	0	0	0	0	0	0	0	0	0	0	0	0	0	0	0	0	0	0	1	0	0	0	3	1	2	0	0	0	0	0	0	0	0	0	0	5	0	0	0	0	1	0	0	0	0	0	0	0	0	0	0	0	4	0	1	0	0	0	0	0	0	0	0	0	0	0	0	0	0	0	0	0	0	0	0	0	2	0	0	0	0	0	1	0	2	0	0	0	0	0	0	0	0	2	2	2	0	0	0	0	0	0	0	0	0	1	0	0	1	0	0	0	0	0	0	0	0	1	0	0	0	0	1	0	0	1	0	12	1	0	0	11	0	0	0	0	2	1	0	0	1	0	1	5	0	2	1	2	1	0	0	1	0	0	3	0	0	0	24	2	0	0	1	0	0	0	0	0	2	0	1	1	0	1	1	0	1	0	0	0	0	1	0	1	0	0	2	1	0	1	6	0	3	2	0	0	0	4	2	1	0	0	0	0	0	0	1	0	1	0	4	0	0	0	0	1	1	0	0	0	2	1	0	0	3	1	1	2	0	0	1	2	0	0	0	4	0	0	0	3	8	0	0	0	5	5	0	0	0	1	0	0	0	0	0	0	0	0	0	0	0	0	1	0	1	0	0	0	0	0	0	0	0	1	0	0	0	0	0	0	0	0	0	0	0	0	0	0	0	0	0	0	0	0	0	0	0	0	0	0	0	0	0	0	0	1	0	0	0	0	0	0	0	0	0	0	0
PHYLLO13	86499	0	0	0	391	1217	136	0	279	2	3	103	62	0	136	7	0	16	0	8	30	1	6	10	54	1	0	42	4	32	4	0	12	20	16	32	35	0	3	0	0	0	0	0	14	0	0	0	0	12	0	0	113	222	250	15	638	26	33	1	182	0	1	13	33	221	0	30	5	0	20	11	0	0	11	10	39	0	2	1	0	0	320	257	113	130	0	72	2	30	0	152	42	159	68	23	86	14	221	14	2	366	0	195	6	100	183	7	20	38	0	0	48	29	3	60	21	56	0	9	103	17	91	25	19	264	68	97	26	22	8	11	1	5	22	25	6	293	112	29	28	134	272	6	8	50	20	4	36	45	8	0	10	13	5	1	8	1	70	81	108	0	16	157	1	85	115	102	27	34	7	27	31	4	16	9	2	8	12	25	21	40	39	18	21	22	31	3	0	5	8	34	7	0	0	28	22	147	3	4	20	11	4	49	5	56	0	45	4	2	97	7	25	0	441	715	3	74	4	47	11	21	55	22	212	14	143	64	70	4	144	13	9	33	0	0	21	0	83	4	41	15	139	32	2	11	0	19	63	13	0	5	164	7	72	3	16	14	162	5	4	16	7	2	9	10	39	49	30	8	43	10	32	9	11	2	0	44	0	52	89	15	42	18	240	181	12	3	36	2	54	0	0	6	75	6	96	0	2	30	1	35	197	39	0	5	7	65	82	99	149	17	54	10	6	11	1	164	1	69	2	78	12	6	2	13	5	4	18	7	4	61	6	0	3	0	5	14	0	14	110	11	12	144	263	30	2	1	43	27	9	5	44	24	97	3	26	20	11	33	33	45	4	11	0	1	46	62	26	281	0	37	31	29	11	32	99	18	6	122	72	57	23	12	8	10	186	131	43	6	476	11	3	2	0	5	1	43	511	3	57	11	97	0	604	97	0	0	15	27	181	112	3	0	1	4	11	2	8	27	196	35	5	0	103	3	71	82	261	4	5	14	0	0	4	46	175	10	11	23	228	5	36	40	50	132	69	36	71	4	19	112	105	42	356	46	33	553	26	48	1	0	3	1	0	0	0	0	7	1	5	9	8	7	11	6	6	10	8	0	106	23	10	15	6	2	0	0	15	11	0	1	7	1	19	0	1	4	0	5	0	8	0	5	0	4	9	25	0	20	11	4	4	3	85	248	378	33	149	9	38	242	11	93	107	17	139	0	77	16	1	7	11	0	43	47	59	8	97	94	8	98	6	7	37	212	43	18	0	10	1	26	17	32	116	8	5	31	99	56	14	22	9	95	32	6	8	0	0	34	13	22	1	76	46	5	136	16	2	28	0	4	9	16	38	0	15	35	15	22	22	7	24	17	0	2	14	7	2	2	0	1	44	65	1	17	12	5	3	6	8	1	71	0	5	26	26	1	72	0	24	0	0	1	3	0	4	1	0	14	1	1	14	1	34	84	11	0	0	14	0	12	35	0	57	4	2	3	6	0	9	26	361	12	19	0	15	27	0	18	101	11	2	1	5	8	98	2	111	13	72	0	14	57	176	5	33	117	58	1	37	76	16	67	33	27	0	7	61	14	23	19	102	0	0	5	9	4	31	1	0	17	32	3	2	0	35	27	35	28	0	80	44	20	35	58	70	21	97	396	35	10	0	103	23	0	0	9	2	70	27	7	0	3	0	20	29	1	13	0	6	40	10	4	27	0	9	16	6	3	36	78	31	25	19	57	0	26	31	0	26	75	9	77	35	20	10	72	17	24	0	21	2	31	36	12	2	7	12	1	86	17	11	0	2	3	9	6	1	2	0	6	1	31	82	0	5	1	0	17	9	28	54	28	8	3	5	0	0	19	16	0	50	11	19	12	19	2	59	4	0	5	53	58	14	10	2	0	4	0	1	4	7	0	1	2	8	0	0	0	27	1	24	21	0	1	9	7	17	18	11	7	11	2	0	2	48	21	0	2	26	2	11	4	0	0	0	13	1	7	10	2	38	16	14	11	20	1	1	8	9	4	3	9	9	72	8	17	14	6	9	9	17	2	24	4	5	1	3	27	17	6	2	2	2	10	0	5	4	9	12	3	8	82	30	20	14	1	146	1	16	3	4	8	27	12	0	2	1	1	2	1	0	5	0	19	0	6	11	20	5	5	5	7	8	0	0	57	4	30	0	24	3	55	20	3	0	7	0	0	185	1	15	0	0	19	7	67	19	0	4	13	0	0	0	7	0	0	53	31	18	174	0	0	0	20	80	50	2	27	32	5	5	0	27	0	0	0	36	7	17	2	2	7	1	0	17	91	15	0	62	2	18	3	15	12	0	3	3	9	58	4	2	1	16	12	56	70	50	66	7	1	0	2	0	8	0	9	14	0	0	0	1	40	3	0	68	0	0	22	0	0	1	16	18	0	7	3	62	0	9	82	0	3	4	16	40	14	1	97	107	4	21	1	19	6	6	10	43	13	11	35	16	4	49	16	18	34	26	15	20	8	0	4	4	0	59	0	55	62	133	66	21	59	101	36	33	25	54	34	0	9	111	23	152	29	41	32	2	30	49	0	11	83	1	39	119	3	4	52	32	40	12	10	0	21	1	0	3	207	11	68	19	48	36	49	48	13	107	3	0	13	70	3	12	13	32	3	15	136	15	0	15	1	26	34	1	64	1	7	5	15	0	7	0	1	17	9	1	3	0	6	0	1	14	13	0	16	25	8	13	2	2	12	4	0	31	0	6	0	4	11	13	11	7	0	3	32	6	13	18	57	1	38	1	10	2	2	1	129	7	6	10	55	33	1	7	11	16	13	10	2	0	1	2	0	0	10	0	15	4	0	12	21	4	20	7	0	3	13	29	1	19	1	26	33	2	49	6	0	13	0	22	18	2	0	0	1	6	4	32	1	3	41	119	7	19	0	0	0	0	17	5	3	4	23	0	7	2	3	1	0	2	0	0	27	1	1	0	0	0	1	17	5	0	0	2	2	2	0	5	23	15	3	0	4	1	3	1	48	0	0	0	10	79	6	0	0	2	1	3	2	21	165	0	19	0	2	0	5	0	12	10	1	30	5	0	21	3	4	0	0	0	1	1	0	5	1	1	13	2	44	46	94	8	25	2	14	0	0	1	9	16	0	115	3	1	0	0	0	0	0	3	3	1	0	0	1	1	0	2	0	0	0	0	0	5	3	4	4	4	5	0	56	2	3	6	8	0	0	3	1	7	0	15	3	2	7	0	0	37	6	0	2	0	0	16	21	0	21	0	0	3	1	3	3	4	7	1	0	6	2	0	0	6	1	8	5	13	33	9	0	0	10	7	90	0	1	9	12	2	0	114	1	23	5	1	0	1	17	1	4	7	0	0	0	0	4	0	1	7	0	1	58	1	22	0	0	2	1	8	3	1	7	0	0	0	3	2	0	25	1	23	8	17	6	18	1	1	6	4	56	1	0	2	27	26	1	7	1	0	0	82	6	1	0	2	0	0	2	1	0	1	0	0	0	4	1	0	0	31	0	0	7	83	28	0	1	1	0	0	115	17	1	7	0	2	13	2	0	2	4	29	6	7	21	58	10	13	7	3	7	11	7	4	0	20	7	7	4	71	2	13	63	14	0	2	7	5	0	3	23	0	24	25	11	0	4	0	1	31	3	20	31	3	3	0	0	8	0	3	19	16	15	15	8	12	3	3	0	0	4	0	13	0	70	3	6	0	1	16	31	13	0	18	4	0	16	3	15	37	7	1	81	1	3	29	5	0	1	17	53	5	12	726	0	15	2	1	8	6	1	18	62	15	6	12	1	6	15	9	19	2	1	22	2	0	13	54	5	3	30	30	7	30	6	2	13	2	1	6	55	3	5	2	13	0	8	10	3	8	20	22	6	11	6	0	1	0	10	1	3	0	0	3	39	13	1	14	0	5	56	9	1	3	0	3	6	0	15	12	21	2	1	6	17	9	60	14	3	17	2	2	2	3	3	4	3	24	12	1	0	0	2	9	1	0	11	110	0	0	8	2	1	2	23	0	1	2	15	7	33	5	10	2	15	5	1	4	39	0	0	60	25	14	1	2	106	0	7	4	16	16	0	1	7	34	36	0	15	25	8	1	14	11	45	0	4	7	6	10	18	0	56	67	53	0	3	25	9	70	0	0	11	11	5	39	0	1	33	30	119	252	256	11	12	49	160	122	13	1	180	101	32	54	40	137	221	72	2	18	29	5	1	0	9	1	18	2	34	128	108	6	32	0	48	106	29	5	10	68	0	2	118	0	83	0	1	0	3	3	41	51	12	0	0	12	12	2	3	98	6	117	6	4	0	0	14	88	8	1	21	17	73	96	1	83	84	84	40	16	7	0	37	22	11	3	4	53	25	90	30	2	32	11	15	0	0	1	2	75	16	10	62	4	0	0	0	76	0	24	3	2	13	0	7	24	0	0	37	0	0	0	0	1	8	4	0	67	11	4	0	47	1	0	1	0	0	3	25	0	0	0	7	4	5	0	0	0	4	0	0	9	17	0	36	0	1	0	5	23	25	5	12	4	36	0	0	15	0	0	19	7	0	23	42	17	2	3	1	0	13	8	7	1	1	3	0	8	1	0	1	9	13	21	2	0	1	38	17	58	4	5	24	18	26	4	1	0	2	103	1	0	1	1	7	12	43	263	17	0	4	4	1	0	2	6	12	4	0	1	0	0	27	0	19	12	22	2	4	0	19	3	6	25	46	0	1	0	8	13	0	4	4	12	0	1	0	0	0	3	8	0	0	24	7	0	1	0	1	0	0	7	0	9	37	2	1	0	48	1	2	7	0	1	4	0	1	0	11	34	5	0	0	2	1	3	1	7	6	13	12	6	3	0	10	5	17	2	3	1	0	0	0	0	36	1	1	6	5	1	41	8	1	2	1	1	0	81	0	0	0	1	1	1	1	44	2	0	1	1	15	27	1	15	2	0	1	0	39	11	0	2	3	0	0	0	11	0	1	0	14	1	9	1	4	26	0	1	0	4	45	37	16	8	29	6	19	19	2	6	1	8	10	86	53	42	4	4	4	372	0	84	0	7	1	5	47	1	22	2	21	20	40	15	0	0	0	0	0	0	0	0	11	0	0	9	4	0	0	1	0	1	1	8	15	3	0	11	0	4	0	7	7	0	1	3	46	33	2	2	2	5	0	8	0	0	5	0	10	13	0	0	0	0	44	2	2	0	0	1	3	0	2	2	13	1	2	0	16	9	2	1	0	2	3	3	2	23	17	15	1	17	3	4	4	26	0	0	0	7	2	0	3	8	0	0	2	0	4	1	2	11	0	1	6	0	0	0	0	11	0	0	1	4	11	4	3	18	16	21	12	26	12	4	0	1	0	63	0	16	57	47	0	0	2	58	39	9	4	3	5	19	5	29	7	11	22	14	52	2	0	0	14	1	5	2	0	3	0	50	4	4	1	16	0	2	0	0	1	1	16	3	2	5	0	16	0	23	14	3	8	0	1	0	1	3	17	6	11	12	2	3	5	5	20	1	1	8	1	3	1	0	1	2	0	1	6	3	0	2	1	0	1	0	5	4	3	6	1	0	8	0	11	0	1	13	0	7	10	2	0	0	1	1	1	0	17	4	1	9	2	0	4	1	3	2	1	0	24	5	4	19	6	0	1	1	0	0	0	2	1	11	4	2	0	17	1	1	1	1	0	0	2	0	2	0	6	2	0	3	0	0	9	24	1	81	29	46	30	3	9	42	0	19	0	0	1	3	0	0	31	17	29	11	1	0	22	0	21	0	0	1	3	2	0	0	3	82	2	11	1	0	1	0	9	9	0	0	2	0	0	0	13	4	4	0	0	0	0	0	8	5	0	0	0	1	6	0	1	1	20	4	5	2	1	1	4	2	1	15	4	7	266	0	4	0	9	1	0	0	0	6	1	2	50	0	4	32	1	1	7	0	2	2	1	123	4	0	12	4	4	0	2	6	17	0	3	0	0	3	23	1	3	1	12	1	0	0	0	2	2	1	19	0	2	1	1	0	0	0	0	11	1	6	2	2	2	1	1	0	2	3	4	1	1	1	0	2	2	7	1	0	0	0	24	0	20	4	13	1	34	0	0	0	0	2	0	1	0	20	0	9	0	0	0	1	0	7	1	5	0	3	10	0	4	5	5	0	16	0	0	0	3	0	0	0	4	6	1	0	5	0	0	10	1	6	7	8	1	1	4	0	13	0	0	10	5	1	1	2	2	4	1	0	2	1	7	18	5	13	4	4	0	0	1	0	8	1	0	7	3	0	0	2	7	24	0	0	0	15	13	4	20	0	0	1	7	2	1	0	1	0	0	8	0	107	2	6	2	4	1	10	65	1	9	0	1	1	11	1	3	1	3	2	3	7	3	2	1	5	0	1	8	17	1	5	3	2	7	4	3	30	0	4	0	1	0	3	2	1	2	8	1	3	3	3	1	1	5	4	1	5	2	0	27	10	2	4	2	1	25	1	11	11	1	0	0	80	0	0	3	23	0	2	0	0	0	2	0	0	7	2	0	0	3	18	3	0	0	4	0	13	2	0	0	0	9	27	1	2	0	0	1	2	3	2	8	166	1	6	1	1	4	9	8	2	2	1	1	0	2	1	2	0	1	1	1	2	1	1	17	47	110	59	18	1	32	10	0	0	64	63	65	5	73	7	10	0	0	0	0	0	2	3	0	0	1	73	6	2	4	15	0	51	0	0	2	0	28	0	1	0	1	1	2	2	1	0	0	1	1	1	0	0	17	3	3	0	29	0	0	0	0	0	0	0	2	42	1	60	0	0	0	1	0	1	3	1	1	1	0	0	3	0	0	1	2	5	2	4	2	33	3	0	3	0	0	9	3	0	2	1	1	1	1	2	0	9	10	10	0	0	4	3	0	0	0	5	25	2	0	0	0	1	1	0	219	2	3	8	0	5	1	1	2	0	104	3	0	0	0	0	0	4	4	0	0	0	106	4	0	30	3	1	1	0	0	1	0	0	0	0	4	6	0	1	1	0	0	8	39	0	2	0	15	2	2	1	8	4	11	0	4	15	2	35	0	0	3	0	19	1	0	0	1	0	1	15	109	6	4	6	2	0	1	0	1	1	1	8	106	111	1	109	1	0	1	0	0	1	2	0	1	10	0	0	1	7	7	0	1	3	0	3	0	0	0	2	13	0	0	7	3	3	0	3	3	2	0	3	0	1	0	15	0	0	2	34	1	0	0	0	1	5	1	0	2	4	1	0	0	2	8	2	0	0	5	3	3	0	0	0	1	4	2	2	3	10	2	7	0	0	3	3	1	0	0	0	0	43	4	0	1	0	3	0	2	2	1	22	2	7	35	0	2	1	0	1	2	1	24	47	2	48	19	56	99	5	30	10	99	20	2	1	0	0	0	39	26	1	0	21	4	15	8	0	1	23	1	0	8	0	20	0	16	1	0	1	0	2	0	0	0	0	4	131	5	1	1	0	0	1	0	1	0	16	0	0	0	0	0	0	0	0	1	11	2	3	0	0	0	11	1	100	0	6	0	23	0	0	0	2	2	0	0	2	1	1	2	6	1	0	4	2	14	2	1	2	3	0	0	0	1	3	0	3	0	20	4	1	25	0	1	1	1	3	0	0	0	41	10	0	0	4	0	1	3	16	0	0	1	7	0	1	0	0	1	0	1	0	0	2	24	284	24	0	31	4	0	0	6	4	0	1	0	0	0	0	3	2	0	4	0	0	0	12	1	1	4	1	1	0	5	0	3	4	7	1	0	0	18	16	1	24	8	0	0	11	1	6	3	1	18	17	3	7	1	0	3	3	0	2	0	0	12	0	32	4	0	4	0	3	0	3	7	4	65	0	1	20	1	0	0	5	4	0	1	0	22	0	1	1	4	0	0	0	4	5	1	0	5	2	3	0	5	1	0	1	34	1	1	0	2	0	12	0	0	8	3	0	4	0	0	2	1	5	1	0	0	0	0	4	2	2	3	1	2	0	3	0	1	9	1	13	2	2	1	28	8	0	11	4	1	2	0	24	0	0	0	0	1	8	5	2	1	3	5	2	0	0	1	0	0	5	1	9	6	0	2	0	6	12	2	4	2	2	5	3	0	22	2	1	0	0	1	1	4	0	0	0	0	10	1	1	0	0	6	1	15	7	10	0	0	0	0	2	2	5	1	0	0	4	7	0	9	1	0	0	0	15	1	3	1	0	6	0	1	3	9	7	1	1	4	2	0	0	4	0	2	0	0	24	3	4	0	0	1	0	0	5	0	0	0	0	4	3	0	0	0	4	0	1	0	0	0	2	20	24	24	0	15	4	0	0	0	11	1	0	1	0	0	1	2	0	0	0	2	0	3	2	0	3	0	0	0	0	0	0	1	0	2	22	0	3	0	11	1	0	0	0	3	0	2	0	0	0	0	0	7	5	0	0	0	11	0	4	0	5	0	0	0	0	2	3	1	4	0	0	1	0	5	0	0	0	0	3	12	1	41	0	1	40	26	0	6	1	4	2	21	3	3	37	2	12	0	12	3	0	0	1	40	1	0	0	28	5	0	0	0	0	20	7	4	0	0	2	34	9	0	2	0	0	0	0	4	0	3	0	2	9	0	0	2	0	0	0	10	10	0	4	2	0	2	0	0	0	0	0	0	0	0	0	0	1	0	5	0	12	0	0	0	0	1	3	2	0	0	0	0	0	0	81	2	0	0	4	0	1	12	3	0	0	1	9	0	0	3	0	2	36	0	1	0	1	2	0	1	0	1	24	21	1	7	1	0	0	0	14	3	2	5	0	1	8	23	21	3	0	9	14	1	0	24	3	0	0	4	4	1	1	3	2	8	0	0	0	0	0	1	0	1	0	13	0	3	4	0	0	2	57	0	6	4	7	0	6	8	51	10	15	1	3	10	2	0	1	2	0	9	2	0	0	0	0	0	6	0	4	1	3	0	0	4	0	3	4	0	0	0	0	0	0	1	0	3	0	1	0	0	2	6	11	0	0	0	0	0	0	0	0	0	2	0	2	0	0	0	1	2	2	0	3	0	15	2	5	3	16	25	0	1	0	12	2	1	1	5	25	2	0	0	1	1	9	0	2	4	0	7	0	3	0	0	0	1	1	4	2	1	0	0	1	0	0	0	0	2	0	9	1	0	1	1	2	1	0	0	4	2	2	1	2	0	5	2	1	1	0	27	0	0	4	2	0	0	0	0	7	0	0	0	1	0	4	0	0	1	0	0	0	0	13	0	0	0	1	3	1	13	4	1	0	0	3	0	0	0	6	5	2	0	0	0	0	0	0	4	0	29	2	0	0	20	0	61	0	0	1	1	0	1	0	0	0	0	3	0	0	27	1	0	2	7	7	1	0	2	0	0	2	0	3	5	1	1	2	0	3	0	2	0	1	0	0	5	2	0	3	4	0	1	2	0	0	1	1	0	4	3	1	0	0	1	2	0	5	0	1	0	3	17	10	3	0	0	0	0	1	0	0	3	0	1	1	1	0	0	0	0	0	7	0	0	2	1	0	5	6	0	0	2	0	8	19	10	0	0	7	1	0	7	0	3	5	3	23	21	7	0	2	1	5	1	0	2	13	0	11	0	0	0	55	57	12	1	34	3	0	2	9	0	0	0	0	4	5	1	1	3	0	1	2	0	53	0	2	0	0	1	0	2	2	5	0	0	1	0	5	8	2	0	0	0	1	0	11	11	2	1	12	1	1	7	0	0	2	0	0	0	0	0	0	0	0	0	0	0	0	1	10	0	0	2	0	1	2	0	37	5	1	0	0	71	1	13	1	32	0	0	4	50	0	0	39	0	1	0	3	18	7	0	116	0	861	19	11	1	29	13	0	1	0	0	0	21	29	1	0	0	1	579	0	66	2	50	1	0	191	30	87	46	57	15	55	59	102	0	0	1	1	4	0	3	1	8	2	0	3	4	1	1	6	0	1	0	0	0	2	0	1	0	4	0	0	5	1	0	5	0	32	27	0	1	4	4	0	0	0	0	29	0	0	0	0	8	2	2	2	1	0	1	0	0	0	0	0	0	3	0	1	46	1	0	1	0	2	0	1	1	0	1	3	32	2	12	1	0	2	0	8	0	0	7	1	0	0	0	1	1	1	1	0	2	0	1	1	22	8	1	0	1	3	0	2	0	1	0	5	1	32	0	13	1	101	0	0	13	11	2	27	2	0	2	2	13	295	33	7	50	4	0	0	6	2	7	3	15	1	0	1	1	4	26	1	2	20	23	6	19	6	16	10	0	0	1	0	13	5	1	0	1	0	0	1	9	8	9	1	1	0	0	25	1	2	1	0	2	3	19	6	0	0	1	0	0	4	1	5	6	1	1	1	3	0	3	0	25	11	1	1	6	0	2	0	0	0	24	0	0	0	1	1	0	0	0	0	0	0	3	0	26	9	294	62	33	0	7	122	198	1	17	2	0	0	22	2	1	28	0	7	10	0	48	37	7	1	1	4	1	1	2	13	35	0	0	1	1	1	1	3	3	0	0	1	2	1	1	1	0	2	16	5	1	9	9	16	0	19	0	6	2	66	1	8	3	15	0	4	2	3	3	108	0	11	1	1	0	0	5	14	0	19	25	0	0	0	2	2	29	21	21	2	34	9	1	0	25	0	0	0	3	52	0	12	0	0	9	2	0	0	0	1	0	1	0	0	2	1	11	9	3	3	15	11	0	13	137	97	6	17	0	3	0	37	0	12	29	9	18	1	9	16	0	11	2	0	2	4	1	0	6	0	0	1	23	9	4	25	2	20	43	1	1	0	5	1	0	6	0	2	0	2	3	3	0	0	1	1	30	8	10	10	9	7	6	1	0	1	25	2	16	22	24	13	2	5	2	2	0	1	5	3	1	0	0	0	0	0	0	1	0	1	0	1	1	1	0	2	1	0	1	3	1	0	1	1	0	1	2	0	2	1	2	1	0	0	0	0	1	0	3	0	0	1	1	0	0	1	3	3	4	0	1	4	0	0	0	1	3	0	0	0	2	0	2	0	5	2	1	1	0	3	41	0	10	0	2	16	0	3	40	0	0	0	28	0	0	1	0	1	0	3	1	4	1	2	3	172	9	0	2	1	5	0	0	0	12	12	1	0	0	1	1	0	2	3	0	0	3	0	0	14	2	0	1	0	1	1	5	0	1	4	6	0	0	1	10	0	13	7	0	0	0	2	6	1	0	0	1	2	1	3	0	0	0	1	4	0	0	0	0	1	0	0	0	0	3	1	0	1	2	0	3	1	1	1	0	1	0	3	1	0	0	1	0	0	0	1	0	0	0	0	0	0	0	3	1	0	0	1	0	1	0	0	0	0	0	0	0	0	0	0	1	0	2	0	11	14	0	0	0	1	4	7	2	3	2	0	9	0	0	1	0	9	0	0	0	0	0	0	0	1	3	0	1	0	0	1	4	0	0	127	0	0	0	0	0	0	0	0	0	0	0	4	5	1	63	1	4	4	0	0	0	0	0	0	0	5	5	0	0	2	3	0	1	1	0	0	0	0	2	1	0	0	3	0	2	0	9	0	1	0	0	0	4	1	0	0	11	3	0	0	3	12	0	0	1	0	4	1	1	0	0	1	0	0	0	0	1	0	0	3	0	0	1	0	7	1	0	0	0	5	0	0	0	0	3	3	1	0	0	0	11	7	1	2	0	0	7	10	12	35	0	0	21	0	0	10	4	0	23	0	0	1	10	5	6	8	0	9	14	58	20	4	7	45	0	0	1	0	0	2	6	1	9	3	1	1	0	1	0	2	8	0	0	1	21	24	1	0	2	14	1	29	0	2	8	1	0	6	0	0	0	23	20	3	1	0	2	39	0	0	0	0	0	0	0	1	6	0	0	0	26	4	1	0	0	0	1	0	2	0	2	0	1	4	0	0	0	0	2	5	1	0	0	0	0	0	0	1	0	0	0	0	0	0	0	1	2	0	0	0	2	0	1	0	0	0	0	0	0	0	0	2	0	0	0	0	2	1	0	0	0	1	2	0	0	12	0	0	0	0	0	0	0	0	0	3	2	5	6	0	1	0	0	0	0	0	0	0	0	0	0	1	0	0	0	0	0	2	0	0	0	1	0	0	49	0	0	0	0	3	0	4	3	0	0	0	13	0	0	0	1	0	0	0	0	2	2	4	1	1	2	2	2	0	1	0	0	0	0	0	0	1	0	1	2	2	2	0	0	0	0	0	0	3	4	1	2	0	0	0	0	1	1	0	4	0	0	1	1	1	0	5	1	0	3	0	0	2	6	0	1	8	0	2	1	0	1	0	0	4	1	1	6	4	1	0	5	0	0	3	0	5	3	1	0	0	6	1	0	6	0	3	0	0	0	3	0	0	0	0	13	1	0	14	16	0	0	8	2	0	0	2	0	3	0	1	0	3	1	3	1	0	0	1	0	0	0	0	2	0	0	0	2	4	0	0	0	0	0	1	7	1	0	1	1	1	0	2	9	2	6	0	0	2	0	0	0	11	0	3	8	0	7	1	0	2	5	1	5	1	1	2	0	1	0	0	4	2	0	0	0	0	2	0	2	0	1	0	1	0	0	1	0	0	0	0	0	1	0	0	0	0	0	0	2	0	0	0	1	0	25	0	1	1	2	0	0	3	0	8	0	3	0	1	43	2	5	0	1	0	0	0	0	0	22	0	0	0	1	5	3	1	1	2	1	5	7	1	5	0	1	1	0	1	5	64	0	0	2	0	1	1	0	0	2	0	1	0	0	0	0	0	0	0	0	0	0	1	0	0	0	1	0	0	0	1	1	0	4	0	2	0	0	3	0	1	16	0	0	0	0	9	6	0	3	0	0	1	0	1	1	9	0	0	0	0	0	0	0	0	1	0	1	1	4	0	1	2	0	1	9	2	0	10	2	0	1	10	0	2	0	1	10	0	1	1	3	0	9	4	10	1	0	0	2	2	0	1	1	61	1	0	0	3	0	0	30	17	0	1	3	3	3	1	4	26	7	3	8	44	15	1	1	10	0	1	178	0	4	1	0	1	2	9	3	1	0	0	0	0	0	51	3	0	20	1	0	1	0	0	5	1	0	0	1	0	2	7	0	4	1	2	0	0	7	1	0	46	4	0	4	3	3	0	0	0	0	4	0	0	9	5	0	0	7	0	15	0	3	0	5	9	0	50	31	8	4	3	7	8	8	1	7	0	1	15	0	0	1	1	0	0	0	3	0	0	0	0	1	0	3	0	1	0	0	0	3	2	0	0	0	0	1	0	6	0	27	0	0	1	0	0	0	1	0	0	0	0	1	1	0	0	0	2	0	1	0	0	0	0	0	3	0	0	0	1	4	0	0	0	0	0	0	1	4	0	0	2	0	0	0	0	0	0	0	0	0	0	0	0	0	0	0	0	1	0	2	0	0	0	0	0	1	0	0	0	1	0	0	0	0	0	0	0	0	1	3	1	0	0	0	7	52	0	0	1	1	0	0	0	0	0	0	0	0	0	0	0	0	0	11	1	0	6	0	2	0	0	0	1	0	0	0	0	0	12	1	2	15	1	2	0	0	0	2	0	0	0	0	0	0	0	1	2	0	0	8	0	1	3	0	0	2	0	0	0	2	0	0	0	0	0	1	1	5	0	0	0	0	4	97	0	0	0	0	0	2	0	0	2	0	0	0	0	0	0	1	0	1	1	0	3	0	0	0	0	0	0	3	0	0	4	1	0	2	0	1	0	0	0	0	0	0	2	0	0	0	3	0	0	0	0	0	1	0	0	0	0	0	0	0	0	0	0	0	0	2	0	3	0	0	2	0	0	0	0	3	0	1	0	0	0	0	0	0	0	0	2	2	0	3	0	0	2	0	2	0	0	0	0	2	0	0	6	0	2	0	0	0	0	1	2	0	0	1	1	0	0	0	1	2	0	0	2	1	0	0	0	0	0	0	3	17	0	6	0	0	1	0	0	0	0	0	0	2	3	1	4	0	0	0	0	1	1	0	0	0	0	0	0	1	1	0	0	2	1	0	0	3	0	2	1	1	0	1	0	0	1	0	0	0	0	23	7	0	25	81	1	6	0	0	0	0	0	0	0	0	0	0	0	0	1	1	0	6	0	1	0	3	0	1	0	1	1	0	0	1	2	2	6	0	1	2	0	2	0	10	0	1	0	3	11	2	1	0	14	2	1	33	0	1	0	0	0	2	2	0	2	2	3	0	0	1	1	4	7	0	3	0	3	1	2	2	1	6	33	1	1	2	11	55	0	0	1	0	2	21	0	0	6	0	0	5	1	1	18	0	5	3	0	0	0	0	20	0	25	0	5	1	13	0	0	2	2	0	3	0	0	0	1	3	0	1	11	60	2	4	0	1	3	0	0	0	0	4	0	0	1	7	0	7	10	23	2	0	8	10	46	2	0	2	0	0	7	3	0	0	3	0	1	5	0	0	3	0	2	0	0	38	20	4	0	0	3	1	0	32	4	4	1	1	2	2	0	5	7	2	1	0	1	2	29	7	0	2	0	7	0	2	0	0	34	1	0	4	0	0	0	0	1	27	0	0	2	0	22	1	1	9	1	0	2	2	1	0	0	1	6	6	1	1	0	1	6	10	1	0	2	4	2	4	0	6	0	0	0	0	0	0	0	0	0	0	0	0	0	0	0	3	0	0	3	0	0	0	3	0	0	1	9	23	2	0	0	4	0	1	2	0	1	53	0	0	0	3	27	3	0	0	0	0	0	2	0	0	9	2	10	1	1	1	1	0	0	2	1	1	0	0	23	0	0	3	3	0	4	0	0	4	2	0	2	2	1	0	0	0	0	6	1	0	0	1	1	2	0	6	18	0	1	0	15	2	1	0	0	9	2	1	54	1	0	0	0	0	1	9	3	0	1	1	0	0	0	0	5	8	0	2	2	0	2	0	0	4	5	1	0	47	4	0	5	0	3	2	1	8	0	4	3	1	1	2	1	0	1	0	0	1	3	0	0	0	9	0	0	0	1	0	1	10	0	1	2	0	0	0	0	1	0	0	0	0	0	3	0	0	0	0	1	1	0	1	1	1	4	4	1	2	4	0	1	7	1	0	0	0	2	0	0	0	0	2	0	0	0	5	0	0	0	1	1	10	2	15	16	29	0	6	2	0	21	0	0	0	0	1	0	0	0	0	0	0	0	1	12	21	0	1	1	4	77	0	73	1	0	1	1	2	1	0	5	0	26	0	1	0	1	1	0	0	1	0	0	11	3	4	8	7	0	0	9	10	17	0	25	1	25	9	3	13	5	15	11	56	3	0	6	1	11	35	49	1	0	4	3	3	3	2	1	0	1	1	0	5	5	179	0	4	1	30	7	6	18	17	1	0	5	5	0	0	0	0	14	0	0	0	0	7	0	3	1	1	0	0	0	0	2	1	0	2	1	0	1	2	0	3	30	0	0	2	0	2	1	0	1	3	2	1	2	16	0	0	0	0	2	0	0	0	0	2	2	1	1	0	4	0	0	1	1	0	0	1	1	0	2	1	7	0	1	9	13	3	8	2	5	1	5	8	0	5	0	0	2	0	7	0	0	0	22	29	31	56	0	0	0	0	9	0	0	0	0	3	7	0	5	5	11	0	1	0	5	16	0	16	10	76	39	0	65	30	83	14	9	67	0	16	357	7	7	0	1	0	2	0	0	4	2	0	1	0	0	5	3	0	0	7	0	9	1	16	0	2	9	20	11	3	0	0	2	0	0	0	12	0	9	0	0	117	1	21	13	1	1	0	0	6	0	10	27	44	14	4	0	30	0	19	3	1	30	3	4	1	2	3	0	0	0	0	0	0	0	3	0	32	10	25	7	3	1	39	4	8	1	0	0	0	0	0	68	6	134	4	4	0	6	10	0	0	3	11	1	0	15	2	1	4	8	0	2	0	14	0	12	50	10	34	24	30	6	43	93	3	6	172	2	7	7	3	0	37	18	0	23	73	1	1	0	7	0	1	59	1	9	0	6	4	0	0	2	3	10	8	2	34	20	8	5	1	3	0	3	17	3	19	3	60	1	20	35	39	3	1	1	1	11	3	2	0	5	15	2	0	0	1	0	0	0	48	8	11	2	5	1	3	9	0	2	2	1	0	48	0	0	2	2	48	0	4	0	4	0	54	1	3	3	20	18	18	19	0	3	0	2	16	25	1	42	0	1	1	35	0	14	10	7	7	4	0	0	2	4	0	1	0	1	1	7	0	0	1	0	81	6	3	4	21	21	2	0	2	2	19	3	0	0	8	0	42	63	0	0	0	1	0	0	1	0	0	3	0	0	1	1	0	5	0	0	0	19	0	0	25	4	0	0	1	0	8	0	0	4	35	1	1	0	0	0	0	3	0	17	11	0	22	0	8	0	1	1	1	0	6	1	0	0	1	0	0	0	0	2	0	4	0	7	0	0	0	0	4	13	1	1	24	0	0	0	0	3	0	1	2	0	9	21	0	15	13	0	11	0	7	0	0	9	24	0	0	0	0	0	0	2	2	0	0	0	0	0	0	1	0	0	0	1	0	0	0	2	1	0	1	0	0	0	0	0	0	0	1	1	0	1	2	1	0	0	1	0	0	0	0	0	0	16	0	0	0	0	0	0	0	0	1	6	1	3	0	1	0	1	0	0	1	0	0	0	0	6	0	0	0	0	0	0	0	0	0	0	0	2	0	1	2	0	0	0	0	0	0	0	0	0	0	0	0	0	0	0	0	0	1	0	0	0	0	0	0	0	0	4	0	0	1	0	1	0	1	6	2	6	22	6	0	0	0	4	0	0	0	0	0	0	1	0	2	1	0	0	1	3	0	0	1	0	22	0	0	0	0	0	2	0	0	0	2	0	0	0	2	0	0	0	0	0	0	6	0	4	0	3	6	0	0	0	0	0	1	1	1	0	2	1	66	0	0	0	1	6	0	6	0	0	3	2	0	1	1	1	2	25	0	1	0	0	0	2	0	0	0	0	1	0	3	1	0	0	1	0	16	4	0	0	0	1	2	0	0	0	2	6	1	4	0	0	1	0	2	2	0	0	5	1	5	0	0	2	0	2	1	0	1	0	11	3	3	1	0	0	0	0	0	4	0	0	0	1	4	1	0	16	2	0	11	9	60	12	0	0	0	3	8	7	7	21	6	0	4	9	0	5	26	0	1	2	6	3	3	0	8	3	1	20	1	0	0	98	2	0	1	1	5	0	0	0	4	4	1	5	5	0	9	5	2	3	1	3	3	3	9	3	7	0	2	2	2	2	4	26	2	15	7	3	12	0	10	6	10	0	0	0	0	0	4	1	1	7	3	3	0	4	0	3	5	3	9	0	0	2	8	2	0	28	7	9	15	1	1	2	1	1	0	31	9	10	1	3	14	40	0	0	0	10	10	3	1	0	5	0	0	0	0	7	0	1	0	0	0	0	0	0	0	0	0	3	0	0	0	0	4	0	0	1	2	1	0	0	0	0	0	0	0	1	0	0	0	0	1	0	0	0	0	0	0	0	4	4	2	0	0	0	0	1	0	0	0	0	0	0	0	1	0	277	1	0
PHYLLO14	37024	0	0	0	121	579	60	0	92	1	2	25	11	0	97	2	0	9	0	2	8	0	0	0	26	0	0	15	3	20	10	0	2	3	9	16	20	0	1	0	0	0	0	0	8	0	0	0	0	7	0	0	25	74	83	4	275	14	20	2	145	0	1	9	3	116	0	6	0	0	4	5	0	0	1	4	35	0	1	2	0	0	109	83	39	34	0	13	0	8	0	42	16	58	29	21	13	9	61	6	3	208	0	70	3	56	58	2	14	19	0	0	22	12	0	20	29	36	0	3	42	15	34	9	6	110	16	57	10	15	5	1	0	5	2	8	2	115	32	8	8	44	78	2	1	17	9	1	21	9	8	1	1	5	9	0	0	0	67	22	26	0	1	58	1	31	47	42	15	16	3	7	9	6	4	6	0	12	18	9	21	8	17	5	9	8	46	2	0	1	0	19	0	0	0	16	4	88	1	0	14	2	1	22	8	30	0	15	2	5	30	19	20	0	163	256	0	23	0	8	3	16	18	18	71	4	61	27	39	0	56	5	6	12	0	0	7	0	23	0	4	6	54	13	7	10	0	7	34	9	0	0	78	6	30	1	7	10	63	1	0	5	3	0	4	1	7	23	13	20	16	3	13	1	9	1	0	4	0	10	77	17	36	0	100	57	3	2	28	3	43	0	0	0	24	0	47	0	4	17	1	5	91	29	0	0	0	35	28	55	75	5	17	2	1	5	0	72	3	25	0	28	2	0	1	0	8	3	8	4	1	17	2	0	1	0	1	5	1	10	24	3	2	58	37	5	4	0	13	6	0	2	12	18	42	1	12	33	10	5	11	22	4	5	0	0	17	33	8	27	0	14	10	7	1	9	30	5	18	45	19	17	7	11	4	2	101	93	17	6	159	2	2	2	0	9	2	23	209	1	16	2	34	0	245	48	0	0	27	13	78	92	1	0	0	8	0	0	2	7	87	36	1	0	37	1	9	37	104	1	3	5	0	0	0	16	83	7	5	15	86	5	53	21	39	55	19	14	46	0	9	30	34	21	125	12	7	185	30	15	0	0	0	0	0	0	0	0	3	1	1	0	4	1	2	0	0	3	11	2	21	7	1	9	7	0	0	0	6	9	0	2	4	2	15	0	2	0	0	0	0	6	0	2	0	0	2	5	0	8	0	4	0	0	26	131	330	16	59	19	4	168	3	34	36	8	40	0	31	8	0	1	4	0	20	20	37	5	42	57	9	24	2	17	15	60	17	2	1	5	1	8	6	6	30	2	4	13	48	37	12	11	2	37	23	1	2	0	0	15	4	6	0	30	21	2	70	4	1	6	0	2	10	3	17	7	1	20	12	17	12	4	0	1	0	1	11	2	0	0	0	0	20	22	0	7	3	0	0	0	3	0	38	1	7	12	7	1	65	0	5	0	3	0	2	2	4	0	0	8	0	0	6	0	1	28	3	0	0	15	0	3	22	0	29	0	0	0	2	0	5	6	153	32	4	0	11	11	0	12	61	2	0	0	4	8	62	1	42	2	14	0	6	27	78	2	8	34	20	1	14	18	24	48	8	8	0	2	29	2	10	2	34	1	0	0	11	3	6	0	0	12	16	1	0	3	10	1	15	14	0	22	39	9	10	20	23	3	58	144	17	3	1	44	5	0	0	2	0	34	2	0	0	2	0	12	13	0	1	0	5	13	6	4	13	0	4	10	2	0	32	21	5	39	12	38	0	10	23	0	2	59	16	18	15	13	6	20	6	16	0	11	1	6	18	11	0	0	32	1	28	7	2	1	0	1	5	1	0	0	1	0	0	10	30	0	9	1	0	6	7	13	16	4	3	4	0	0	0	8	2	0	18	6	19	0	13	0	14	2	0	5	13	10	7	9	2	0	0	0	0	0	2	0	0	2	2	2	0	0	12	0	8	9	0	0	2	1	7	7	11	4	3	0	0	0	10	15	0	0	6	4	2	2	0	0	0	9	0	9	3	1	23	4	5	5	1	0	0	3	4	1	6	1	6	31	8	4	7	0	4	0	18	0	5	2	4	0	2	10	0	1	0	1	0	0	0	8	7	9	15	2	5	56	13	8	9	0	67	0	2	0	2	4	2	15	9	0	2	0	0	2	0	3	0	7	0	15	10	12	5	2	4	1	7	2	0	15	0	9	0	12	5	26	2	0	0	3	0	0	61	1	10	0	0	18	2	17	8	0	3	0	0	1	0	0	2	0	26	6	3	94	2	0	0	1	51	33	0	7	11	1	8	6	5	0	0	0	12	2	2	1	0	1	0	0	15	61	5	0	19	3	5	0	23	24	0	0	3	2	25	2	0	0	2	4	15	20	16	29	0	0	0	0	0	3	0	15	2	0	0	0	0	20	0	0	50	1	0	19	0	0	0	15	4	0	0	2	32	0	2	47	0	0	2	2	11	9	0	44	33	0	21	1	9	3	3	2	8	7	11	8	7	5	15	23	9	8	18	28	95	3	0	5	2	0	17	0	15	18	55	34	6	19	27	17	9	8	18	9	0	4	50	5	78	14	9	11	4	13	22	0	4	34	3	23	32	0	1	8	20	20	7	1	0	6	4	0	3	65	0	31	10	15	20	18	14	0	79	0	0	6	24	5	3	1	8	0	2	45	4	1	0	0	13	18	0	56	1	2	0	6	0	3	0	1	8	2	0	1	0	7	0	1	7	39	0	6	14	0	9	0	0	5	3	0	36	0	4	2	3	7	4	2	5	0	2	11	0	13	11	19	3	17	0	3	3	1	0	39	3	3	1	56	9	0	0	7	10	16	0	0	0	0	0	0	0	2	0	2	0	0	7	13	2	3	6	1	0	1	11	0	0	0	7	12	2	26	5	0	2	0	11	4	2	0	0	0	4	1	18	0	1	22	61	0	13	1	0	0	0	1	0	0	1	5	0	4	1	0	1	0	0	0	0	3	0	0	0	0	0	0	5	1	0	2	0	0	0	0	2	6	2	1	2	2	0	2	1	12	0	0	0	3	24	4	0	1	0	0	0	0	4	58	0	4	0	0	4	6	0	5	2	0	20	5	0	20	0	0	3	0	0	0	0	0	3	0	0	2	0	11	16	33	0	8	0	2	0	0	0	2	12	0	34	1	0	0	0	0	0	1	1	0	0	0	0	0	0	0	1	0	0	0	0	0	3	0	7	0	1	1	0	11	7	1	3	6	0	1	7	0	8	0	1	0	3	0	1	0	32	4	0	3	0	0	5	6	0	30	0	0	0	0	1	1	0	9	0	0	4	1	0	0	0	1	3	2	0	30	2	0	1	2	3	30	0	1	6	1	0	0	40	2	5	13	0	0	0	10	1	1	3	0	0	1	0	0	0	0	6	0	0	19	1	8	0	0	0	0	37	1	0	1	0	0	0	2	0	1	10	0	10	2	4	2	4	6	0	0	7	50	0	0	0	8	6	3	29	1	0	0	23	4	1	0	2	0	0	0	0	0	0	0	0	0	2	0	0	0	19	0	0	3	33	16	0	0	0	0	0	45	12	0	4	0	0	0	0	0	0	3	7	2	7	8	25	13	2	2	0	2	16	2	4	9	5	8	3	7	54	2	2	41	10	0	2	9	2	0	0	18	0	8	9	3	0	2	0	0	0	2	2	18	0	9	1	2	0	0	0	4	13	6	8	17	5	0	2	0	0	1	0	0	0	23	0	15	1	0	14	17	5	1	5	2	0	2	2	8	10	2	0	0	0	2	24	7	5	1	1	6	1	4	314	0	4	5	1	0	2	2	5	23	13	2	1	0	1	7	8	2	2	0	10	2	2	5	20	0	2	13	9	15	5	5	7	5	0	0	2	28	0	5	2	5	0	2	2	1	2	4	8	6	1	1	0	6	0	6	0	0	0	0	0	9	7	0	1	1	1	27	0	0	8	3	2	8	6	4	1	5	0	0	0	6	5	23	20	0	6	0	2	2	0	2	4	2	6	11	1	0	0	0	12	1	0	6	53	2	1	1	1	5	5	11	0	3	0	2	0	17	0	4	0	12	1	6	27	15	0	0	23	5	4	3	1	32	0	2	0	6	18	5	0	4	22	31	0	4	9	0	1	7	7	9	0	0	0	4	5	4	0	37	18	27	0	5	21	5	25	1	3	2	2	19	3	0	0	6	7	29	40	43	4	5	13	49	48	9	0	71	42	12	44	13	37	74	25	0	12	12	0	0	0	11	0	6	0	20	33	36	2	10	0	36	41	16	0	5	19	0	3	33	1	40	0	2	0	0	0	17	17	12	0	0	10	10	0	2	34	4	51	0	0	0	0	8	42	3	0	16	14	34	42	0	29	29	29	13	3	2	0	14	19	9	0	1	32	24	50	21	0	25	11	8	0	0	0	1	29	27	5	13	0	0	2	0	25	0	16	2	4	10	1	2	6	0	0	16	0	0	0	0	0	3	0	0	20	3	1	0	27	0	0	0	0	0	4	6	0	0	0	1	2	0	0	2	0	2	0	1	9	1	0	7	0	0	0	3	5	4	1	5	1	10	0	0	38	0	0	5	0	0	6	14	4	0	3	0	0	5	11	0	0	3	0	0	0	0	0	2	3	4	15	2	0	0	18	2	29	3	5	6	9	12	4	0	1	0	30	0	0	0	0	5	0	18	82	9	0	0	0	0	0	1	2	1	2	0	0	0	0	6	0	10	11	6	1	1	0	5	2	2	21	29	0	0	0	1	9	0	0	0	8	0	0	0	0	2	3	5	0	0	6	8	0	0	0	0	0	4	0	0	13	5	5	8	0	0	0	0	6	0	0	0	0	0	0	2	19	0	0	0	3	0	0	3	4	0	7	8	2	1	0	6	3	7	1	0	0	1	0	0	0	7	7	1	6	8	1	13	0	2	1	0	2	0	24	1	0	0	0	2	0	2	16	2	0	0	0	7	2	0	2	0	2	0	0	26	1	0	1	0	0	0	2	1	0	0	0	9	0	2	0	0	4	0	0	0	0	11	16	10	4	6	0	5	5	3	3	0	2	4	28	19	15	1	1	1	211	0	43	6	4	0	4	27	0	3	0	11	9	20	3	0	0	0	0	0	0	0	0	8	0	0	2	0	0	0	0	0	1	0	5	8	0	2	2	1	4	0	1	7	0	0	1	23	14	0	0	2	0	1	0	0	0	5	1	0	4	0	0	0	0	12	2	0	2	0	3	1	0	8	4	15	0	7	0	2	5	0	0	0	0	0	0	1	6	3	3	0	3	0	3	0	5	2	0	0	0	1	0	1	0	0	0	1	0	1	0	0	7	0	0	5	0	0	1	0	4	1	0	10	6	7	1	0	11	3	3	15	12	13	2	0	0	0	42	0	5	18	20	0	0	0	14	12	1	0	1	1	20	1	17	9	7	18	3	25	12	0	0	3	2	1	3	0	1	0	18	0	1	0	3	2	5	3	0	0	0	10	1	10	1	2	2	1	17	29	0	6	1	1	0	0	1	2	5	7	6	0	1	4	0	1	0	0	8	0	3	2	0	6	2	0	0	2	2	2	0	0	1	5	0	0	0	0	3	0	0	4	1	15	0	0	3	0	0	3	9	0	0	2	2	0	0	12	10	6	13	0	1	4	2	3	1	0	0	2	0	0	1	4	0	0	0	0	0	0	0	1	4	0	0	0	0	0	0	0	3	0	0	7	2	0	1	0	3	0	2	1	0	6	12	2	28	10	6	4	0	9	15	0	7	0	1	0	0	0	0	13	14	3	5	0	0	6	0	6	0	0	0	2	0	0	0	2	31	0	3	0	2	2	0	6	2	0	1	0	0	0	0	1	1	3	0	0	0	0	0	3	3	0	0	0	2	6	0	0	0	3	0	2	0	0	0	0	0	1	12	1	0	102	0	2	0	2	0	0	0	0	0	0	0	9	0	0	7	1	0	5	0	0	0	1	35	0	2	6	0	1	0	0	2	8	0	0	0	0	3	9	0	0	0	2	0	0	0	0	1	1	0	6	0	1	0	0	0	0	0	0	6	0	1	0	0	2	0	2	0	1	1	4	0	1	0	0	0	0	0	0	0	0	0	5	0	9	0	8	0	14	0	0	0	0	0	0	0	0	9	0	5	4	0	0	0	1	5	0	6	0	8	2	0	0	12	23	0	3	0	0	0	1	0	0	0	3	4	0	0	11	0	0	3	1	8	2	5	1	10	5	0	2	0	3	0	7	1	0	0	2	2	0	0	0	0	3	17	0	7	0	0	0	0	1	0	2	0	0	4	0	0	0	0	5	2	1	2	0	1	4	1	7	0	0	0	2	2	0	1	6	1	1	24	0	29	0	3	0	3	1	7	15	0	4	0	1	0	1	0	2	1	10	4	1	1	1	1	2	0	0	1	11	5	0	0	0	2	1	2	3	20	0	1	4	1	1	0	0	2	0	0	0	0	0	1	0	0	7	2	0	0	0	0	14	4	8	0	2	1	12	4	4	8	0	0	0	38	0	0	0	6	0	0	0	0	2	0	0	0	6	0	0	0	0	6	0	0	0	0	1	7	0	0	0	0	4	12	0	2	0	1	0	2	6	3	0	0	1	9	0	0	4	1	1	4	3	0	0	3	0	0	1	0	0	0	0	1	0	0	2	23	48	31	11	1	11	6	0	0	20	37	40	3	37	5	6	1	0	0	4	0	0	0	0	0	0	22	3	2	0	3	3	14	0	1	0	0	12	0	3	0	0	0	1	0	0	0	0	0	0	1	0	0	1	0	0	1	6	0	0	0	0	0	0	1	1	12	0	35	0	0	0	1	0	0	1	0	0	0	0	0	1	0	0	5	7	39	0	0	0	14	0	0	1	0	0	1	0	0	0	0	0	0	0	0	0	1	1	1	0	0	0	0	0	0	0	1	59	3	0	0	0	0	0	0	78	4	0	15	0	3	0	0	0	0	29	0	1	1	0	1	0	1	0	0	0	0	45	0	0	13	0	0	0	0	0	0	0	0	0	0	0	1	0	0	0	1	0	8	9	0	0	0	1	3	0	0	4	0	4	0	1	6	7	10	0	0	1	0	6	6	0	0	0	0	0	2	21	9	3	35	2	0	0	0	0	1	1	2	18	30	0	26	0	0	1	2	0	0	2	0	0	4	0	0	0	2	2	0	0	2	0	0	0	0	0	3	5	0	0	15	0	1	0	0	0	0	0	0	1	2	0	2	2	0	7	1	0	0	0	0	0	2	0	2	0	0	0	0	1	0	1	6	1	0	0	0	4	0	1	0	0	0	2	0	0	1	3	3	0	0	2	0	0	1	1	0	0	4	0	0	0	0	1	0	1	0	1	20	3	7	26	0	0	0	0	0	2	0	11	15	0	14	8	15	34	0	7	5	42	7	0	1	0	3	0	4	12	0	0	10	2	0	7	4	3	16	1	0	1	0	5	0	4	0	2	0	0	1	9	0	0	0	0	0	3	2	4	1	0	0	1	0	0	5	0	0	6	0	2	1	0	0	1	1	1	0	0	0	0	0	0	21	0	5	0	7	0	0	0	0	0	0	0	0	2	0	0	13	0	0	0	0	11	2	1	0	2	0	0	0	0	5	0	2	0	6	3	3	6	0	0	0	0	1	2	1	2	28	6	0	0	0	0	0	0	6	0	0	0	1	2	0	0	0	4	0	0	0	0	5	6	3	45	0	5	0	0	0	6	0	0	0	0	0	0	0	7	30	0	0	0	0	0	4	2	0	2	1	0	0	3	0	0	3	0	0	0	0	5	4	0	6	0	0	6	1	0	0	0	0	6	6	6	3	2	0	0	0	0	2	4	1	9	0	4	2	0	0	0	0	0	0	1	0	27	0	0	3	0	0	0	3	0	0	0	0	2	0	0	0	4	2	0	0	3	1	0	0	2	0	0	0	2	0	0	0	50	5	0	0	12	0	9	0	0	0	2	0	0	0	0	0	2	2	0	0	0	0	0	0	0	0	1	1	0	0	2	0	0	20	0	18	1	1	3	15	2	0	2	1	0	6	0	9	1	0	0	0	0	0	3	1	0	1	10	0	0	0	5	3	0	3	0	0	2	1	2	0	2	4	0	0	2	0	3	1	0	16	0	0	0	0	2	0	1	1	1	0	0	2	0	0	0	3	15	0	7	1	0	1	0	0	1	5	0	0	0	0	0	6	9	0	0	1	0	0	0	6	0	33	0	0	1	0	0	3	5	7	0	0	0	0	0	0	0	0	0	0	0	35	4	3	0	0	0	0	0	2	0	0	0	0	0	0	1	1	0	0	0	0	0	0	0	1	2	35	35	0	3	0	0	0	0	5	4	0	0	0	0	0	0	0	0	0	0	0	0	1	0	0	0	0	0	0	0	0	0	0	6	11	0	0	1	1	2	0	0	0	0	5	1	0	3	0	0	0	0	9	0	0	0	6	0	0	0	1	0	0	0	1	0	0	0	3	0	0	0	0	0	21	0	0	0	2	4	0	12	2	0	12	6	0	0	1	2	0	34	0	0	11	0	2	0	0	3	0	0	0	18	0	0	0	6	3	0	0	0	0	7	1	0	0	0	1	12	3	0	1	0	0	0	0	0	0	9	0	0	2	0	0	0	0	0	1	3	3	0	1	0	0	0	0	0	0	0	0	0	0	0	0	0	0	1	6	0	16	0	11	0	0	1	0	0	0	1	0	0	0	2	24	3	0	0	0	0	2	2	0	0	0	0	8	3	0	0	0	0	10	0	1	0	0	0	3	0	1	0	2	16	0	6	0	0	0	0	17	0	0	0	0	0	0	8	2	0	0	2	1	0	1	8	0	0	0	0	2	1	0	2	1	1	0	0	0	0	1	0	0	0	1	10	0	0	8	1	0	0	6	0	4	0	7	1	0	7	18	9	4	0	26	2	0	2	0	0	0	2	1	0	0	1	1	0	0	0	3	0	0	0	0	4	0	1	0	1	0	0	0	1	0	0	0	10	0	0	0	0	2	11	0	0	4	1	4	2	0	0	0	0	4	0	1	0	0	0	0	0	0	2	0	0	0	4	5	0	10	22	0	0	0	0	0	0	0	2	12	23	0	2	0	0	5	0	1	0	0	6	0	4	0	0	2	4	0	2	0	3	1	2	2	0	0	3	0	1	0	0	0	0	4	31	0	3	0	0	0	0	2	0	0	0	2	2	0	0	0	5	0	0	0	7	0	0	0	0	4	0	0	1	1	0	0	4	0	0	0	0	0	0	2	0	0	0	1	0	0	0	1	1	0	0	5	0	0	1	15	13	0	0	1	0	0	0	0	2	0	4	1	0	0	30	0	24	0	0	0	0	0	0	0	1	0	0	0	0	0	6	0	0	0	2	4	0	0	1	0	0	0	0	0	2	1	0	0	0	1	2	1	0	0	0	0	0	1	0	0	7	0	3	6	0	0	1	0	0	1	1	0	0	0	0	1	0	0	0	0	0	0	0	1	0	0	0	0	0	0	2	0	1	0	0	0	0	2	1	0	0	0	2	0	0	0	0	0	0	8	0	0	0	0	0	4	5	0	0	2	0	0	0	0	1	1	1	11	12	3	0	0	0	1	0	0	0	2	0	3	0	0	0	40	38	2	10	5	1	0	0	1	2	0	0	0	0	0	0	0	2	0	0	0	0	24	0	0	0	0	0	0	0	0	6	0	0	0	0	0	4	1	0	0	0	0	0	1	2	1	0	2	0	2	0	1	0	0	0	0	0	0	0	0	0	0	0	0	0	0	0	2	0	0	0	1	0	2	0	11	3	0	0	0	9	0	16	0	20	0	0	0	30	0	0	24	0	0	2	3	6	2	0	46	1	445	1	39	14	5	1	0	0	0	1	1	17	19	0	0	0	3	198	0	36	1	12	1	2	77	3	46	15	37	4	22	20	37	0	0	1	0	0	0	0	1	0	0	0	3	0	0	0	5	0	0	0	3	0	0	1	0	0	2	0	0	0	0	0	1	0	24	24	0	0	0	0	2	1	0	0	7	0	0	0	0	3	0	0	0	0	2	1	0	0	1	0	0	0	0	0	0	12	2	0	1	0	0	0	0	0	0	0	0	18	0	11	0	0	0	0	2	0	0	18	0	0	0	1	2	0	0	0	0	0	0	0	0	14	5	0	0	0	0	0	0	0	0	1	0	0	12	0	6	0	29	0	0	2	7	1	10	0	0	0	3	14	98	13	2	13	0	0	0	0	0	4	0	6	0	1	7	0	0	28	0	3	2	10	5	4	2	10	1	0	0	0	0	1	0	0	1	0	0	0	0	0	0	0	0	0	0	0	22	0	0	1	3	0	0	6	0	0	0	0	0	1	1	0	0	1	0	0	0	0	0	0	0	21	5	0	0	2	0	0	0	0	0	19	0	0	1	0	0	0	0	0	1	0	1	1	1	10	4	91	15	9	0	13	48	56	0	10	0	0	3	5	3	2	11	0	5	26	0	10	22	15	1	0	0	0	0	0	11	0	0	0	1	0	0	1	0	1	0	0	0	0	0	0	1	0	0	6	2	1	5	3	7	0	9	0	11	1	22	0	6	1	14	0	5	4	6	0	48	0	6	0	0	0	0	4	3	0	10	6	2	0	0	0	0	9	2	4	2	14	5	0	0	4	0	0	0	0	22	0	2	0	0	2	2	1	0	0	0	0	0	0	0	4	0	4	1	3	5	5	2	1	0	43	38	1	7	0	0	0	9	0	11	21	6	6	0	6	4	0	2	0	0	1	1	1	0	6	0	2	0	6	1	3	2	0	3	13	0	2	0	1	0	0	5	0	1	0	0	0	0	0	0	11	0	12	3	3	4	3	8	0	0	0	0	6	1	4	14	5	3	0	0	1	0	0	1	0	0	1	0	0	0	0	0	0	0	0	0	0	0	0	2	0	0	0	0	1	0	0	0	1	0	0	1	0	0	3	0	0	0	0	0	0	0	0	0	2	0	0	0	0	0	0	0	0	0	0	0	1	0	0	1	0	0	0	0	0	0	2	0	5	0	2	0	0	0	0	0	15	0	0	0	1	4	0	1	4	0	1	1	4	0	3	0	0	0	0	0	0	1	0	1	5	0	0	0	1	2	0	0	0	0	2	2	0	0	0	0	0	0	0	1	0	0	0	0	0	45	3	1	4	0	0	0	0	0	0	1	4	0	0	0	2	0	1	0	0	0	0	0	5	0	0	0	2	0	0	2	0	0	0	6	0	0	0	0	0	0	0	0	0	0	0	0	0	0	0	0	0	0	4	0	1	0	0	0	0	0	0	1	0	0	0	1	0	0	0	0	0	0	0	0	0	0	0	0	0	0	1	0	0	0	0	0	0	0	0	0	0	0	0	0	0	6	0	1	0	0	5	3	0	0	0	0	2	0	0	0	2	8	0	0	0	0	0	0	0	0	2	0	0	0	0	0	0	0	0	12	0	0	0	0	0	0	1	0	0	0	0	2	19	0	27	0	0	0	0	0	0	0	0	0	0	4	4	0	0	1	1	0	0	0	0	0	9	0	0	0	3	0	0	0	0	2	7	0	0	0	1	0	0	0	0	0	1	4	1	0	3	14	0	0	0	5	0	3	0	0	0	2	0	0	0	0	0	0	0	0	0	0	0	1	0	3	1	0	0	0	0	0	0	0	1	0	0	0	1	0	6	1	0	0	1	1	0	2	0	10	1	0	0	0	0	9	1	0	6	0	0	0	2	4	3	25	0	13	3	25	15	0	6	15	0	1	0	0	0	1	9	0	0	1	0	0	0	0	0	2	0	0	0	0	1	2	0	0	0	2	1	12	0	0	7	0	0	0	0	0	0	10	11	0	0	0	0	21	0	0	0	1	0	0	0	0	2	0	0	0	8	0	0	0	0	0	0	0	0	0	0	0	0	0	0	0	0	0	1	13	1	0	0	0	0	0	0	0	3	2	0	0	1	0	0	0	2	0	0	0	0	0	4	0	0	0	0	0	0	0	0	0	0	0	0	0	0	0	0	0	0	0	0	0	1	1	0	0	0	0	0	0	0	0	0	0	0	2	0	0	0	0	0	0	0	0	0	0	0	0	1	0	0	0	0	0	0	0	0	0	0	0	0	1	1	8	1	4	0	1	0	3	0	0	2	0	4	3	0	1	0	0	0	0	0	0	0	0	1	1	1	0	0	0	0	0	0	0	0	0	0	0	0	0	0	0	0	0	2	0	0	0	0	0	0	0	0	0	1	0	0	1	0	0	0	0	1	0	0	0	2	2	2	0	0	0	0	1	1	0	3	0	0	0	0	0	0	0	0	0	20	0	8	0	0	0	0	0	0	0	0	1	2	0	0	0	4	1	0	0	0	0	0	0	0	1	0	0	0	0	3	0	0	3	6	0	0	0	0	0	0	0	0	0	2	0	0	1	0	1	0	0	0	0	0	0	0	0	0	0	0	0	0	2	0	0	0	2	0	0	11	0	0	0	0	0	0	3	2	0	0	0	0	0	0	0	0	7	0	0	2	0	0	0	0	0	0	0	1	1	0	0	0	0	0	0	0	2	0	0	0	0	2	0	0	4	0	0	0	0	0	0	1	0	1	0	0	0	0	0	0	0	0	0	0	0	0	0	0	0	33	0	0	0	0	0	0	0	0	6	0	3	0	1	28	0	0	1	0	0	0	2	0	1	6	6	0	0	0	0	1	1	0	1	4	2	0	0	0	0	0	9	0	0	13	23	0	0	1	0	0	1	0	0	0	0	1	0	1	1	1	0	0	0	0	0	1	0	0	0	0	0	1	0	0	0	0	0	0	0	2	0	0	1	0	0	12	0	0	0	0	5	1	0	0	0	0	1	1	0	0	5	0	0	0	2	0	0	1	0	0	0	0	1	0	0	1	0	0	0	5	1	0	5	0	0	0	5	0	0	0	0	5	1	0	1	1	0	4	0	0	0	0	0	1	0	0	0	0	31	0	0	0	2	0	0	5	2	0	0	2	2	2	0	2	9	5	17	4	20	8	0	0	7	0	0	72	0	3	1	3	0	0	1	0	0	0	0	0	0	0	13	0	0	4	0	0	0	0	0	0	0	2	0	0	0	0	1	0	8	1	0	0	0	2	0	0	16	0	0	0	0	0	1	0	0	0	0	0	0	7	3	0	0	0	0	3	0	2	0	0	2	0	14	8	6	0	0	0	0	0	0	2	0	0	8	1	0	0	1	0	0	1	1	0	0	0	0	1	0	1	0	0	0	0	0	0	0	0	0	0	0	0	0	0	0	14	0	0	0	0	0	0	0	1	0	0	2	0	0	4	0	0	2	0	0	0	0	0	0	0	9	3	0	0	0	0	0	0	0	0	0	0	0	1	0	0	0	0	0	1	0	0	0	0	0	0	0	0	0	0	3	0	2	0	0	0	0	0	1	0	0	0	0	0	0	2	0	0	0	0	0	2	0	0	0	3	0	0	0	0	0	0	0	1	0	0	0	0	0	0	0	3	0	0	0	0	0	0	0	0	0	0	0	0	0	0	1	0	0	0	0	0	0	0	0	2	1	4	0	0	0	2	0	0	0	0	0	0	1	0	0	0	0	1	0	2	0	0	2	0	0	0	0	0	0	0	2	0	0	0	2	2	0	4	0	0	0	0	56	0	0	0	0	0	6	0	0	0	0	0	0	0	2	0	0	0	0	0	0	0	0	0	0	0	0	0	0	0	0	0	0	2	0	0	0	0	0	0	0	0	1	0	0	0	0	0	0	0	0	0	0	0	0	0	0	0	0	2	0	0	0	0	3	0	0	0	0	0	0	1	0	0	0	0	0	0	0	0	0	0	0	0	1	0	0	0	0	0	0	1	0	0	0	0	0	0	0	0	0	4	0	0	1	0	0	0	0	0	0	0	0	0	0	0	0	0	0	0	0	0	0	0	1	0	0	0	0	0	0	0	14	4	0	0	5	0	0	0	0	0	0	0	0	0	11	0	2	0	0	0	0	1	0	0	0	0	1	0	0	1	0	0	0	2	0	0	0	1	0	0	0	0	0	0	0	1	0	0	0	0	0	3	0	0	0	0	0	3	0	0	0	0	0	0	0	0	0	1	0	0	1	0	0	2	0	0	0	0	0	0	0	1	0	0	0	0	0	0	2	0	1	0	0	0	0	5	0	0	0	0	1	0	0	0	5	6	1	22	0	0	0	0	0	0	0	0	0	0	6	0	0	3	0	0	3	0	0	0	0	0	0	0	0	1	9	6	0	0	33	59	0	0	0	1	0	8	0	0	4	0	0	2	0	0	21	0	1	1	0	0	2	0	5	1	2	0	0	0	2	0	1	0	1	0	1	0	0	3	0	2	0	1	2	21	0	1	3	0	5	0	0	0	0	0	0	0	1	1	0	3	4	8	0	0	3	3	24	0	0	1	0	0	1	1	0	2	4	2	0	1	0	0	1	32	0	3	0	15	16	0	0	0	0	0	0	11	1	0	0	1	0	1	0	0	15	0	0	0	0	0	18	8	0	0	0	0	0	0	0	0	14	0	0	2	0	0	0	0	0	4	0	1	0	0	2	0	0	0	0	0	0	0	0	0	0	0	2	1	4	0	0	0	0	0	0	0	0	0	0	2	0	3	0	0	0	0	0	0	1	0	0	0	1	0	0	0	2	3	2	0	3	0	0	0	4	0	0	0	0	19	0	0	0	1	0	2	0	0	0	35	0	0	0	1	8	1	3	1	0	0	0	0	0	0	1	0	3	0	0	0	0	1	0	0	4	4	0	0	28	0	0	0	0	0	0	0	0	0	0	0	1	0	0	1	0	0	0	0	0	0	0	0	0	0	0	1	3	0	0	0	5	0	2	1	0	3	1	0	20	0	0	0	0	0	3	3	0	0	0	0	0	0	0	2	3	0	0	1	0	1	1	1	0	0	0	0	0	5	0	3	0	0	0	0	1	0	0	0	3	4	0	1	0	0	0	0	0	9	0	0	0	1	0	0	3	0	1	0	0	1	1	0	0	0	0	0	0	0	0	0	0	0	0	0	0	0	0	1	2	0	0	0	0	0	0	1	0	3	0	0	3	5	0	0	1	0	0	0	7	0	0	0	0	0	0	3	3	14	0	0	0	3	0	2	3	5	1	15	1	0	6	0	0	0	0	0	0	0	0	1	0	0	0	1	2	6	1	0	0	0	24	0	25	0	0	0	0	1	2	0	3	0	11	0	0	0	1	1	0	0	0	1	0	6	1	0	1	1	0	0	1	5	6	0	4	0	4	3	3	11	5	9	9	13	0	0	2	1	0	17	5	1	0	0	0	1	0	0	0	0	2	2	0	0	1	62	1	1	0	7	0	3	9	6	0	0	0	1	0	0	0	0	8	0	0	0	0	0	0	1	2	0	0	0	0	0	0	0	0	0	2	0	0	1	0	2	23	0	0	0	0	0	0	0	1	0	1	0	0	5	0	0	0	0	0	0	0	0	0	2	12	0	0	0	0	0	0	0	0	0	0	0	0	0	0	2	0	3	0	24	2	24	0	1	2	0	0	32	0	1	7	0	2	1	1	0	0	0	9	23	24	40	0	0	0	0	7	0	0	0	0	1	13	0	0	0	0	0	1	0	1	6	0	7	11	27	4	0	14	12	11	3	1	8	0	3	115	2	2	0	0	0	0	0	0	1	0	0	0	0	0	0	0	0	0	0	1	4	0	1	3	0	5	2	1	2	0	0	1	0	0	0	3	3	0	0	0	95	0	14	4	0	1	0	0	5	0	4	10	29	1	0	0	11	0	30	0	1	19	0	5	0	0	0	0	0	0	0	0	0	0	1	0	55	7	2	4	3	0	12	0	4	0	1	1	0	1	0	25	3	55	3	3	0	0	1	0	1	0	14	2	0	2	10	0	0	5	0	0	0	14	1	11	52	0	11	14	22	5	25	36	0	2	61	0	1	5	0	2	47	28	0	22	0	0	0	0	4	0	0	7	0	6	0	5	0	0	1	0	8	0	5	1	17	8	4	2	0	1	0	0	11	0	11	0	39	0	3	22	21	2	0	2	0	3	0	1	1	0	2	0	0	0	0	1	0	0	10	11	0	0	14	0	6	4	0	2	6	2	0	22	0	0	0	0	32	0	5	1	1	0	18	1	1	0	1	7	4	4	0	0	0	0	11	8	0	11	0	0	1	6	0	3	3	6	6	1	0	0	0	0	0	0	0	0	1	14	0	7	0	0	20	2	2	3	16	11	2	0	0	0	4	0	1	0	4	0	35	44	0	0	0	0	0	0	0	0	1	1	0	0	1	0	0	5	0	0	0	9	1	0	7	0	2	0	0	0	2	0	0	0	2	0	0	0	0	0	0	0	1	22	7	0	22	0	1	0	0	0	2	0	1	0	0	0	0	0	0	0	0	0	0	0	0	0	0	0	0	0	1	16	0	0	37	0	0	0	0	0	1	0	0	2	3	6	0	41	33	0	1	1	5	1	0	0	16	0	0	0	0	4	0	1	2	0	0	1	0	0	0	0	0	0	0	3	0	0	0	0	0	0	0	0	0	0	0	0	0	0	0	0	0	0	2	0	0	0	1	0	0	0	0	0	1	7	0	0	0	0	0	0	0	0	0	3	0	0	1	0	0	0	0	1	2	0	0	0	0	2	0	0	0	0	0	0	0	0	0	0	1	0	0	2	0	0	0	0	1	0	0	0	0	0	0	0	1	0	0	0	0	0	1	0	4	0	0	0	0	0	0	0	0	0	2	1	0	0	0	3	1	3	6	3	0	0	0	0	0	0	0	2	0	0	3	0	2	0	0	0	0	0	0	0	0	0	3	0	0	1	0	0	0	0	1	0	0	0	0	0	0	3	1	0	0	0	0	2	2	1	0	0	0	0	0	0	0	0	0	0	0	10	3	0	19	0	0	0	0	0	0	29	0	0	0	0	0	0	0	0	0	5	0	0	0	0	0	0	0	0	0	0	0	0	0	0	0	0	0	0	6	1	0	0	0	0	0	0	2	0	0	3	0	0	0	0	0	0	0	0	0	0	0	0	0	0	0	0	0	0	0	0	0	0	0	0	1	0	0	0	0	0	0	6	0	0	0	2	2	1	0	6	0	0	9	0	17	1	0	0	0	1	1	0	0	4	1	0	0	3	0	4	22	0	1	1	8	2	0	0	4	2	0	8	0	0	0	30	5	0	0	4	0	0	0	0	0	10	0	0	0	3	0	0	2	3	0	4	4	4	12	4	0	0	0	2	1	0	0	17	0	9	1	3	4	1	1	1	2	0	0	0	0	0	0	0	0	1	0	9	0	0	0	5	3	2	4	0	0	1	11	1	0	9	1	8	6	1	1	5	6	0	1	7	7	2	0	1	28	16	0	0	0	8	8	1	0	0	0	0	0	0	0	1	0	0	0	0	0	0	0	0	0	0	0	0	1	0	0	0	1	0	0	0	2	0	0	1	1	0	0	0	0	0	0	0	0	0	2	0	0	0	0	0	0	0	0	0	0	1	0	0	0	0	0	0	0	0	0	1	0	0	0	0	0	0
PHYLLO15	48387	0	0	0	195	742	77	0	191	1	4	43	39	0	91	2	0	3	0	1	9	0	0	0	25	0	0	12	11	17	6	0	6	17	7	23	26	0	0	0	0	0	0	0	15	0	0	0	0	4	0	0	25	71	204	2	341	12	11	0	43	0	1	11	22	117	0	17	5	0	15	2	0	0	2	5	4	0	0	0	0	0	182	132	56	45	0	35	0	7	1	71	22	73	39	10	59	14	118	0	0	187	3	120	2	75	107	1	17	13	0	2	21	23	0	31	18	17	0	1	44	15	56	5	15	162	37	59	19	12	13	5	0	2	8	6	0	173	32	14	7	68	72	6	5	25	15	2	21	26	5	3	8	8	2	1	2	1	57	40	41	2	3	71	4	52	63	61	11	18	3	16	12	5	6	3	4	4	14	0	11	10	17	11	7	13	36	3	0	1	3	30	3	1	0	18	16	94	2	1	15	6	2	32	7	17	0	27	2	3	66	14	20	0	252	365	4	40	9	20	9	17	28	19	96	6	91	47	38	11	81	8	10	17	1	3	17	0	40	2	29	7	57	18	1	5	0	6	48	15	0	0	64	2	49	2	12	5	68	4	2	1	5	0	3	0	32	16	17	12	14	7	31	4	6	2	0	18	0	48	71	27	32	6	101	85	16	2	41	1	51	0	0	0	57	1	75	0	3	13	1	17	122	7	0	2	2	41	33	67	103	23	22	5	1	15	0	42	1	34	0	56	4	1	1	1	0	8	15	2	0	31	0	0	0	0	1	7	0	13	57	11	6	86	131	2	0	2	34	9	7	1	5	14	75	1	16	21	4	16	24	32	4	7	0	0	17	47	4	46	0	28	13	17	4	15	49	9	13	84	36	32	16	8	2	4	126	84	8	3	251	0	1	0	2	3	3	16	285	1	19	4	67	0	340	47	0	0	15	18	70	75	2	0	2	0	2	2	1	30	92	25	2	0	55	0	38	58	101	0	1	2	0	0	1	19	129	8	6	17	161	1	24	19	22	90	41	30	38	2	5	59	92	32	113	15	12	326	19	22	1	0	2	0	2	2	1	0	3	3	1	2	0	1	2	5	5	2	6	1	82	8	0	17	6	0	0	0	10	8	0	3	2	0	8	0	1	0	0	3	0	4	0	4	0	1	1	5	1	2	0	4	0	0	33	140	139	7	62	9	21	169	9	42	56	7	107	0	58	6	0	1	9	0	17	18	40	17	45	69	5	28	2	7	27	117	22	17	0	8	1	28	17	21	23	5	3	19	54	43	10	21	4	44	22	1	0	0	0	28	7	15	28	50	33	0	102	20	1	22	0	4	4	10	15	1	8	13	3	29	15	5	17	3	0	0	5	1	0	1	0	0	23	33	1	2	6	0	1	2	0	0	38	1	4	9	6	0	51	0	14	0	4	0	2	3	3	0	0	18	0	0	15	0	24	44	3	0	0	17	0	6	25	0	46	0	0	2	0	0	3	15	155	31	10	0	5	17	2	12	74	3	2	0	2	14	55	0	59	4	23	0	14	34	124	0	27	68	36	0	32	30	14	48	17	20	0	2	41	9	2	7	43	0	0	0	7	0	5	1	0	13	18	0	1	1	15	2	11	15	0	50	31	7	14	28	50	10	44	178	14	0	0	40	9	1	0	3	2	33	13	1	0	3	0	6	14	0	10	0	5	24	9	5	15	0	2	15	3	1	28	53	18	21	9	40	0	11	17	0	11	19	8	52	22	5	4	33	7	20	0	12	0	9	21	9	0	7	12	0	49	12	4	0	0	5	7	1	0	1	2	7	0	27	52	1	2	0	0	2	5	19	22	10	13	2	6	0	1	10	6	0	56	17	21	3	6	1	43	11	0	1	19	22	3	8	0	0	1	0	5	0	4	0	0	1	0	0	0	0	23	1	10	13	0	2	8	6	12	16	8	11	13	0	0	0	29	12	0	2	9	7	7	0	0	0	2	5	4	7	4	6	35	9	11	7	12	0	1	2	4	0	5	0	2	48	9	9	22	0	12	0	16	0	10	2	5	0	2	12	4	4	0	0	0	7	0	8	3	7	6	5	16	52	14	11	6	0	82	2	5	0	2	9	15	14	0	1	2	0	0	0	0	4	1	6	0	8	14	10	5	0	6	4	3	0	0	20	9	23	0	10	4	25	20	0	0	8	1	0	112	0	15	2	0	13	1	37	13	0	0	1	0	0	2	3	3	0	49	19	7	92	2	0	0	13	60	33	0	11	2	3	0	0	11	0	0	0	33	1	5	1	7	2	0	0	24	51	14	0	43	3	7	0	25	11	0	0	3	1	61	1	1	1	6	9	53	29	35	17	2	0	0	0	2	7	0	17	6	0	0	0	0	27	2	0	37	0	0	13	0	0	1	21	10	0	8	13	34	0	3	52	0	0	0	2	19	4	0	37	54	1	17	3	2	3	3	2	21	8	11	18	12	6	28	17	9	23	13	10	18	2	0	0	1	1	26	0	28	28	96	55	20	21	44	33	7	9	24	30	2	6	66	17	94	22	23	17	0	15	44	0	13	36	0	36	55	0	4	19	40	25	7	6	0	3	1	0	2	94	8	38	5	31	12	31	26	12	73	3	2	12	38	7	15	6	10	6	0	45	11	0	4	0	19	28	0	46	0	6	1	11	0	6	0	2	15	8	0	1	0	8	0	0	9	5	0	12	6	2	9	1	4	4	6	0	14	1	4	0	1	10	6	6	1	0	1	19	1	12	11	32	2	20	0	10	0	0	0	104	2	0	7	32	22	0	9	3	13	6	4	0	0	1	0	0	0	3	1	3	1	0	6	13	0	4	1	1	1	0	11	0	9	2	17	20	3	35	1	1	8	0	6	12	3	0	0	0	12	1	12	0	2	20	71	0	6	0	0	0	0	9	0	2	0	15	0	5	1	1	1	0	13	0	0	28	0	0	0	0	0	1	8	8	0	0	1	0	1	0	2	19	10	0	0	2	1	5	1	18	0	0	0	2	37	1	0	0	5	0	0	1	11	80	0	11	0	1	2	8	0	9	6	0	33	3	0	17	1	0	0	0	0	0	0	0	1	0	0	12	7	10	17	67	7	15	2	12	0	0	0	2	7	1	71	3	0	0	0	0	0	6	2	2	0	0	0	3	0	0	0	0	0	0	0	0	1	0	5	3	0	1	0	29	0	2	0	10	0	0	1	2	4	0	3	3	4	3	0	0	24	9	0	7	0	0	9	20	0	22	0	0	2	3	0	0	0	5	0	0	8	3	0	2	2	1	4	3	15	32	2	0	0	1	0	45	0	2	7	1	1	0	83	2	9	3	0	0	0	13	2	2	2	0	0	0	0	0	0	0	0	0	0	22	1	23	0	0	0	2	12	2	0	0	0	0	0	2	0	0	9	0	15	5	6	2	7	2	0	1	6	34	0	0	0	2	2	3	9	0	0	0	50	10	2	0	5	0	0	1	0	0	0	0	0	0	2	0	0	0	25	0	0	3	37	12	0	0	0	0	0	63	12	0	4	0	0	8	0	1	0	3	26	7	7	17	29	8	8	5	3	3	5	4	5	1	17	1	2	0	80	6	0	25	17	1	6	4	4	0	0	24	0	10	13	9	0	3	0	1	0	3	14	23	7	8	2	0	3	0	2	25	10	23	9	12	11	2	6	1	0	1	2	0	0	57	6	2	1	0	5	19	5	1	11	9	0	19	0	12	24	1	2	4	0	3	31	12	2	0	5	26	2	5	423	0	13	4	2	8	5	0	13	28	16	8	3	0	4	6	12	12	4	0	13	4	1	11	34	0	0	29	9	1	11	3	6	3	0	1	3	22	2	1	1	1	0	4	6	3	4	16	11	6	1	3	2	4	0	7	0	1	2	1	0	11	10	0	5	0	9	24	5	2	4	3	3	4	6	15	1	11	4	0	4	7	3	25	14	3	15	1	5	0	3	5	2	2	20	5	4	0	0	3	3	1	7	11	64	1	0	0	1	0	2	4	0	1	2	10	2	10	1	8	0	23	1	2	0	26	1	0	27	19	7	1	1	38	0	5	3	8	9	3	1	12	19	25	0	9	21	0	0	10	14	25	0	0	1	4	4	8	0	44	23	49	0	4	17	6	43	0	0	6	1	10	12	0	2	22	19	59	135	137	13	12	18	88	65	11	0	127	80	14	52	20	59	96	33	0	10	11	0	0	0	4	1	7	0	26	44	57	3	20	0	24	94	17	1	0	22	0	1	90	0	49	0	0	1	2	0	22	24	11	2	0	9	9	2	0	76	2	61	1	9	0	0	16	60	7	1	15	2	40	80	0	58	57	58	34	10	2	0	14	11	7	0	0	29	17	63	23	0	19	5	21	1	1	3	6	44	13	14	24	0	0	0	0	45	0	16	3	0	8	0	5	19	0	0	18	0	0	0	0	0	7	2	0	27	7	0	0	22	0	0	0	0	0	0	26	0	0	2	0	0	2	0	0	0	0	0	0	3	5	0	13	0	0	0	0	10	5	2	2	2	9	0	0	16	4	0	9	1	0	12	20	9	0	0	7	0	7	10	0	0	2	5	2	7	0	0	0	0	1	29	1	0	3	13	4	17	4	8	7	13	19	7	0	0	1	87	2	0	0	0	4	4	18	168	20	0	1	3	0	1	0	0	1	1	0	0	0	0	15	0	5	8	10	5	3	0	16	0	2	20	12	0	1	0	3	4	0	0	0	10	0	0	0	0	0	0	4	0	0	7	7	0	0	0	0	0	0	2	0	9	22	0	0	0	2	0	0	5	0	0	0	0	0	0	11	20	1	0	0	4	2	1	2	7	3	19	18	4	5	2	13	9	4	1	0	0	0	0	0	0	26	0	0	3	17	0	20	3	0	0	1	0	0	43	3	0	1	0	0	2	0	24	0	0	1	0	7	8	0	2	0	0	0	0	13	0	1	0	0	1	0	0	5	0	0	1	15	0	3	1	1	14	0	5	1	4	35	28	13	4	5	0	5	4	0	0	0	3	8	49	31	15	0	0	0	189	0	50	2	5	0	4	32	0	12	0	26	21	32	9	0	0	0	8	0	1	0	0	3	0	0	12	0	0	0	0	0	2	0	7	14	5	1	3	3	11	0	0	4	0	0	0	25	20	2	3	2	3	0	4	0	4	1	0	17	4	0	0	0	0	23	2	0	0	0	2	1	1	6	19	9	0	7	0	2	7	1	0	0	1	0	2	0	15	13	3	2	13	1	0	0	8	0	1	0	5	2	0	4	2	1	0	0	0	0	0	1	8	0	2	2	0	0	0	0	11	0	0	1	6	1	1	0	11	16	9	13	18	14	1	2	0	0	50	0	1	26	24	0	0	4	37	28	4	3	0	2	6	2	24	7	7	21	8	31	0	2	0	1	4	1	2	0	5	2	52	1	1	1	14	2	2	1	0	0	3	16	3	5	0	2	13	6	32	16	0	3	0	0	0	3	1	8	0	5	4	0	0	7	1	17	2	3	7	0	0	3	1	7	1	0	0	1	2	0	0	0	0	5	0	0	2	0	4	0	0	1	1	7	0	0	2	0	2	3	4	0	0	0	0	0	0	16	1	1	5	0	0	2	0	1	0	0	0	11	5	2	11	3	0	0	0	1	0	0	0	0	2	0	3	1	3	0	3	5	1	0	0	2	7	0	0	0	0	0	0	0	0	10	17	2	30	8	37	7	0	0	22	0	8	0	1	2	4	0	0	14	9	16	4	0	1	8	0	8	0	0	0	0	0	0	0	2	64	1	3	2	1	0	2	5	0	0	0	0	0	0	0	3	2	1	0	0	0	0	5	7	8	1	0	0	0	6	0	0	1	17	6	3	0	1	0	1	0	0	5	3	1	175	0	1	0	4	0	0	1	1	0	1	0	12	0	2	20	0	1	2	0	0	3	0	39	0	0	8	2	4	0	0	5	11	0	0	2	0	4	7	0	0	0	9	0	0	0	0	0	1	0	9	0	1	0	1	0	0	1	0	9	0	4	1	1	1	1	7	0	1	0	4	0	1	0	0	2	1	0	1	2	0	0	9	4	5	0	9	0	21	0	0	0	0	0	0	0	2	21	0	5	1	0	1	0	0	0	2	0	0	8	2	0	1	0	12	0	7	3	0	0	3	0	0	2	2	1	4	3	4	0	3	4	3	0	1	10	0	6	4	0	5	0	0	7	4	0	0	2	0	0	0	0	0	0	5	12	4	7	4	1	0	2	0	0	2	0	0	4	3	0	4	2	4	9	1	0	0	2	7	3	10	0	0	4	2	0	0	0	2	1	2	3	0	47	3	5	0	1	0	8	36	0	5	0	0	9	5	0	2	2	6	3	4	3	0	4	4	1	0	2	4	10	1	1	2	0	1	1	10	30	1	0	2	1	0	3	3	1	0	8	2	2	2	0	0	0	4	2	0	6	0	1	13	3	0	3	1	2	12	0	4	8	1	0	0	30	0	2	2	9	0	0	0	0	0	0	0	0	0	2	0	0	3	17	0	0	0	3	1	7	5	0	0	1	1	16	0	1	0	0	0	5	3	0	0	0	5	5	2	0	1	6	2	0	1	0	0	0	0	0	0	0	0	0	0	0	0	0	3	24	53	35	3	0	10	7	0	0	39	46	47	0	48	5	5	0	2	0	2	1	0	0	0	0	0	58	5	2	0	6	0	39	0	0	1	0	20	0	0	0	4	0	0	2	0	2	0	0	0	0	0	0	0	1	1	0	9	0	0	0	0	0	0	0	0	15	0	40	0	0	0	3	0	1	2	0	0	0	0	0	2	0	1	7	1	5	0	0	0	24	1	0	1	0	0	2	0	0	0	0	0	0	0	0	0	0	0	0	0	0	7	0	0	0	0	3	27	1	0	0	0	0	0	0	110	1	0	10	0	7	2	1	0	0	51	0	0	0	0	0	0	1	0	0	0	0	36	0	0	15	2	0	0	0	2	0	0	0	0	0	0	0	0	2	1	0	0	4	15	0	2	0	4	6	0	0	9	0	4	0	1	7	6	10	0	0	3	0	12	9	0	1	1	2	0	7	82	7	1	6	0	0	0	0	0	1	1	4	85	80	0	73	0	0	1	0	0	0	0	1	1	1	0	0	0	0	0	0	0	1	0	0	0	0	0	0	9	0	0	9	0	0	1	2	0	0	0	0	0	8	0	7	0	0	2	6	0	0	0	0	3	0	0	0	2	0	3	1	1	2	0	8	0	0	0	4	1	3	1	0	8	3	0	0	2	10	0	0	1	0	4	0	0	0	0	0	0	25	0	1	1	2	1	0	1	0	2	13	0	4	27	0	1	0	0	0	5	1	4	28	1	28	3	28	42	1	15	8	44	15	0	0	0	1	1	22	14	4	0	3	0	11	8	0	2	19	0	3	8	0	8	1	7	0	1	0	16	0	0	0	3	0	0	3	10	0	0	0	0	0	0	0	0	1	0	0	0	0	0	2	0	0	0	9	1	0	1	0	0	3	1	35	0	6	0	15	0	3	0	0	0	0	0	2	1	0	0	7	0	0	4	2	7	1	2	1	1	0	0	0	0	1	0	12	0	12	1	3	15	0	1	0	2	0	0	0	0	41	21	0	0	3	0	0	2	2	0	0	0	7	0	0	0	0	1	0	0	0	0	2	8	13	21	0	6	0	0	0	0	0	0	0	0	0	0	2	1	8	0	4	0	0	0	9	3	0	2	0	0	5	9	4	0	2	5	0	0	0	12	14	0	0	0	0	0	7	1	1	0	0	10	10	2	4	1	0	2	0	0	4	4	0	8	0	14	5	0	0	0	0	0	3	1	7	53	0	0	4	0	0	0	0	1	0	0	1	9	0	4	0	11	0	0	0	2	5	0	0	2	0	0	1	4	0	0	0	27	2	0	0	0	0	12	0	0	3	0	0	2	0	0	0	1	1	1	0	0	1	0	2	6	0	1	0	0	0	4	0	0	8	0	13	1	0	3	23	15	0	4	1	0	5	0	7	0	0	2	0	0	2	2	1	0	1	9	1	0	0	0	0	1	2	1	0	2	0	0	5	2	6	0	0	4	5	0	0	1	18	0	2	0	0	1	1	14	0	0	0	1	3	1	0	0	0	6	1	9	0	2	0	0	0	0	5	0	1	1	0	0	2	3	0	7	2	0	0	0	11	0	3	0	1	2	0	3	7	9	1	5	0	0	0	4	1	1	0	2	0	0	15	2	0	0	0	0	0	0	1	0	1	0	2	0	1	1	3	0	0	0	2	0	2	0	1	0	13	13	0	2	1	0	0	0	11	1	0	0	1	0	0	0	1	1	1	4	0	2	1	0	2	0	1	1	2	2	0	0	0	8	21	0	3	0	6	1	1	0	0	7	1	0	0	0	0	0	0	5	0	0	1	0	5	0	0	0	0	0	0	0	0	0	0	0	1	2	0	0	0	0	2	0	1	1	3	6	0	20	0	0	35	17	0	0	3	0	0	23	0	0	11	0	4	2	8	6	0	0	1	12	0	0	0	18	0	0	0	0	0	16	4	0	0	0	0	26	6	0	0	0	0	0	0	0	0	1	0	1	3	0	0	2	0	0	0	3	2	0	0	0	0	2	8	2	0	0	0	0	0	0	0	0	2	0	8	2	20	0	1	0	1	0	7	1	0	1	0	0	0	0	34	7	0	0	1	0	0	4	1	0	0	0	4	0	0	2	0	0	17	1	0	0	0	0	4	0	0	2	6	11	0	4	0	0	0	0	10	2	0	1	0	0	0	18	8	0	0	3	5	0	0	19	2	0	0	2	2	2	1	0	4	5	0	0	0	0	0	3	2	2	0	2	0	0	2	2	0	0	23	2	5	0	8	1	5	4	16	8	2	3	2	7	2	0	1	0	0	2	0	1	0	1	0	0	0	0	1	0	0	0	2	3	0	0	0	0	0	0	2	0	0	0	0	0	0	1	0	1	0	3	2	1	0	0	1	0	0	0	3	0	0	0	2	0	0	0	0	0	2	0	0	0	11	6	4	0	16	21	1	1	0	2	0	0	0	1	10	0	0	0	2	2	0	0	0	0	0	5	2	2	2	1	0	0	0	2	0	2	0	0	0	0	0	0	0	0	0	1	0	0	2	8	3	1	2	1	1	3	3	3	1	0	3	0	0	0	0	21	0	0	0	2	0	0	0	0	2	0	0	0	0	0	0	1	0	0	1	0	0	1	2	3	0	0	1	0	0	5	2	0	0	0	6	0	0	0	2	3	0	0	1	0	0	0	1	7	0	10	0	0	0	14	0	39	0	0	0	0	0	4	0	2	0	0	1	0	0	2	0	0	1	4	1	0	1	0	0	0	0	1	0	1	0	0	0	0	0	1	0	1	0	0	0	1	3	0	4	2	0	0	0	0	1	2	1	0	2	4	1	0	0	0	1	1	1	0	1	0	1	7	4	3	1	0	0	0	0	0	1	2	0	0	0	1	2	0	0	0	0	1	0	2	1	0	0	0	4	0	0	0	0	3	13	7	0	1	3	0	1	3	0	2	5	5	20	17	7	2	0	1	1	0	0	0	17	0	7	0	0	0	38	40	4	8	28	1	18	0	4	0	17	0	2	0	10	0	0	1	0	1	0	0	27	0	0	0	1	0	2	2	2	11	0	0	0	2	2	3	1	0	0	2	0	0	3	1	3	1	1	2	0	5	0	1	0	0	0	0	0	0	0	0	0	0	0	0	0	0	0	0	0	0	0	0	0	0	20	2	0	3	0	22	0	6	0	23	0	0	0	30	0	0	21	0	0	0	4	15	4	0	88	0	462	13	1	6	4	1	5	5	0	0	0	14	12	2	0	4	0	349	0	25	0	24	1	2	110	6	3	15	32	20	23	25	83	0	0	0	0	1	2	2	1	7	0	0	0	1	0	0	5	0	0	0	0	2	0	0	0	0	6	1	0	0	0	0	0	0	13	12	0	0	2	2	0	0	0	0	5	0	0	2	0	4	0	4	1	0	0	0	0	0	1	0	0	0	0	0	0	23	0	0	0	0	0	0	0	1	3	0	0	20	0	10	0	0	4	0	1	0	0	5	1	0	0	1	0	0	0	0	0	0	0	1	1	7	8	0	0	0	0	0	0	1	0	0	1	1	19	0	9	2	89	0	0	7	5	1	26	0	0	0	4	17	221	10	6	24	0	1	0	0	0	3	0	5	0	1	0	0	0	21	0	6	4	15	1	4	7	5	0	0	0	0	0	0	2	0	1	0	0	0	1	4	4	4	0	0	0	0	18	0	2	0	0	0	1	4	0	0	0	2	3	0	0	0	0	3	0	0	0	1	1	0	0	37	17	0	0	2	0	0	0	0	2	13	0	5	1	0	0	1	0	0	0	0	0	0	0	20	4	144	20	14	0	9	90	114	0	6	3	0	0	19	1	0	17	0	3	16	3	22	24	2	0	1	1	0	0	0	3	26	0	0	3	0	0	0	0	3	0	0	0	0	0	0	0	0	2	3	0	1	1	3	5	1	6	0	4	4	36	0	3	5	35	0	4	5	1	4	58	3	6	1	1	0	1	2	1	9	17	5	1	1	0	1	2	13	9	5	2	6	3	0	0	5	0	0	0	0	23	0	0	0	0	1	1	0	2	0	0	0	0	0	0	0	0	9	0	0	16	16	4	1	6	64	47	1	8	0	1	0	20	0	10	3	5	8	2	3	4	0	6	0	0	1	0	1	0	3	1	0	0	27	1	5	13	0	10	25	0	1	0	1	0	0	2	0	0	0	0	2	3	0	0	2	0	14	4	5	7	7	5	4	0	1	5	20	0	16	17	23	11	0	0	0	2	0	2	0	0	0	1	0	0	0	1	0	0	0	1	0	0	0	1	0	0	0	0	0	2	1	0	1	0	2	0	1	0	0	1	0	0	0	0	1	0	0	0	0	0	0	1	0	1	1	0	1	1	0	0	1	0	0	0	2	0	0	0	0	0	0	0	0	0	3	0	0	0	0	0	18	0	0	0	1	12	0	3	17	0	0	0	10	0	0	0	0	0	0	1	0	2	0	1	3	0	13	0	0	0	3	0	0	1	2	2	1	0	0	0	0	0	0	1	0	0	0	0	0	8	0	2	1	0	0	0	2	0	0	3	0	0	0	0	0	0	0	4	0	0	0	2	4	1	0	1	1	1	1	1	0	0	0	3	2	0	0	0	0	3	0	0	0	0	0	0	0	0	0	0	6	0	1	0	0	0	0	0	1	1	0	0	0	1	0	0	0	0	0	0	0	0	0	2	0	1	1	0	0	3	2	0	0	1	0	1	0	0	0	0	0	0	0	0	7	4	0	0	0	0	0	2	0	1	0	0	6	0	0	0	0	3	0	0	0	0	1	0	0	0	0	0	0	0	0	0	2	0	2	1	0	0	0	0	0	0	1	0	0	0	0	0	7	0	43	0	0	0	0	0	0	0	0	0	0	0	0	0	0	1	1	0	0	0	0	0	0	0	1	0	0	0	0	1	0	2	5	0	0	0	0	0	0	0	0	0	4	4	1	0	1	17	0	0	0	0	0	1	0	0	0	0	0	0	0	0	0	2	0	2	0	0	0	1	7	0	0	0	0	5	0	0	0	0	1	0	0	0	0	2	17	0	0	1	0	0	1	4	2	14	0	0	0	0	0	5	0	0	7	0	0	1	2	4	5	6	0	11	0	29	23	1	0	29	0	0	1	0	0	0	10	1	1	1	0	0	0	2	0	0	0	0	1	1	11	11	0	0	0	4	0	26	0	0	1	0	0	1	0	0	0	9	11	0	0	0	0	30	0	0	0	1	0	0	0	0	1	0	0	0	10	5	0	0	0	0	0	0	0	0	0	1	0	0	0	0	0	0	1	8	0	0	0	2	0	0	0	0	2	1	0	0	0	0	0	0	0	0	0	0	0	0	6	0	1	0	0	1	0	2	0	0	0	0	0	0	1	0	0	0	0	0	0	0	0	5	1	0	0	0	0	0	0	0	0	11	2	4	2	0	0	0	0	0	1	0	0	3	0	0	0	0	1	0	0	0	0	0	1	0	0	0	0	0	6	1	1	0	0	2	2	1	1	0	0	0	9	0	0	0	0	2	0	4	0	3	0	0	2	0	0	0	0	0	0	1	0	0	0	1	0	0	0	1	5	0	1	2	0	0	0	0	0	0	0	0	0	0	2	0	0	0	0	0	0	0	0	2	0	1	1	0	2	2	0	0	0	4	4	0	4	1	1	1	0	0	0	2	0	2	6	1	7	1	1	0	1	0	0	1	0	0	3	0	0	0	1	0	0	0	0	0	0	1	0	4	0	0	0	0	6	0	0	15	3	0	0	4	0	0	0	0	0	0	2	1	0	3	1	2	0	0	0	0	0	0	0	0	0	0	0	0	0	0	0	0	0	2	0	1	8	0	0	14	0	0	1	5	1	3	2	2	0	0	1	0	0	2	0	0	3	0	4	1	0	0	2	2	0	1	0	0	0	0	0	0	0	5	0	0	0	0	3	0	0	1	0	0	0	0	0	0	0	0	0	0	1	0	0	0	0	0	0	2	0	0	0	0	0	0	13	0	1	0	2	0	0	0	0	14	0	1	0	0	27	1	0	1	2	1	0	0	0	3	19	1	0	0	0	1	0	2	0	1	6	11	0	0	2	0	3	1	1	1	14	27	0	0	0	0	0	2	0	0	0	0	2	0	0	1	0	0	0	0	0	0	1	1	0	0	0	0	0	0	2	0	0	0	2	0	0	0	0	0	0	0	9	1	2	0	0	3	1	0	0	0	7	0	1	0	0	3	0	0	0	0	1	0	0	0	0	0	2	1	4	0	1	0	0	0	3	0	0	3	2	0	0	3	0	2	0	0	3	0	0	2	2	0	8	0	16	0	0	0	0	0	0	0	2	43	0	0	0	1	0	0	7	10	0	0	1	1	1	0	0	15	8	5	4	27	7	5	0	5	0	0	105	0	2	2	7	0	2	1	0	0	0	0	0	0	0	32	1	0	1	0	0	0	0	0	2	0	2	0	0	0	0	7	0	1	2	1	0	0	1	1	0	25	0	0	3	2	3	0	0	0	0	0	1	0	8	2	0	2	1	0	4	0	4	0	0	2	0	34	14	2	0	0	4	4	4	2	5	0	0	6	2	0	0	1	0	0	2	1	0	0	0	0	0	0	0	0	2	0	0	0	1	1	0	0	0	1	0	1	3	1	17	0	0	0	0	0	0	0	1	0	0	0	1	1	2	0	0	1	0	1	0	1	0	0	0	0	0	0	0	0	1	0	0	0	0	0	0	0	0	0	0	0	0	0	0	0	0	0	0	0	0	0	0	0	0	0	0	0	0	0	0	0	0	3	0	0	0	0	0	0	0	0	0	0	0	0	0	0	0	0	6	0	6	0	0	2	1	1	0	0	0	0	0	0	0	0	0	0	0	0	0	0	0	1	4	1	0	1	0	2	0	3	0	2	0	0	0	0	0	0	3	2	9	1	0	0	1	0	1	0	1	0	1	0	0	0	0	7	0	0	2	0	0	2	0	1	2	0	0	0	2	0	0	0	0	4	1	0	3	2	0	0	1	3	0	0	0	0	1	0	1	0	0	0	0	0	0	1	0	0	2	0	0	0	0	1	1	0	0	0	0	0	0	0	0	0	0	8	0	0	0	0	0	0	0	0	0	2	0	0	0	3	0	0	0	0	0	0	0	0	0	0	2	1	0	0	0	2	0	0	0	1	0	0	0	1	0	0	0	1	0	0	0	0	1	0	0	1	0	0	0	2	0	0	4	0	1	0	0	0	0	0	0	0	2	0	1	3	0	1	0	0	0	0	0	0	0	0	0	1	0	0	0	2	0	0	1	3	0	0	0	0	0	0	0	2	13	1	8	1	0	0	0	0	2	0	0	0	0	3	0	10	0	0	0	0	0	0	0	0	0	0	0	0	0	0	0	0	0	1	0	0	0	0	0	0	1	0	1	0	0	0	0	0	0	1	24	0	2	0	0	0	0	0	0	0	0	0	0	0	0	1	2	0	0	0	0	0	9	0	0	0	4	0	1	2	1	0	0	0	0	1	0	1	0	0	0	1	0	0	6	0	0	0	0	5	1	0	0	2	3	0	16	0	0	0	0	0	1	1	0	1	1	4	3	3	0	5	1	1	0	0	0	3	0	0	0	0	0	10	0	1	3	30	47	1	0	0	0	0	5	0	0	6	0	1	4	0	1	9	0	0	0	0	0	0	0	5	0	13	0	0	1	6	1	0	0	2	0	2	1	0	0	0	4	0	2	0	18	1	1	4	0	3	0	0	0	0	1	0	1	1	2	0	10	2	5	3	2	6	1	21	0	0	1	0	3	3	0	0	0	1	0	0	2	1	2	0	1	0	0	0	11	20	1	0	1	0	2	0	9	2	0	0	0	0	0	0	0	1	0	1	0	0	0	12	4	1	0	0	1	0	0	0	0	23	0	0	1	0	3	0	0	0	6	0	0	3	0	18	0	0	0	1	0	0	3	0	0	0	0	9	0	0	0	0	2	3	4	0	1	0	0	0	5	0	2	1	0	0	0	0	0	0	0	0	0	0	0	0	0	0	2	0	0	1	0	0	1	3	0	0	0	4	9	0	0	0	3	1	0	0	0	0	21	0	0	0	2	19	2	0	0	0	1	0	0	0	0	1	0	4	0	2	0	0	1	0	0	3	3	0	0	24	0	0	0	0	0	2	0	0	1	0	0	2	0	0	0	0	0	0	1	0	0	0	0	1	0	0	5	1	0	0	0	16	0	0	0	0	1	1	1	38	0	1	0	0	0	0	1	0	1	0	6	0	0	0	1	5	1	0	0	0	0	0	1	0	0	3	0	1	21	1	2	0	0	1	0	0	3	0	1	1	0	0	0	0	0	4	1	0	4	2	0	0	0	0	1	0	0	0	0	0	7	1	0	0	0	0	5	0	0	0	0	1	1	1	1	8	0	1	1	0	3	0	1	0	0	4	2	0	2	1	7	0	3	0	0	0	0	1	0	0	0	0	0	0	0	0	1	1	5	0	0	1	8	0	4	5	7	0	7	0	0	8	0	0	0	0	0	2	2	0	0	0	0	3	0	6	11	1	0	0	3	32	0	32	1	0	0	1	0	0	0	6	0	21	0	4	0	2	0	4	0	0	0	0	4	1	2	1	0	0	0	0	8	1	3	5	0	5	4	0	4	2	11	11	26	1	1	1	0	4	20	24	2	5	1	0	0	1	0	2	0	1	1	0	0	2	112	1	1	0	23	1	2	18	24	0	0	4	0	1	0	0	0	10	0	0	0	0	4	0	2	0	1	0	0	0	0	0	1	0	1	1	0	0	0	0	2	22	3	0	0	0	0	0	0	0	0	2	0	1	9	0	0	0	0	0	0	0	0	0	0	3	0	0	0	2	0	0	0	0	0	1	0	2	0	0	0	0	0	0	10	3	7	0	3	0	0	0	22	1	1	2	0	0	0	1	0	1	0	7	31	31	27	0	0	0	0	11	0	1	0	0	2	9	0	1	1	5	0	8	0	0	19	0	13	7	48	12	0	25	14	39	16	4	42	1	11	186	1	11	1	0	0	4	0	0	0	0	0	0	0	0	4	0	0	0	3	1	4	0	12	0	0	7	18	5	3	0	1	1	0	0	0	6	2	4	0	0	73	2	10	3	0	4	0	0	8	0	9	17	32	8	0	1	35	3	15	5	0	23	0	0	0	0	1	0	0	0	0	1	0	0	0	0	26	10	12	4	0	0	19	3	5	2	0	0	1	0	0	17	1	92	2	3	0	0	18	0	1	4	14	2	0	11	3	0	2	12	1	2	2	10	2	6	40	9	15	15	22	5	29	68	0	0	70	0	1	2	0	0	24	18	0	15	0	0	0	0	3	0	0	19	18	6	0	5	2	0	1	0	2	1	3	1	24	22	14	3	0	0	0	0	19	0	6	0	80	3	3	23	16	7	0	2	0	13	4	2	0	3	13	0	0	0	0	0	0	0	17	3	4	0	1	3	0	2	0	0	2	0	1	26	1	0	0	0	37	0	0	0	2	0	17	0	0	0	9	13	9	4	0	0	0	0	0	8	1	35	0	0	0	10	0	12	4	1	5	7	1	0	1	0	0	0	0	0	1	8	0	0	0	0	34	0	4	4	13	14	2	1	4	0	8	3	0	1	5	0	29	44	4	4	0	1	0	0	0	0	1	0	0	0	0	0	0	1	0	1	0	11	0	0	15	2	0	3	0	0	1	0	0	0	20	3	0	0	1	0	0	1	0	20	1	0	10	0	2	0	2	2	0	0	3	0	0	0	0	0	0	0	0	3	0	1	1	0	0	2	0	0	1	17	0	0	2	0	0	1	0	1	0	0	2	0	0	28	0	17	12	0	1	0	0	0	0	2	1	0	0	0	0	1	0	1	10	1	0	0	0	0	0	0	0	0	0	0	0	0	0	0	0	0	1	0	0	0	0	0	1	0	1	0	0	2	0	0	0	1	4	0	0	0	0	0	0	8	0	0	0	0	0	0	0	1	0	1	0	4	0	0	0	0	0	0	0	0	0	0	0	3	0	0	0	0	0	0	0	0	0	0	0	1	0	0	0	0	0	0	0	0	0	0	0	0	0	0	0	0	0	0	0	0	0	2	0	1	1	0	1	0	0	13	0	0	0	0	0	1	0	2	0	2	8	2	0	0	0	0	0	0	1	0	0	0	1	0	0	0	0	0	0	0	0	0	0	0	1	0	0	1	0	0	0	0	0	1	2	0	0	0	0	1	0	0	0	0	0	3	1	0	0	2	2	0	2	0	0	0	2	0	0	4	0	0	34	0	1	0	0	1	0	5	0	0	0	0	0	0	0	1	0	18	0	0	0	0	0	0	0	0	1	0	0	0	2	0	0	0	2	0	3	7	1	0	0	5	3	0	0	0	0	2	0	2	0	0	0	0	0	0	0	0	0	0	0	0	0	0	0	1	0	0	0	0	2	0	0	0	0	0	0	0	0	5	0	2	1	1	10	0	0	3	0	0	6	3	60	4	0	0	1	2	3	1	1	11	5	0	0	2	0	6	6	1	0	0	0	0	0	0	2	0	0	10	2	0	1	76	5	0	0	3	4	0	0	0	2	6	0	1	1	0	2	1	2	7	0	0	0	0	6	0	0	0	2	2	2	3	4	13	1	11	0	0	9	0	9	3	2	0	0	0	0	0	2	0	0	3	2	5	3	0	0	2	2	2	1	1	0	0	3	0	0	14	9	5	3	0	1	0	8	0	0	12	4	1	0	0	14	30	0	0	0	5	5	0	0	0	1	1	0	0	0	2	0	0	0	2	0	0	1	0	0	2	0	1	0	0	0	0	2	0	0	0	0	0	0	0	0	10	0	0	0	0	0	0	0	0	0	0	0	0	0	0	0	0	0	0	0	0	0	0	0	0	1	0	0	0	0	1	0	0	0	0	1	0
PHYLLO16	54893	0	0	0	202	844	107	0	223	2	3	52	55	0	81	2	0	0	0	1	5	0	0	2	34	2	0	19	13	23	3	0	2	25	5	23	26	0	1	0	0	0	0	0	13	0	0	0	0	8	0	0	34	89	145	2	466	10	6	0	22	0	0	13	35	116	0	16	1	0	22	10	0	0	4	5	0	0	0	0	0	0	266	146	73	43	0	39	0	22	0	77	24	88	41	17	51	12	114	1	0	194	0	162	1	84	132	1	13	11	4	0	30	25	1	50	12	18	0	1	72	27	72	3	23	175	56	62	14	13	3	5	0	5	8	3	1	193	40	12	30	56	66	6	3	35	19	1	16	27	3	1	12	9	3	0	4	8	41	51	22	2	10	73	6	78	60	82	19	37	7	11	27	0	8	3	1	7	22	1	29	6	21	7	4	11	26	1	2	3	7	30	3	1	0	12	24	101	0	1	8	3	4	30	7	28	1	28	3	8	77	6	22	0	288	423	3	32	1	27	5	15	30	16	148	6	104	73	26	11	93	9	4	24	1	2	14	0	66	6	29	18	77	17	2	5	0	5	40	12	0	2	97	2	64	1	6	20	94	5	2	10	5	0	1	0	17	22	30	16	28	12	21	1	7	0	0	38	0	25	71	12	26	7	107	107	10	4	24	3	47	0	0	1	47	3	77	0	1	19	0	16	102	5	0	0	0	50	21	51	90	14	18	15	0	19	0	46	4	45	1	59	10	3	1	8	6	4	7	4	0	26	0	0	1	0	0	1	0	5	83	15	2	77	175	9	1	0	25	4	3	9	11	11	77	1	25	15	7	16	23	23	3	12	1	1	36	54	13	42	0	32	11	23	2	32	79	14	3	90	28	49	11	14	6	2	104	45	17	5	275	0	3	0	6	2	16	15	373	1	25	3	99	0	397	42	0	0	7	42	88	84	1	0	0	5	5	0	2	40	85	30	4	0	57	6	27	95	138	1	2	4	0	0	1	26	118	6	9	26	142	2	47	26	36	84	32	25	58	3	9	65	91	28	119	34	22	454	22	35	10	0	54	11	51	17	41	0	0	0	5	5	3	0	3	1	1	4	5	0	96	14	2	5	5	0	0	0	2	10	0	0	5	0	19	0	0	1	0	0	0	3	1	0	0	0	2	5	0	8	1	5	0	0	39	182	109	11	67	5	28	214	5	83	90	11	122	0	68	15	1	4	11	0	27	30	44	16	72	84	4	28	4	4	29	115	41	19	0	11	1	29	7	25	36	6	9	20	67	45	15	24	2	51	17	1	0	0	0	35	9	8	4	29	26	0	111	35	0	25	0	15	10	11	26	1	4	15	12	26	20	4	11	2	0	0	1	1	0	0	0	1	18	52	1	14	21	0	0	0	0	1	53	0	2	5	5	1	51	1	10	0	4	0	12	3	1	0	0	7	0	4	24	0	10	50	8	0	0	14	0	8	20	0	41	2	0	1	0	0	12	16	220	9	10	0	8	28	1	11	43	3	5	0	1	10	84	4	77	1	6	0	8	52	161	10	19	85	36	1	35	56	19	41	18	15	0	0	30	18	5	7	59	0	0	0	0	0	6	1	0	12	26	0	0	1	18	3	3	14	0	36	21	14	33	39	63	22	56	204	16	2	0	61	16	0	0	2	8	28	16	1	0	1	0	18	38	0	17	0	8	22	5	8	6	0	0	16	2	0	22	51	24	22	10	59	0	25	26	0	8	18	6	61	20	12	9	39	10	13	0	16	0	27	27	9	0	11	24	0	50	19	1	0	1	1	5	1	0	0	0	4	0	33	33	0	4	0	0	10	3	23	22	16	16	4	3	1	0	6	10	0	52	11	25	4	4	2	44	11	0	1	31	20	7	7	0	0	4	0	0	0	5	0	0	0	2	1	0	0	37	3	14	14	0	0	9	8	16	12	16	7	6	3	0	0	20	6	0	7	16	6	5	3	0	0	1	15	1	5	1	0	27	8	6	14	15	1	1	1	11	0	3	0	2	63	4	7	3	2	12	1	12	0	9	1	3	0	4	17	8	3	0	1	0	2	0	6	1	15	5	5	16	68	16	10	6	0	85	2	1	0	0	11	15	6	0	0	3	0	0	0	1	3	1	16	0	4	12	12	8	3	0	0	5	0	0	42	4	12	0	8	4	21	10	2	2	3	0	0	158	0	26	1	3	15	2	21	5	0	0	4	0	0	0	3	4	0	45	29	2	145	1	0	0	6	62	34	0	14	0	12	1	0	6	0	0	1	11	1	7	0	2	0	0	0	28	90	12	0	34	2	9	0	16	6	0	0	2	3	56	0	1	1	6	16	48	50	40	28	3	0	1	1	1	6	0	19	5	0	0	0	0	25	0	0	41	0	0	11	0	0	0	21	8	0	5	5	32	0	3	47	0	1	2	5	20	6	0	52	65	0	27	0	2	6	5	4	12	13	11	23	14	8	24	16	5	38	16	5	16	3	0	2	2	0	24	0	29	23	92	77	19	36	48	35	22	17	42	31	0	6	65	11	78	14	26	25	2	20	47	0	7	44	0	41	69	1	2	32	22	27	3	4	0	8	0	0	0	76	7	35	9	30	20	29	32	23	62	5	1	4	30	1	14	6	39	1	0	61	4	0	4	0	45	28	0	58	0	7	1	13	0	8	0	0	12	7	0	3	0	9	0	2	12	2	0	4	7	4	12	2	2	4	3	0	18	0	0	0	6	5	8	9	6	0	1	23	1	4	29	28	2	19	0	12	0	1	0	127	0	0	10	29	23	0	4	8	6	5	4	0	0	0	0	0	0	5	0	7	0	0	6	6	6	6	11	3	0	0	15	0	10	0	20	27	5	31	0	0	4	1	13	16	1	0	0	0	10	1	30	0	3	30	85	5	5	0	0	0	0	1	3	3	1	14	0	4	5	0	1	0	9	0	0	15	0	1	0	0	0	0	8	6	1	1	0	2	3	0	0	12	13	3	0	2	0	6	2	15	0	2	0	10	46	7	0	2	7	0	3	2	26	114	1	6	0	1	0	8	1	3	7	0	31	1	0	17	4	0	3	0	0	0	0	0	0	0	0	18	0	25	17	72	5	17	0	18	0	2	2	10	8	0	66	1	0	0	0	0	1	6	0	3	0	0	0	2	0	0	0	0	0	0	0	0	6	0	8	8	0	2	0	40	6	2	2	2	0	0	0	11	6	0	14	7	5	0	0	0	12	5	0	0	0	0	4	16	0	23	0	0	1	3	0	0	1	7	1	0	3	3	0	1	6	0	10	2	8	25	0	0	1	7	1	71	0	2	6	2	0	0	84	3	7	5	6	0	0	20	5	1	1	0	0	0	0	1	1	0	1	0	0	31	0	20	0	2	0	0	2	0	0	2	0	0	0	0	0	0	12	0	21	9	18	4	11	1	2	3	5	40	0	0	0	4	4	6	2	7	0	0	53	6	5	0	5	0	0	1	0	0	0	0	0	1	0	0	0	1	9	0	0	10	81	18	0	0	0	0	0	78	18	0	3	0	4	3	0	0	0	6	39	3	9	18	33	12	15	5	5	0	3	3	2	0	20	0	1	0	37	1	2	31	5	0	1	10	1	0	0	24	0	10	12	12	0	4	0	4	0	3	11	19	4	8	0	0	5	0	0	19	11	13	17	8	6	0	0	0	0	1	1	1	0	44	6	5	0	0	4	27	12	0	14	13	2	8	0	13	12	1	1	0	1	2	60	5	0	4	7	31	1	5	550	0	7	5	1	1	6	2	17	35	21	1	0	0	4	7	9	10	1	0	19	2	3	7	43	1	1	16	11	8	8	7	3	5	2	2	3	42	0	2	4	2	1	4	5	0	3	23	9	10	11	2	1	10	0	4	0	3	0	2	3	16	10	6	2	0	0	49	6	2	4	0	0	7	6	12	5	10	7	1	12	8	2	34	16	3	19	1	5	0	0	3	4	1	17	8	1	0	0	1	21	0	1	9	81	1	0	2	0	0	1	6	0	0	0	11	3	16	0	13	1	11	3	0	6	28	0	0	30	11	7	2	2	58	0	2	0	18	11	2	0	14	40	18	3	3	16	2	1	7	9	27	0	0	2	7	2	11	0	46	51	45	0	4	27	5	36	0	3	9	2	12	21	0	0	25	24	68	169	168	15	16	21	92	67	13	0	155	106	11	47	28	82	145	66	1	10	15	0	0	0	4	8	9	0	24	41	75	1	32	1	37	122	36	0	1	33	0	7	87	0	60	0	0	6	1	0	46	51	15	2	0	9	9	0	4	61	5	74	0	4	0	0	14	64	6	1	23	10	69	84	0	63	62	61	21	11	0	0	22	28	3	0	0	44	24	48	22	0	28	10	3	0	2	0	2	71	10	11	29	0	1	0	0	65	0	15	19	0	15	0	4	17	0	0	21	1	0	0	0	0	4	1	0	51	4	0	0	48	0	0	0	0	0	1	11	3	0	1	1	0	1	1	0	0	0	0	0	5	5	0	19	0	0	0	1	16	4	0	5	0	17	0	0	5	2	0	25	1	0	17	26	8	0	6	0	0	13	9	0	0	1	0	2	5	1	0	0	1	4	17	0	0	7	11	3	30	3	0	16	38	46	3	0	0	1	88	0	0	0	0	3	11	25	195	18	0	3	4	0	0	1	2	11	0	0	0	0	0	12	1	5	4	19	1	10	0	38	3	3	11	7	1	0	0	7	15	0	2	0	14	0	2	0	0	0	0	4	0	1	3	1	0	0	0	0	0	2	3	0	17	22	1	2	0	1	0	2	5	0	2	0	0	0	0	12	22	1	0	1	1	0	1	0	15	10	7	8	8	10	0	8	6	11	1	2	0	0	0	0	0	19	2	0	1	1	0	21	12	2	1	0	0	0	68	2	0	0	0	0	0	2	14	0	0	0	0	0	14	0	14	1	0	0	0	20	1	0	0	0	0	1	0	27	4	0	1	9	0	13	0	0	18	0	0	1	4	28	28	8	8	6	0	6	6	1	1	0	9	7	50	37	37	0	0	0	196	0	39	4	2	0	1	25	0	12	4	23	20	22	16	0	0	0	2	0	0	0	0	1	0	1	14	0	0	0	0	0	2	0	6	7	9	1	11	2	13	0	2	1	0	0	0	50	23	8	4	0	5	2	11	4	0	8	0	10	6	1	0	0	0	12	6	2	0	0	3	2	0	1	0	3	0	0	0	1	5	0	0	0	1	2	8	0	20	11	9	2	11	1	2	1	14	0	0	0	10	0	0	4	2	0	1	0	0	5	2	0	10	0	0	2	0	0	0	0	4	0	0	6	10	5	3	0	25	7	16	4	11	6	1	0	0	0	70	0	10	38	35	0	0	2	42	34	1	0	2	2	0	2	25	11	8	32	3	47	0	0	0	5	8	0	2	0	3	0	42	0	3	1	7	1	2	0	0	1	4	18	1	4	0	0	29	6	27	16	1	5	0	0	0	0	2	8	4	3	2	1	0	6	0	12	0	1	7	0	0	1	0	0	2	4	0	1	2	1	0	0	3	3	4	1	2	0	0	0	2	3	0	4	2	0	10	0	0	15	0	0	0	0	0	0	1	16	4	0	2	0	0	1	0	0	0	0	2	13	5	0	6	0	2	0	0	0	0	0	1	1	7	0	2	0	2	0	4	2	9	0	0	1	5	0	1	4	3	0	2	0	0	4	21	3	22	5	30	20	3	0	20	0	2	0	1	2	1	0	0	18	9	15	3	0	1	19	0	16	0	2	1	0	0	0	0	0	83	0	8	4	0	0	0	5	2	0	0	0	0	0	0	5	6	4	1	0	0	0	4	6	3	1	0	0	3	6	0	0	0	11	3	0	1	0	2	0	1	0	6	4	0	225	0	1	0	5	0	0	0	0	0	0	0	8	0	3	23	0	1	4	1	0	5	0	40	0	0	8	0	2	0	2	1	23	1	0	0	0	0	12	0	0	0	16	0	0	0	0	0	0	1	12	0	0	0	0	0	0	0	1	11	0	1	0	1	0	0	5	0	0	1	3	0	0	0	0	3	2	0	0	0	0	0	12	0	4	6	8	0	17	0	0	0	0	0	0	0	1	14	0	7	1	0	1	0	0	0	0	1	0	3	8	0	7	3	4	0	7	1	0	0	0	1	0	0	1	0	0	0	2	3	2	11	0	0	8	6	2	1	5	0	10	2	3	19	6	0	2	1	3	4	1	0	0	0	8	7	2	8	2	0	0	0	3	0	0	2	0	2	2	0	0	0	2	16	1	2	1	10	1	5	6	0	2	3	1	5	0	0	2	0	1	2	0	50	0	2	1	2	0	10	24	0	5	0	0	6	8	0	0	1	2	3	1	5	3	0	4	0	0	0	4	5	0	0	3	0	2	3	5	28	0	0	2	2	0	1	1	1	0	3	1	8	8	6	2	0	1	1	0	3	0	1	37	2	0	2	0	0	24	0	8	9	0	0	0	39	0	0	4	10	0	0	0	0	0	0	0	0	0	0	0	0	1	1	0	0	0	2	0	10	1	0	0	0	5	18	0	0	0	1	0	4	4	1	1	2	1	2	5	2	2	7	0	1	4	0	1	0	0	2	1	0	0	2	1	0	5	0	7	35	85	47	16	0	17	18	0	0	87	80	81	0	82	3	4	0	0	0	1	0	0	0	0	0	0	67	4	2	0	7	0	79	0	0	0	0	20	0	0	0	0	0	2	6	0	0	0	0	4	3	0	0	10	0	0	0	27	0	4	0	0	0	1	0	0	6	0	30	0	0	0	1	0	0	0	0	0	0	0	0	0	0	0	6	0	6	0	0	0	30	0	0	0	0	0	7	2	2	0	1	1	0	0	0	0	2	2	2	0	0	13	0	1	1	0	4	9	4	0	0	0	0	0	0	140	0	0	5	0	8	1	1	0	0	44	0	0	0	0	0	0	0	0	0	0	0	56	0	0	14	2	0	0	0	0	0	0	0	0	0	1	1	0	0	0	0	0	4	9	0	3	0	4	4	2	0	6	0	1	0	6	18	3	15	0	0	0	0	14	2	0	3	0	0	2	8	95	5	2	4	0	0	0	3	0	0	0	7	87	90	1	89	0	0	0	0	0	0	2	0	2	3	0	0	2	0	0	0	1	1	0	0	0	0	0	0	12	0	0	2	2	0	0	3	2	0	0	0	0	2	0	14	0	0	0	17	0	0	0	0	3	0	1	0	0	2	4	0	2	0	0	2	0	0	1	2	5	2	3	0	3	6	3	6	0	20	3	5	3	2	6	1	0	0	4	0	2	28	0	2	2	1	0	0	0	0	1	12	1	3	15	0	0	0	0	0	0	0	15	30	2	31	8	34	87	0	14	11	54	7	0	0	0	2	1	27	17	1	4	0	3	19	4	3	1	4	3	2	2	0	3	0	4	0	1	0	2	3	0	0	0	0	1	2	8	1	4	0	0	1	1	2	0	15	0	0	0	1	0	2	0	0	6	10	0	0	0	0	0	0	4	38	0	14	0	17	0	0	1	0	0	2	3	0	1	0	2	3	0	0	7	0	5	0	2	2	2	0	0	0	2	2	0	6	0	9	5	1	14	0	3	2	3	0	0	0	0	29	7	0	0	5	0	0	3	5	1	0	0	6	1	1	0	0	2	0	0	1	0	2	24	31	7	3	17	0	0	0	4	0	1	0	0	0	3	1	0	0	0	1	0	0	1	14	1	0	2	1	0	1	6	1	3	4	4	3	0	0	5	4	1	3	1	0	0	3	1	0	4	0	15	14	0	2	0	1	2	0	0	0	1	2	11	0	20	6	0	1	0	0	1	3	2	3	44	0	0	9	0	1	0	4	0	0	2	0	16	0	0	0	6	0	0	0	4	1	0	0	0	1	2	0	2	0	1	0	15	1	3	1	0	0	16	0	0	1	1	0	0	3	0	0	1	3	0	0	0	0	0	1	7	1	2	0	0	0	3	2	1	11	1	5	0	0	0	17	23	1	11	0	2	8	0	16	0	0	2	0	0	2	1	1	0	0	8	0	0	0	0	0	0	1	1	0	1	0	0	0	1	2	0	0	1	0	2	0	0	21	2	1	0	0	3	2	7	0	1	0	2	9	2	0	0	1	4	0	18	1	5	2	0	0	1	0	1	2	0	0	0	2	5	1	1	1	0	0	1	9	3	3	0	0	2	1	0	4	10	0	0	0	1	0	0	0	2	0	3	0	0	9	0	2	0	0	0	2	0	5	0	0	1	0	3	0	1	0	0	1	0	3	0	0	1	0	7	9	9	0	10	3	0	0	0	11	1	0	0	1	0	2	2	1	0	6	2	0	3	0	0	2	0	0	1	0	0	0	1	0	8	14	0	2	0	17	0	0	1	0	2	0	0	0	0	0	0	0	0	1	0	0	0	5	0	0	0	1	0	0	0	0	1	2	0	1	2	0	0	0	1	2	0	0	0	2	9	0	26	0	0	43	12	0	0	7	1	0	15	1	0	10	0	11	0	3	5	0	2	4	9	1	0	0	16	0	0	0	0	0	10	5	0	0	0	0	21	2	0	0	3	0	0	0	0	0	2	2	2	5	0	0	0	0	0	1	6	0	0	0	0	2	1	0	1	0	1	0	0	3	0	0	0	0	0	9	0	29	0	0	0	0	1	0	2	0	0	0	0	0	0	15	2	0	0	0	1	0	2	0	1	1	0	2	1	1	0	0	0	27	0	1	0	0	0	0	1	0	0	4	13	3	1	0	0	1	1	8	2	0	0	0	0	3	12	6	0	0	3	15	0	1	14	0	0	0	6	3	1	0	0	2	5	0	0	0	0	0	3	1	0	1	4	0	3	0	1	0	0	19	0	3	0	2	1	4	3	18	7	6	3	0	5	0	1	0	0	1	3	0	0	0	2	0	1	3	0	0	0	0	1	0	1	0	1	2	0	0	1	0	0	0	0	1	0	0	2	1	0	0	3	0	0	0	0	0	0	0	0	1	0	1	0	0	1	1	0	0	2	0	4	1	0	16	4	2	0	7	24	0	0	1	4	7	0	1	1	8	1	0	0	1	0	1	0	0	0	0	6	0	4	0	0	0	0	0	0	0	1	0	0	0	2	0	0	0	0	0	4	0	0	0	0	4	0	0	0	5	0	0	0	2	0	3	0	4	0	0	7	0	2	0	2	0	0	0	0	4	0	0	0	0	0	4	0	0	0	2	0	0	0	0	0	1	3	0	1	0	4	1	0	0	0	2	0	0	0	5	3	0	0	0	1	0	1	0	2	0	12	0	0	0	7	0	31	0	0	1	0	0	0	0	0	0	1	3	1	0	0	0	0	0	5	2	1	0	1	0	0	0	0	1	0	0	2	2	0	0	0	0	1	0	0	0	1	4	0	1	1	0	0	0	0	0	0	1	0	1	0	0	2	0	0	0	0	0	0	0	2	0	10	1	3	0	0	0	0	0	0	0	0	0	0	0	0	0	0	0	0	0	0	0	0	0	0	0	0	16	0	0	6	0	3	16	14	0	0	3	0	2	3	0	0	10	8	20	19	3	0	2	0	0	3	1	0	13	0	11	0	0	0	58	59	3	1	44	4	0	2	0	0	16	0	1	0	15	0	0	2	0	0	1	0	30	0	0	0	0	0	1	0	0	3	0	0	0	0	0	19	0	0	0	0	2	0	8	6	2	0	6	0	0	8	0	0	3	0	0	2	2	0	0	0	0	0	1	1	1	0	6	1	0	2	0	0	0	0	15	1	0	0	0	44	1	5	0	19	0	0	5	26	1	0	48	0	1	1	1	11	6	0	86	0	468	16	10	5	19	11	0	0	0	0	0	10	17	0	0	2	0	555	0	28	3	22	0	1	121	29	0	13	32	21	22	24	111	0	1	0	0	0	0	9	1	11	1	0	0	0	0	0	7	0	0	0	0	1	1	0	0	0	7	0	0	0	0	0	0	0	9	9	0	1	0	0	0	0	0	0	8	0	0	0	0	7	0	10	1	0	0	0	0	0	1	0	0	0	0	0	0	29	0	1	1	0	4	0	0	2	2	0	0	21	7	7	0	0	3	0	5	0	0	1	0	1	0	0	0	1	1	0	0	1	0	9	0	8	19	0	2	0	0	0	0	0	1	0	0	2	24	0	22	0	67	0	0	9	9	0	51	0	0	0	2	20	171	10	7	52	0	0	0	1	0	1	0	5	0	0	4	1	0	10	0	4	5	14	2	5	9	9	2	0	0	0	0	0	2	0	2	1	0	0	1	0	0	0	1	2	4	0	22	0	3	0	2	0	2	8	0	0	0	0	0	0	0	1	2	1	0	0	0	0	0	0	0	15	11	0	0	2	0	0	0	0	0	11	0	0	1	0	0	0	0	0	1	0	0	0	0	19	8	171	31	8	0	7	101	149	0	5	2	0	0	5	0	2	23	0	2	15	0	36	17	2	0	11	1	0	0	1	4	27	0	0	3	0	0	0	4	1	0	0	0	0	1	0	0	0	0	12	1	0	0	8	18	0	6	0	3	4	20	0	11	3	16	0	8	0	1	2	55	0	1	0	0	0	0	1	3	0	12	8	0	0	0	0	0	5	6	4	1	3	2	0	0	4	0	0	0	0	22	0	0	0	0	1	5	0	0	2	1	0	0	0	0	0	0	13	2	0	6	23	6	4	6	108	74	0	13	0	0	2	16	0	0	10	4	15	0	5	19	0	10	0	2	3	0	4	0	0	0	2	0	37	4	1	14	0	10	31	0	0	0	1	0	0	1	0	1	0	0	0	2	0	0	2	0	25	11	15	4	2	14	6	0	0	0	21	3	8	14	22	7	0	2	0	0	0	0	0	0	0	0	0	0	0	0	0	0	0	0	0	0	0	0	0	0	0	0	0	0	1	0	0	0	1	0	0	0	0	2	1	1	0	0	0	0	0	0	3	1	0	0	2	0	0	0	2	0	3	0	0	0	0	0	0	0	0	2	0	0	0	0	1	2	1	0	0	0	0	0	11	0	0	0	4	12	0	9	22	0	0	0	15	0	0	0	0	2	0	1	0	1	1	2	3	0	6	0	0	4	5	1	0	0	3	5	0	0	0	0	0	0	0	0	0	0	1	0	0	9	0	0	2	0	0	0	0	0	0	1	0	0	0	0	0	1	0	2	0	0	0	0	0	1	0	0	3	0	0	3	0	2	1	3	2	0	1	0	0	2	0	0	0	0	0	0	1	0	0	0	2	0	0	0	0	0	0	0	2	0	2	0	2	0	0	0	0	2	0	0	0	0	2	0	0	1	2	0	0	0	1	0	0	1	0	0	0	1	0	0	0	0	2	0	3	7	0	0	0	0	2	3	1	0	1	0	9	0	0	0	0	1	0	0	0	0	0	0	0	0	5	1	0	3	0	0	4	0	0	3	0	0	0	0	0	0	0	0	0	0	0	1	4	0	28	6	0	0	0	0	0	0	0	1	2	0	0	6	6	0	2	0	0	1	0	0	0	0	2	0	0	0	1	0	0	0	3	0	4	0	0	0	0	0	0	0	5	9	0	0	0	22	0	0	0	0	1	1	0	1	0	1	0	0	0	1	0	0	0	3	0	1	0	0	10	1	0	0	0	2	0	0	2	0	3	0	0	0	0	0	11	3	0	0	0	2	2	7	6	5	0	0	0	0	0	9	0	1	12	0	0	0	1	0	5	7	0	4	0	60	23	2	0	26	0	0	2	0	0	3	3	0	3	2	2	0	0	0	0	0	1	0	0	1	12	13	0	0	0	1	0	22	0	1	7	0	0	0	0	0	0	20	14	1	1	0	0	38	0	0	0	2	2	0	0	0	0	0	0	0	9	3	0	0	0	2	0	0	1	0	0	0	0	0	0	0	0	0	0	3	0	1	0	2	0	0	2	0	0	1	0	0	0	0	0	0	2	0	0	0	0	1	2	0	0	1	0	2	0	0	0	2	0	0	0	0	1	0	0	0	1	1	0	0	0	2	1	0	0	0	0	0	0	0	0	3	2	2	8	0	0	0	0	0	0	0	0	1	0	0	0	0	0	0	0	0	0	0	0	0	0	2	0	0	2	0	1	0	0	6	0	3	0	0	0	0	11	0	2	3	0	1	0	0	0	4	0	0	0	0	0	0	0	0	0	2	0	0	0	0	0	0	0	0	5	2	4	0	0	0	0	0	0	0	0	0	0	0	0	0	0	0	0	0	0	3	0	0	0	0	0	0	3	0	0	1	0	1	4	0	4	2	0	0	0	0	0	0	0	0	0	0	6	2	0	0	0	0	0	0	0	2	0	0	0	0	4	0	0	2	0	2	0	1	1	1	0	0	0	0	7	0	2	4	6	0	0	5	0	0	0	1	0	2	0	0	0	11	0	1	0	0	0	0	0	0	0	0	1	0	0	2	1	4	0	2	0	3	0	1	3	0	0	3	1	0	0	4	9	1	1	1	0	0	0	1	0	11	0	1	0	2	4	0	0	2	3	0	0	0	2	0	0	0	0	0	1	6	0	0	0	0	1	0	1	0	1	0	0	1	0	0	0	0	0	0	2	1	0	0	0	1	0	0	0	0	0	0	0	0	14	0	0	0	0	0	1	0	0	4	0	2	0	0	19	1	0	1	0	2	0	1	0	1	11	0	0	0	1	3	5	3	0	2	2	6	2	0	1	0	0	0	0	0	5	35	0	0	0	0	0	1	0	0	1	0	0	0	0	0	0	0	0	1	0	0	0	0	0	0	0	0	0	0	0	0	0	1	3	0	0	0	0	0	0	1	12	0	0	0	0	3	0	0	0	0	1	0	0	2	0	3	0	0	0	0	0	0	0	0	0	0	0	2	4	1	2	1	0	0	3	0	0	3	0	0	0	3	0	0	0	0	3	0	0	2	4	2	8	3	3	0	0	0	1	0	0	0	2	79	0	0	0	0	0	0	15	9	2	1	0	0	0	0	0	16	3	6	10	38	5	0	0	6	2	1	116	0	3	1	0	6	0	4	1	0	0	0	0	0	0	29	6	0	4	0	0	1	0	0	0	0	2	0	0	0	0	13	0	8	0	1	0	0	5	0	0	32	0	0	3	0	3	0	0	0	0	0	0	0	7	1	0	0	21	0	12	0	9	0	0	0	0	30	19	3	0	1	0	0	0	0	16	0	1	4	0	0	0	1	0	2	0	0	0	0	0	0	2	1	1	0	1	0	0	1	0	1	0	0	0	0	1	0	2	1	19	0	0	0	1	1	0	1	0	0	0	0	1	0	2	1	0	2	1	0	0	0	0	0	0	0	0	0	0	0	0	0	0	0	0	0	0	0	1	0	1	2	1	1	1	0	1	0	0	0	0	0	0	0	0	0	0	0	0	0	0	1	0	0	1	1	0	0	0	0	0	0	0	0	0	0	0	0	0	0	3	0	0	0	0	0	1	0	0	0	0	0	0	1	0	1	0	0	0	0	1	1	0	1	4	0	0	0	0	1	1	1	0	0	0	0	3	0	2	0	0	0	6	0	2	0	1	0	1	0	1	1	0	0	0	0	2	9	0	0	0	0	0	2	3	0	4	0	0	0	0	0	0	0	0	1	1	0	9	0	0	0	1	3	0	0	0	2	0	3	0	0	0	0	0	1	0	0	0	0	0	0	1	0	0	1	0	0	0	0	0	0	1	0	0	1	0	0	0	1	0	0	0	0	3	0	0	0	0	0	0	0	2	1	0	1	0	0	0	0	1	0	1	0	0	1	0	0	0	0	5	1	0	0	0	0	0	0	0	0	0	0	2	2	0	0	0	1	0	0	0	1	0	0	6	4	2	0	0	0	0	1	0	0	4	1	0	3	3	1	0	1	0	1	0	0	0	0	0	0	0	0	0	2	0	0	3	1	0	0	0	0	0	0	0	3	8	0	5	0	0	0	0	0	0	0	1	0	0	4	0	0	0	0	0	2	0	2	0	0	0	1	0	0	0	0	0	0	2	2	0	0	0	0	0	0	0	0	1	0	0	0	0	0	0	0	15	2	1	0	3	0	1	0	1	0	0	0	0	0	0	0	3	0	0	0	0	0	5	0	0	0	1	1	0	0	1	0	0	0	0	1	0	0	0	0	3	0	0	0	1	1	0	0	0	7	0	0	0	4	4	2	22	1	0	0	0	0	1	1	0	3	3	4	0	0	1	0	3	0	0	0	0	11	0	0	0	0	3	11	2	1	0	9	48	1	0	0	1	0	1	0	0	4	0	0	8	2	0	6	0	0	0	0	0	0	0	14	0	14	1	0	0	1	0	0	0	1	0	0	0	0	0	0	8	1	2	1	29	0	6	1	0	2	0	0	0	0	4	0	0	0	0	0	2	1	7	1	0	4	5	25	0	0	0	0	0	2	3	0	0	0	0	0	1	0	0	0	1	0	0	0	13	25	0	0	0	3	2	0	9	0	5	0	0	0	0	0	0	9	0	1	0	0	0	17	6	0	0	1	1	2	0	0	0	29	0	0	5	0	1	0	0	0	15	0	0	2	0	15	0	0	3	1	0	0	4	1	0	0	0	9	1	5	0	1	0	3	0	0	0	0	0	0	15	0	3	0	7	7	0	0	1	0	0	1	0	1	0	1	0	0	0	0	1	1	0	0	2	2	0	2	0	0	6	0	0	0	3	0	0	0	0	0	25	0	0	0	1	14	1	0	3	0	0	1	0	1	0	0	1	3	0	6	0	0	2	0	1	0	0	0	0	16	0	0	0	0	0	4	2	3	0	0	0	0	0	1	1	1	0	0	5	0	0	0	0	0	1	0	7	0	0	0	0	20	0	0	0	0	1	0	0	42	1	2	0	0	0	0	1	1	0	0	0	0	0	0	3	8	3	0	0	0	0	2	0	0	0	1	1	0	37	0	0	0	0	0	0	2	8	0	4	1	5	0	1	2	0	1	0	0	2	0	0	0	0	0	2	0	0	0	0	0	4	1	1	0	0	0	2	0	0	0	0	0	0	1	0	0	0	0	0	1	3	0	0	0	1	0	1	1	6	0	0	2	2	3	0	0	0	0	0	1	0	0	0	0	0	0	3	1	1	0	0	0	1	1	2	5	17	1	4	0	0	20	1	2	0	0	0	0	0	1	0	0	0	0	3	7	28	0	1	1	6	33	0	47	0	0	0	1	0	0	1	2	0	24	0	0	0	0	2	2	0	0	2	0	2	6	0	6	1	1	1	0	5	0	0	4	1	4	0	0	7	0	7	6	22	4	0	3	2	5	18	39	0	5	0	0	2	0	2	3	0	0	0	0	0	3	130	0	0	0	14	0	3	16	19	0	0	2	3	0	1	0	0	5	1	0	0	0	4	0	5	0	2	0	1	0	2	2	0	0	0	3	0	0	1	0	2	30	0	0	1	1	2	0	0	0	0	3	0	0	5	0	0	0	2	3	0	0	0	0	0	2	0	0	1	0	1	0	0	0	0	0	0	1	0	1	0	0	1	0	3	7	3	2	3	1	0	0	13	0	0	2	0	0	2	1	0	0	1	15	55	60	58	0	0	0	0	5	1	0	0	3	1	8	1	0	0	0	0	0	1	1	23	0	15	6	65	24	0	46	25	62	9	2	40	0	5	190	6	21	5	0	0	1	1	0	2	0	0	0	0	1	3	0	0	0	6	0	7	0	1	0	0	11	10	11	5	0	0	0	0	0	2	5	0	7	0	0	49	2	16	19	0	1	0	1	13	7	13	27	16	14	0	0	34	2	27	2	0	12	1	0	1	0	0	0	0	0	0	1	3	0	0	0	7	13	14	0	2	0	21	2	5	1	0	0	0	0	0	34	3	80	3	3	3	3	38	1	0	5	8	3	1	9	6	0	1	13	0	0	1	6	2	10	33	6	17	17	22	4	26	56	0	2	126	0	1	10	1	0	19	16	0	18	0	0	1	0	0	1	0	20	0	5	3	4	1	0	0	0	6	4	4	2	27	16	12	2	0	0	4	0	12	0	8	1	68	2	2	24	21	10	1	2	0	8	3	2	1	4	7	3	9	0	0	2	0	0	30	6	5	1	6	1	1	5	0	2	4	0	3	40	2	0	4	2	25	0	1	0	2	0	27	1	3	3	8	8	7	2	0	1	1	0	0	6	2	33	0	0	2	21	0	11	4	4	1	6	1	0	1	2	0	0	0	1	3	3	0	0	2	0	197	2	2	9	7	19	1	6	11	2	13	3	0	0	4	0	23	29	4	3	0	0	0	0	0	0	1	2	1	0	0	0	1	0	0	0	0	11	0	0	11	2	0	1	3	0	1	0	0	0	26	0	0	0	0	1	0	2	0	39	6	0	13	2	14	1	2	0	0	0	0	0	0	1	0	1	1	0	0	1	0	2	6	0	0	0	0	0	1	22	0	0	11	0	0	0	0	0	0	0	5	0	1	19	0	28	24	0	0	0	0	0	0	1	0	0	0	0	0	0	0	2	2	0	0	2	0	0	4	0	0	0	0	1	0	0	1	0	0	0	1	0	0	0	0	0	0	0	0	0	0	1	0	0	0	1	3	0	0	1	0	0	0	4	0	0	0	0	0	0	2	1	0	7	1	2	0	0	0	0	0	0	0	0	0	0	0	1	1	0	0	2	0	1	0	0	0	0	2	0	1	0	1	0	0	1	2	0	0	0	0	0	1	0	0	0	2	0	2	0	0	0	0	0	0	0	0	0	0	8	0	1	0	0	0	1	0	5	3	5	18	5	1	0	0	0	0	0	0	0	0	0	2	0	0	0	0	0	0	0	0	0	0	1	2	0	0	0	0	0	2	0	0	0	0	0	2	0	0	1	0	0	0	0	2	0	3	0	1	5	2	0	0	0	0	0	2	0	0	1	0	0	38	0	0	0	0	0	0	3	0	0	0	2	0	0	0	1	0	13	0	1	0	0	0	0	1	0	1	0	0	0	1	1	0	0	13	0	6	2	0	0	0	5	5	0	0	0	1	2	0	0	0	0	0	0	0	0	2	0	1	0	1	0	0	1	0	2	0	0	2	0	0	0	3	0	0	0	1	0	0	0	0	0	0	0	0	0	0	5	0	0	5	4	48	9	0	0	10	2	7	21	21	6	2	0	4	10	0	3	2	2	1	0	7	1	2	0	6	0	2	10	0	0	0	107	2	3	0	0	0	0	1	0	0	3	2	0	0	1	2	0	0	7	0	0	0	0	7	0	0	0	0	12	8	0	3	8	12	9	1	0	0	3	3	2	0	0	0	0	0	1	0	0	0	7	0	2	3	1	0	1	0	0	1	0	0	0	14	3	0	0	7	3	6	0	0	1	5	0	0	14	8	7	2	1	15	13	0	0	0	6	6	1	0	0	0	0	0	0	0	0	0	0	0	0	0	0	0	0	1	0	0	1	0	0	1	0	1	0	0	0	0	0	0	0	0	0	0	0	0	0	0	0	0	0	0	0	0	0	0	3	1	0	0	0	0	0	0	0	1	0	0	0	1	0	0	0	0	0	0	0	2	0
PHYLLO17	12592	0	0	0	75	273	30	0	65	0	2	14	17	0	9	1	0	0	0	1	0	0	2	0	12	0	0	5	2	9	2	0	5	6	0	2	4	0	0	0	0	0	0	0	3	0	0	0	0	0	2	0	12	44	33	2	103	4	0	0	18	0	0	2	8	23	0	2	0	0	5	0	0	0	0	0	0	0	0	0	0	0	69	44	22	33	0	12	0	9	0	23	4	32	24	5	13	1	22	0	0	15	2	68	0	21	38	0	4	0	0	0	9	6	0	22	1	8	0	0	14	7	19	0	7	22	9	24	1	2	0	4	0	1	0	0	0	56	4	2	7	12	15	0	0	18	1	0	4	11	1	0	0	0	0	0	0	1	27	9	4	0	2	31	1	8	22	22	5	4	0	7	9	0	0	1	0	0	5	0	4	0	7	3	5	7	17	0	0	1	0	9	0	0	0	3	3	35	0	0	3	2	0	3	3	3	0	4	0	0	24	1	2	0	60	91	4	6	1	3	4	8	8	4	43	2	20	11	10	1	24	1	1	4	0	0	0	0	16	0	1	1	19	2	0	6	0	2	7	8	0	1	5	1	12	0	0	3	16	1	1	1	1	0	2	0	10	7	4	0	7	3	6	0	1	0	0	2	0	13	14	2	2	1	24	29	2	0	3	0	7	0	0	4	7	0	23	0	1	0	0	4	49	3	0	0	0	8	8	14	19	6	2	1	0	0	0	12	0	4	0	7	1	0	0	1	1	0	0	0	0	4	0	0	0	0	1	0	0	1	15	10	0	17	63	0	1	0	4	2	1	1	4	0	21	0	6	7	3	6	9	5	2	0	0	0	8	11	0	8	0	5	5	3	2	6	8	2	2	25	7	11	4	4	0	3	21	9	5	3	105	0	1	0	1	0	2	2	71	0	7	0	16	0	114	9	0	0	0	2	29	19	4	0	1	1	0	0	0	5	32	5	1	0	11	0	11	24	15	0	1	1	0	0	0	6	25	1	0	12	54	0	3	7	8	22	14	10	11	1	1	14	21	7	22	3	6	43	1	11	0	0	7	0	9	5	5	0	0	0	0	0	2	0	0	0	0	0	1	0	20	1	0	2	0	0	0	0	1	1	0	0	1	0	1	0	0	0	0	0	0	0	0	2	0	1	1	6	0	1	3	0	0	0	8	45	32	3	19	2	6	42	4	17	25	2	36	0	28	5	0	2	3	0	9	9	4	4	13	17	0	11	0	2	2	22	3	1	0	2	1	4	2	4	1	3	3	15	9	10	6	7	0	14	6	0	0	0	0	11	2	0	0	5	8	0	28	14	0	6	0	2	4	4	2	0	2	6	1	9	1	0	1	1	0	0	0	0	0	0	0	0	5	5	0	2	1	0	0	1	0	0	10	0	1	1	8	0	5	0	4	0	0	0	2	1	0	0	0	2	0	0	6	0	6	4	4	0	0	4	0	0	4	0	6	2	0	0	0	0	3	9	56	0	6	0	3	7	0	3	10	0	1	0	0	2	25	0	3	0	6	0	3	10	23	2	6	13	4	0	6	17	3	4	8	8	0	0	6	5	3	3	22	0	0	0	0	1	2	1	0	2	6	0	0	0	18	1	1	0	0	7	10	6	5	7	8	3	8	15	1	2	0	15	9	0	0	2	1	17	2	1	0	1	0	2	9	0	1	0	1	2	0	3	2	0	0	1	3	0	1	29	5	8	2	21	0	3	0	0	2	1	3	9	3	4	1	13	0	4	0	4	2	8	7	1	0	0	1	0	6	3	2	0	0	0	0	0	0	0	0	0	0	4	2	0	2	0	0	1	3	1	3	2	6	0	1	0	0	0	0	0	9	3	4	2	0	0	17	1	0	0	5	17	0	3	0	0	0	0	0	0	0	0	0	0	0	0	0	0	8	0	2	2	0	2	4	0	4	2	0	3	2	0	1	0	11	5	0	0	9	2	0	0	0	0	0	2	0	0	0	0	2	2	3	2	3	0	0	0	0	0	0	0	0	8	0	0	1	2	1	0	4	0	0	0	0	0	0	3	3	2	0	1	0	2	0	0	0	4	0	1	6	21	3	1	2	0	12	0	0	0	0	2	5	2	0	0	0	0	0	0	0	0	0	0	0	1	2	5	0	0	0	0	0	0	0	18	1	1	0	1	0	9	1	0	1	1	0	0	44	0	2	0	0	2	2	3	0	0	4	0	0	0	0	0	2	0	8	2	1	34	0	0	0	0	13	1	0	5	2	3	0	0	0	0	0	0	3	2	0	0	2	0	0	0	5	27	1	0	10	0	2	0	2	4	0	0	0	0	8	0	1	0	1	4	7	15	14	6	3	0	1	1	0	2	0	7	5	0	0	2	0	11	0	0	7	0	0	9	0	0	0	3	1	0	1	0	1	0	0	4	1	0	0	0	1	2	0	16	14	0	2	0	0	0	1	0	4	2	0	5	1	0	6	2	2	8	7	0	4	1	0	1	0	0	10	0	5	7	23	15	12	4	8	1	19	5	9	11	0	1	29	9	44	3	3	4	0	5	12	0	2	3	2	8	10	0	2	6	6	5	5	0	0	0	0	0	0	8	8	10	1	7	6	6	6	3	7	0	0	1	10	0	1	5	23	2	0	15	1	0	0	0	2	3	0	12	0	12	1	2	0	0	0	0	3	1	0	2	0	1	0	0	2	7	0	2	1	0	1	0	0	3	1	0	3	0	1	0	1	0	1	1	0	0	0	5	0	1	2	4	0	7	0	2	0	0	0	17	0	0	1	3	4	0	0	2	2	0	0	0	0	0	0	0	0	1	0	0	0	0	0	4	0	5	1	0	0	0	7	0	3	0	2	3	1	3	0	0	2	0	1	4	0	0	0	0	0	0	4	0	3	3	26	0	2	0	0	0	2	0	0	0	0	13	0	1	0	0	1	0	0	0	0	11	0	0	0	0	0	0	4	3	0	0	0	0	0	0	0	0	3	0	0	0	0	1	1	1	0	0	1	0	20	0	0	0	2	0	0	0	4	21	0	0	0	0	0	2	0	1	4	0	3	2	0	2	0	0	0	0	0	0	0	0	1	0	0	2	0	6	1	13	3	6	0	6	2	0	1	0	0	0	13	0	0	0	0	0	0	4	1	1	0	0	0	3	0	0	0	0	0	0	0	0	6	0	0	3	0	0	0	1	0	0	0	0	0	0	0	3	1	1	1	1	3	0	0	0	5	1	0	0	0	0	1	1	0	2	0	0	0	0	0	0	0	3	0	0	3	0	0	1	0	2	3	0	5	7	0	0	1	0	0	19	0	0	1	1	0	0	22	2	1	3	1	0	0	5	0	0	0	0	0	0	0	0	0	0	0	0	0	17	0	6	0	0	0	0	0	0	0	2	1	0	0	0	0	0	3	0	3	0	7	0	3	0	0	0	0	5	0	0	0	3	1	0	0	1	0	0	11	2	0	1	0	0	0	0	0	0	0	0	0	0	0	0	0	0	1	0	0	1	34	2	0	0	0	0	0	10	1	0	0	0	1	0	0	0	0	2	6	0	3	5	8	1	3	3	3	0	0	0	1	0	12	0	4	0	5	0	0	7	1	0	0	0	1	0	0	7	0	2	7	3	1	0	0	0	0	0	2	1	0	0	0	0	1	0	0	8	5	4	6	1	3	0	0	0	0	3	0	0	0	14	1	0	0	2	0	9	2	0	0	2	0	0	0	2	9	0	0	0	0	1	3	3	0	3	3	14	0	1	94	0	0	0	0	0	1	0	11	16	3	0	8	0	1	3	2	0	0	0	1	0	0	0	20	0	0	4	3	0	2	0	0	5	0	1	0	8	1	0	0	0	0	0	0	0	0	4	1	0	5	0	1	0	0	1	0	0	0	0	0	2	2	0	1	0	0	11	3	0	2	0	0	1	0	4	1	5	1	0	0	0	1	1	2	1	7	0	1	0	0	0	1	0	9	0	0	1	0	1	4	0	0	1	16	0	0	0	0	0	0	0	0	0	0	4	0	7	0	4	0	3	1	0	0	4	2	0	0	0	0	0	0	28	0	0	0	2	2	0	0	3	5	4	0	1	3	1	0	2	2	11	0	0	0	1	0	5	0	10	21	8	1	0	4	0	18	0	0	2	0	0	17	0	0	4	4	14	61	58	10	10	2	32	22	2	0	35	22	5	7	3	26	44	17	1	2	2	0	0	0	1	2	1	0	4	33	22	4	11	0	19	30	4	0	0	7	0	0	16	0	9	0	0	0	1	0	4	6	6	0	0	1	1	0	0	20	0	21	0	1	0	0	3	13	2	1	3	4	14	17	0	8	8	8	4	4	0	0	6	4	0	0	0	11	2	13	5	0	5	2	1	0	0	0	0	18	1	1	15	3	0	0	0	20	0	1	1	0	0	0	3	11	0	0	3	0	0	0	0	0	3	2	0	18	3	0	0	8	0	0	1	0	0	0	4	1	0	1	0	0	0	0	0	0	0	0	0	2	5	0	0	0	0	0	0	4	0	3	6	0	2	0	0	1	0	0	7	1	0	3	3	1	0	3	0	0	1	1	0	0	0	0	0	0	0	0	0	0	2	7	0	0	1	0	0	1	0	0	8	2	2	0	0	0	0	19	1	0	0	0	2	5	7	58	8	0	2	0	0	0	0	0	1	0	0	0	0	0	4	0	4	0	0	0	4	0	17	0	0	0	6	0	0	0	2	2	0	0	0	9	0	0	0	0	0	0	0	0	0	1	0	0	0	0	0	0	0	1	0	0	1	3	0	0	0	0	0	4	0	0	1	0	0	0	6	1	0	0	1	0	0	0	0	3	1	2	1	3	1	0	4	0	2	0	0	0	0	0	0	0	0	0	0	3	0	0	4	1	0	0	0	0	0	10	0	0	1	0	0	0	0	0	0	0	0	0	0	5	0	4	0	0	0	0	1	2	0	0	1	0	0	0	3	0	0	1	0	0	2	0	0	6	1	1	0	0	12	11	2	2	2	0	0	0	0	0	0	0	1	6	11	8	0	0	0	16	0	5	0	5	2	0	7	0	3	1	10	10	8	0	0	0	0	0	0	0	0	0	0	0	1	0	0	0	0	0	0	0	0	3	2	1	0	5	1	0	0	1	0	0	0	0	4	2	7	1	0	0	0	0	0	2	0	0	1	0	0	0	0	0	2	0	0	0	0	0	0	0	0	0	1	0	0	0	0	0	0	0	0	0	0	0	0	2	5	5	0	5	0	0	1	4	0	0	0	1	0	0	0	0	0	0	0	0	0	3	0	1	0	0	0	0	0	0	0	0	0	0	0	2	2	0	3	2	3	1	0	0	2	1	1	0	0	6	0	1	7	7	0	0	0	17	15	0	0	0	0	0	0	7	1	0	1	0	3	1	0	0	1	1	0	1	1	0	0	17	1	0	0	1	2	0	0	0	0	0	7	0	3	0	0	4	5	9	0	0	0	0	0	0	0	0	0	1	1	0	0	0	2	0	5	0	0	0	0	0	0	0	0	0	0	0	0	0	0	0	0	0	1	0	0	0	0	0	0	0	0	0	0	0	0	2	0	0	0	0	0	0	0	0	0	0	3	0	0	0	0	0	0	1	0	0	0	0	7	1	0	0	2	0	0	0	0	0	0	0	0	4	0	0	0	0	0	0	0	0	0	0	0	0	0	0	0	0	0	0	0	0	1	1	0	8	1	4	8	0	0	3	0	0	0	0	0	0	0	0	1	0	3	2	0	0	3	0	7	0	0	0	0	0	0	0	1	16	0	2	0	0	0	0	4	0	0	0	0	0	0	0	3	2	0	0	0	0	0	1	0	0	0	0	0	0	2	0	0	0	1	3	0	0	0	0	0	0	0	0	1	0	53	0	0	0	0	0	0	0	0	0	0	1	5	0	0	1	0	0	0	0	0	0	0	2	0	0	0	0	0	0	0	0	3	0	0	0	0	0	3	0	0	0	6	0	0	0	0	0	0	0	2	0	0	0	0	1	1	0	0	3	0	0	0	0	0	0	1	0	1	0	0	0	0	0	0	0	0	0	0	0	0	0	1	0	3	0	0	0	4	0	0	0	0	0	0	0	0	1	0	6	0	0	0	0	0	0	0	0	0	0	1	0	0	2	1	0	1	2	0	1	0	0	0	0	0	0	1	0	0	0	2	8	0	0	0	0	0	0	4	0	1	0	0	0	0	0	0	1	0	2	0	0	0	0	6	0	1	6	0	0	0	0	0	0	0	0	0	0	0	0	0	0	0	0	0	0	0	0	1	0	2	1	0	0	0	0	0	0	0	0	0	0	0	7	0	0	0	0	0	3	2	0	1	0	0	0	0	0	0	0	0	1	0	0	0	0	0	0	0	0	0	2	0	0	0	0	0	0	0	0	0	1	0	0	0	0	0	1	0	1	0	1	1	0	1	0	0	0	0	0	0	0	10	0	0	0	0	0	1	0	0	2	0	1	4	7	0	0	0	1	0	1	0	0	0	0	0	0	0	0	0	0	0	4	0	0	0	0	0	0	0	0	0	0	2	1	0	1	0	0	0	1	0	1	2	0	2	2	0	0	0	0	0	0	0	0	0	2	0	0	0	0	0	0	0	0	0	0	0	10	35	12	3	0	5	1	0	0	21	22	22	0	21	0	0	0	0	0	0	0	0	0	1	0	0	12	0	3	0	1	0	23	0	0	0	0	3	0	0	0	0	0	0	0	0	0	0	0	0	0	1	0	2	0	0	0	8	0	1	0	0	0	0	0	0	4	0	5	0	0	0	0	0	0	1	0	0	0	0	0	1	0	0	0	0	0	0	0	0	3	0	0	0	0	1	2	0	0	0	0	1	0	0	0	0	0	0	0	0	0	4	0	0	0	0	1	0	0	0	0	0	0	0	0	27	0	0	0	0	0	0	0	0	0	27	0	0	0	0	0	0	1	0	0	0	0	15	1	0	8	0	0	0	1	0	0	0	0	0	0	0	0	0	0	0	0	0	0	1	0	0	0	1	0	1	0	0	0	2	0	2	1	1	1	0	0	0	0	3	0	0	0	0	0	0	0	20	1	0	0	0	0	0	0	0	0	0	0	17	18	0	19	0	0	0	0	0	2	1	0	0	0	0	0	0	0	0	0	0	0	0	0	0	0	0	1	0	0	0	0	0	0	0	1	0	0	0	0	0	1	0	0	0	0	0	7	0	0	0	0	0	2	0	0	0	0	0	0	0	0	0	1	0	0	0	0	2	1	0	0	0	0	0	0	0	0	0	1	0	0	0	0	0	0	0	0	0	6	0	0	0	0	0	0	0	0	0	1	0	2	1	0	0	0	0	0	0	0	0	6	0	8	0	10	17	0	2	2	15	0	0	0	1	0	0	6	3	0	0	1	2	3	0	0	0	2	0	0	0	0	6	0	3	0	0	0	2	0	0	0	0	0	0	0	0	0	0	0	0	0	0	1	0	0	0	0	0	0	0	0	0	0	0	0	0	0	0	0	0	1	0	18	0	5	0	6	0	0	0	0	0	0	0	0	0	0	0	0	0	0	0	2	1	0	0	0	0	0	0	0	0	0	0	0	0	2	0	0	3	0	0	0	3	0	0	0	0	6	0	1	0	2	0	0	2	0	0	3	0	0	1	0	0	0	0	1	0	0	0	0	5	1	0	0	7	0	0	0	0	0	0	0	0	0	3	0	0	0	0	0	0	0	0	4	0	0	2	0	0	1	2	1	0	0	1	0	0	0	4	4	0	3	0	0	0	3	0	0	0	0	2	1	1	0	0	0	0	0	0	0	0	0	3	0	2	0	0	1	0	0	0	0	0	0	9	0	0	3	0	0	0	0	0	0	0	0	1	0	0	0	0	0	0	0	0	1	0	0	0	0	0	0	1	0	0	0	0	0	0	0	0	0	1	0	0	0	0	0	0	1	0	0	0	0	0	0	0	0	0	0	2	0	0	0	0	0	1	0	0	2	0	0	0	1	0	0	7	0	0	0	0	0	0	7	0	0	2	2	1	0	0	5	0	0	0	0	0	0	0	0	0	0	0	0	1	0	0	0	1	0	0	0	1	0	0	0	0	1	0	0	0	0	0	0	0	0	0	0	0	0	0	0	0	0	0	0	4	1	0	0	0	0	1	0	0	0	0	0	0	0	0	0	0	0	0	0	0	3	0	0	1	0	0	0	0	1	0	0	0	0	1	0	0	0	0	0	2	0	0	11	0	0	0	0	0	1	0	2	0	0	1	0	0	3	0	0	0	2	0	0	0	0	0	0	4	10	11	0	0	2	0	0	0	1	0	0	0	0	0	0	0	0	2	0	0	0	0	0	0	1	0	0	0	0	0	0	0	0	1	1	0	0	0	2	0	0	0	0	2	0	0	0	0	0	0	0	0	0	0	0	0	0	0	0	0	0	0	0	0	0	0	0	0	0	0	0	0	0	0	0	1	0	0	0	1	0	13	0	0	7	1	0	0	0	0	0	7	0	0	1	0	5	0	2	0	0	0	1	0	0	0	0	7	0	0	0	0	0	8	3	0	0	0	0	3	0	0	0	0	0	0	1	0	0	1	0	0	0	0	0	0	0	0	0	0	0	0	0	0	0	0	1	0	1	0	0	0	0	0	0	0	0	0	1	0	2	0	0	0	0	0	0	0	0	0	0	0	0	0	3	2	0	0	0	0	0	3	0	0	0	0	0	0	0	0	0	0	9	0	0	0	0	0	0	0	0	0	1	7	0	0	0	0	0	0	0	2	0	0	0	0	2	0	2	0	0	0	0	0	0	0	1	0	0	0	1	0	0	0	0	0	0	0	0	0	0	0	0	1	0	2	0	0	2	0	0	0	7	0	0	0	0	0	0	0	3	3	1	0	0	0	0	0	0	0	0	2	0	0	0	0	0	0	2	0	0	0	0	0	0	0	0	0	0	0	0	0	0	0	0	1	0	0	0	0	0	0	0	0	0	0	0	0	0	0	0	0	0	0	1	0	2	0	0	0	0	0	0	0	0	0	3	1	1	0	3	3	0	3	0	2	0	0	0	5	4	0	0	0	0	0	0	0	0	0	1	1	0	0	0	0	0	0	0	1	0	0	0	0	0	0	0	0	0	0	0	0	0	0	0	0	0	0	0	0	0	0	0	0	4	0	0	0	0	0	0	2	0	0	0	0	0	0	0	0	0	0	0	0	0	0	0	0	0	0	0	0	0	0	0	0	0	1	1	0	0	3	1	0	0	0	0	0	0	0	0	0	0	0	0	0	0	0	0	0	0	2	0	0	0	1	0	1	0	0	0	0	0	0	0	1	0	0	0	0	0	2	0	0	0	1	0	2	0	0	0	0	0	0	0	0	0	0	0	0	0	0	0	0	0	0	0	1	0	0	0	0	0	0	0	0	0	0	0	0	1	0	0	0	0	0	0	1	0	0	1	0	0	14	0	0	0	0	0	0	0	0	0	0	0	0	0	0	0	0	0	0	0	0	0	0	0	0	0	0	0	0	0	0	0	2	5	2	0	0	1	0	1	1	0	0	0	1	10	7	1	0	0	1	2	0	0	0	4	0	0	0	0	0	21	21	3	0	5	0	0	0	0	0	0	0	0	0	3	0	0	1	0	1	0	0	5	0	0	0	1	0	0	0	0	1	0	0	0	0	0	3	0	0	0	0	0	0	5	15	1	6	16	0	2	17	0	0	0	0	0	1	0	0	0	0	0	1	1	1	1	0	13	1	0	0	0	0	0	0	0	0	2	0	0	5	0	0	0	2	0	0	0	3	0	0	7	1	2	0	0	0	2	0	22	0	101	2	0	0	1	0	0	0	0	0	0	4	5	3	0	0	0	61	0	7	0	11	1	0	37	8	1	10	9	1	5	6	28	1	0	2	0	0	0	1	1	0	0	1	0	0	0	0	0	0	0	0	0	0	0	0	0	0	0	0	0	0	0	0	0	0	3	3	0	0	2	0	0	0	0	0	0	0	0	0	0	1	0	2	0	1	0	2	0	0	1	0	0	0	0	0	0	4	0	0	0	0	0	0	0	0	2	0	0	8	0	2	0	0	0	0	2	0	0	0	0	0	2	0	0	0	0	0	0	0	0	0	0	2	5	0	1	1	0	0	0	0	0	0	2	0	7	0	6	0	18	0	0	1	2	0	3	0	0	0	0	7	41	2	12	12	0	0	0	0	0	1	0	1	0	0	0	0	0	0	0	0	4	4	1	3	5	4	0	0	0	0	0	0	0	2	0	0	0	0	0	1	1	1	0	0	0	0	4	0	0	0	0	0	0	0	0	0	0	0	0	0	0	0	0	0	0	0	0	0	0	0	0	3	3	0	0	0	0	0	0	0	0	0	0	0	1	0	0	0	0	0	0	0	0	0	0	1	1	43	6	2	0	3	19	43	0	1	2	0	0	0	0	0	2	0	1	0	0	22	0	0	0	0	0	0	0	0	2	1	0	0	0	0	0	0	4	0	0	0	0	0	0	0	0	0	0	4	0	0	4	6	4	0	0	0	0	1	1	0	0	0	2	0	0	0	0	0	32	0	0	1	1	0	1	0	0	0	1	0	0	0	0	0	0	2	2	0	1	3	0	0	1	0	0	0	0	0	4	0	0	0	0	0	0	0	0	0	0	0	0	0	0	0	0	4	0	0	1	3	1	0	1	11	8	0	8	0	0	0	9	0	0	2	0	5	1	0	1	0	0	0	0	0	0	0	0	0	0	0	0	4	0	0	1	0	2	14	0	1	0	0	0	0	0	0	0	0	0	0	0	0	0	0	0	5	3	3	1	1	3	1	0	0	0	6	0	1	4	6	0	0	0	0	0	0	0	0	0	0	0	0	0	0	0	0	0	0	0	0	0	0	0	0	0	0	0	0	0	0	0	0	0	0	0	0	0	0	0	0	0	0	0	1	0	0	0	0	0	0	0	0	0	0	0	1	0	0	0	0	0	0	0	0	0	0	0	0	0	0	0	0	0	0	0	0	0	0	0	8	0	0	0	0	2	0	0	3	0	0	0	2	0	0	0	0	0	0	0	0	0	0	0	0	0	0	0	0	2	0	0	0	1	0	0	0	0	0	0	0	0	0	0	0	0	0	0	0	1	0	1	0	0	0	0	0	0	0	0	0	1	0	0	0	0	0	0	0	0	0	0	0	0	0	0	1	0	0	0	0	0	0	0	1	0	0	0	0	2	0	0	0	0	0	0	0	0	0	0	1	0	0	0	0	0	0	0	0	0	0	0	0	0	0	0	0	0	0	0	0	0	1	0	0	0	0	0	0	0	0	0	0	0	0	1	0	0	0	0	0	0	0	0	0	0	0	0	0	1	0	0	0	0	0	0	0	0	0	0	0	0	0	0	0	0	0	0	0	0	0	0	0	0	0	0	0	0	0	0	0	0	0	0	0	0	1	0	2	0	0	0	0	0	3	0	0	0	1	1	0	0	0	0	0	0	0	0	2	0	0	0	0	0	0	1	0	0	1	0	0	0	0	0	0	0	2	0	0	0	0	0	0	0	0	0	0	0	0	0	0	3	0	0	0	0	0	0	0	0	0	0	0	0	0	0	0	0	0	0	0	0	0	0	0	1	0	0	0	2	0	0	0	0	0	0	0	0	0	0	3	2	0	0	0	0	0	0	0	0	0	0	0	0	0	1	0	0	2	0	0	0	1	0	0	0	0	1	3	11	1	0	0	7	0	0	1	0	0	0	1	0	1	0	0	0	0	0	0	0	0	1	0	0	7	7	0	0	0	4	1	6	0	0	1	0	0	0	0	0	0	1	1	0	0	0	0	7	0	0	0	1	0	0	0	0	0	0	0	0	3	2	0	0	0	0	0	0	0	0	0	0	0	0	0	0	0	0	0	0	0	0	0	0	0	0	0	0	0	0	0	0	0	0	0	1	0	0	0	0	0	0	0	0	0	0	0	0	0	0	0	0	0	0	0	0	0	0	0	0	0	0	0	0	0	1	0	0	0	0	0	0	0	0	0	0	1	1	2	0	0	0	0	0	0	0	0	0	0	0	0	0	0	0	0	0	0	0	0	0	0	0	0	0	0	0	0	0	0	0	0	0	0	0	0	0	1	0	0	0	0	0	0	0	0	0	0	0	0	1	0	1	0	0	0	0	0	0	0	0	0	0	2	0	1	0	0	0	0	0	0	0	0	0	0	0	0	0	0	0	0	0	0	0	0	0	0	0	0	0	0	0	0	0	0	0	1	2	0	0	0	0	0	0	0	0	0	0	1	0	0	1	1	0	0	0	1	0	0	1	0	2	0	0	0	0	0	0	0	1	1	1	0	0	0	0	0	0	0	0	0	0	0	5	0	0	0	0	0	0	0	0	0	0	1	0	0	2	0	0	0	0	0	0	0	0	0	0	0	0	0	0	0	0	0	0	0	0	0	1	0	0	0	0	0	1	0	0	2	0	0	0	0	0	0	0	0	0	0	6	0	0	0	0	0	0	0	1	0	0	2	0	0	0	0	0	0	0	0	0	0	0	0	0	0	0	0	0	0	0	0	0	0	1	0	0	1	0	0	0	0	2	0	0	0	0	0	0	0	0	12	0	0	0	0	0	0	0	0	0	0	1	0	1	2	0	0	0	0	0	0	0	0	0	0	0	0	0	0	0	0	0	0	0	0	0	3	0	0	0	0	0	1	0	0	10	0	0	0	0	0	0	0	0	0	0	0	0	0	0	0	0	0	0	0	0	0	0	0	0	0	0	0	0	0	0	0	0	0	0	0	0	0	1	0	0	4	0	0	0	0	0	0	0	0	0	0	0	0	0	0	0	0	0	0	0	0	0	0	0	0	0	0	0	0	0	0	0	0	0	0	0	0	0	0	0	0	1	0	0	0	0	0	0	0	0	0	0	3	2	3	0	0	0	0	0	0	0	0	22	0	0	0	0	0	0	2	6	0	1	0	0	0	0	0	1	0	0	0	5	3	0	0	0	0	0	35	0	0	0	0	0	0	0	0	0	0	0	0	0	0	9	3	0	0	0	0	0	0	0	0	0	0	0	0	0	0	1	0	2	0	0	0	0	0	0	0	7	0	0	0	0	0	0	0	0	0	0	0	0	0	0	0	0	3	0	5	0	0	0	2	0	0	7	5	0	0	0	1	1	1	0	6	0	1	4	0	0	0	0	0	0	1	0	0	0	0	0	0	0	2	0	1	0	0	0	0	0	0	0	0	0	0	0	0	0	1	0	0	2	0	0	0	0	0	0	0	0	0	0	0	0	0	0	0	0	0	0	0	0	0	1	0	0	0	0	0	1	0	0	0	0	0	0	0	0	0	0	0	0	1	0	0	0	0	0	0	0	0	0	0	0	0	0	0	0	0	0	0	0	0	0	0	0	0	0	0	0	0	0	0	0	0	0	0	0	0	0	0	0	0	1	0	0	0	0	0	0	0	0	0	0	0	0	0	0	0	0	0	0	0	0	0	2	0	0	0	0	0	0	0	0	0	0	1	0	0	0	0	0	0	0	0	0	0	0	0	0	0	0	0	0	1	0	0	0	0	0	0	0	0	0	0	0	0	0	0	0	0	0	0	0	0	0	1	0	0	0	0	0	0	0	0	1	0	0	0	0	0	0	0	0	0	0	0	0	0	0	0	0	0	0	0	0	0	0	0	0	7	0	0	0	0	0	0	0	0	0	0	0	1	1	0	0	0	0	0	0	0	0	0	0	0	0	0	0	0	0	0	0	0	0	0	0	0	0	0	0	0	0	0	0	0	0	0	0	0	0	0	0	0	0	1	1	0	0	0	0	0	0	1	0	0	0	0	0	0	0	0	0	0	0	1	0	0	1	0	0	0	0	0	0	0	0	0	2	0	0	0	0	0	0	0	0	0	0	0	0	0	0	0	0	0	0	0	0	0	0	0	0	1	0	0	0	0	0	0	0	0	0	0	0	0	0	0	0	0	0	0	0	0	0	0	0	0	0	0	0	2	0	0	0	0	0	0	0	0	0	0	0	0	0	0	0	0	0	0	0	0	0	0	0	0	0	0	0	0	0	0	0	0	0	0	0	2	0	0	0	0	0	1	0	0	0	0	0	0	1	0	0	0	0	0	0	0	0	0	0	1	0	0	0	0	0	0	0	0	0	1	0	0	0	0	0	0	0	0	0	0	2	0	0	0	2	2	0	0	0	0	1	0	0	0	0	0	1	0	1	0	3	5	1	0	0	0	0	0	0	0	1	0	0	0	0	0	0	0	0	0	0	0	0	0	9	0	1	1	0	0	0	0	0	0	1	0	0	0	0	0	0	0	0	0	0	0	0	2	0	0	0	0	0	0	0	0	2	0	0	2	0	0	0	0	0	0	5	4	3	0	0	0	0	2	0	0	0	0	0	0	0	0	0	0	0	1	0	0	0	6	9	0	0	0	1	0	0	2	0	2	0	0	1	0	0	0	0	0	0	0	0	0	1	1	0	0	0	1	0	0	0	0	3	0	0	0	0	0	0	0	0	5	0	0	1	0	2	0	0	0	0	0	0	0	0	0	0	0	0	0	0	0	0	0	0	0	1	0	0	0	0	2	0	0	0	0	0	0	0	0	0	0	0	0	0	0	0	0	0	0	0	0	0	0	0	0	0	0	0	0	1	0	0	0	0	0	0	0	1	0	0	7	0	0	0	0	4	0	0	0	0	0	0	0	0	0	1	0	0	0	0	0	0	0	0	0	0	0	1	0	1	0	0	0	0	0	0	0	1	0	0	0	0	1	0	0	0	0	0	2	0	0	0	0	1	0	0	0	0	0	0	0	5	0	0	0	0	0	0	0	7	0	0	1	0	0	0	0	1	0	0	0	0	0	0	1	0	0	0	0	0	0	1	0	0	0	0	1	0	8	2	0	0	0	0	0	0	2	0	0	0	0	0	0	0	1	4	0	0	0	0	0	0	0	0	0	0	0	0	0	1	0	1	1	0	0	2	0	0	0	0	0	0	0	0	0	0	0	0	0	1	0	0	0	0	2	0	0	0	0	0	0	0	0	0	0	1	0	0	0	0	0	0	0	0	0	0	0	0	0	0	0	0	0	0	3	0	2	2	1	0	0	6	0	0	0	0	0	0	0	0	0	0	0	0	0	3	9	0	0	0	0	5	0	27	0	0	0	0	0	0	0	0	0	3	0	1	0	0	0	0	0	0	0	0	0	0	0	0	0	0	0	0	0	4	1	0	0	0	1	0	1	0	0	0	0	4	0	0	0	0	1	7	0	0	0	0	0	0	0	0	0	0	0	0	0	0	12	0	0	0	15	0	0	1	4	0	0	0	1	0	0	0	0	2	0	0	0	0	4	0	0	0	1	0	0	0	0	0	1	0	1	1	0	0	2	0	0	7	0	0	0	0	0	0	0	0	0	0	0	0	1	0	0	0	0	3	0	0	0	0	0	1	0	0	0	0	0	0	0	0	0	0	0	1	0	0	0	0	0	0	0	0	0	0	2	1	0	1	0	0	0	0	0	0	0	2	0	0	0	3	3	3	4	0	0	0	0	0	0	0	0	0	0	1	0	0	1	0	0	0	0	0	3	0	7	2	16	8	0	13	5	19	2	1	5	0	1	81	0	1	0	1	0	0	0	0	2	0	0	0	0	0	3	0	0	1	6	0	0	0	0	0	0	0	1	7	0	0	0	0	0	0	0	0	0	0	0	0	12	2	3	1	0	4	0	1	0	1	4	4	2	2	0	0	5	0	3	0	0	4	0	0	1	0	1	0	0	0	0	0	0	0	0	0	0	2	0	0	1	0	4	3	4	0	0	0	0	0	0	2	1	22	0	0	0	1	5	0	0	0	6	1	0	0	2	0	0	0	0	2	0	1	0	2	8	2	1	7	0	0	6	5	0	0	19	0	0	0	2	0	0	10	0	3	1	1	0	0	0	0	0	16	0	1	1	0	1	0	1	0	1	0	1	1	6	8	4	0	0	3	0	0	2	0	1	0	35	0	2	5	4	1	0	0	0	2	2	0	0	0	0	4	0	0	0	0	0	0	8	3	5	0	1	0	0	0	0	0	1	0	1	13	0	0	0	0	9	0	2	0	0	0	9	0	0	0	1	0	1	0	0	0	0	0	3	2	0	7	0	0	0	4	0	2	0	1	0	0	0	0	0	0	0	0	0	0	0	0	0	0	0	0	15	0	1	5	0	1	1	0	0	0	2	0	0	0	1	0	1	1	0	0	0	0	0	0	0	0	0	0	0	0	0	0	0	0	0	0	0	4	0	1	2	0	0	0	0	0	0	0	0	0	7	0	0	0	0	0	0	0	0	8	1	0	5	0	0	0	0	0	0	0	0	0	0	0	0	0	0	0	0	0	0	1	2	1	0	0	0	0	0	2	0	0	3	0	0	0	0	0	0	0	0	0	0	1	0	2	2	0	0	0	0	2	0	0	0	0	0	0	0	0	0	0	0	0	0	0	0	0	0	0	0	0	0	0	0	0	0	0	0	0	0	0	0	0	0	0	0	0	0	0	0	1	0	0	0	1	0	0	0	0	0	0	0	0	0	0	0	0	0	0	1	0	0	0	0	0	0	0	0	0	0	0	0	0	0	1	0	0	1	0	0	0	0	0	0	0	0	0	0	0	0	0	0	0	0	0	0	0	0	0	0	0	0	0	0	0	0	0	0	0	0	0	0	0	0	0	0	0	0	1	0	0	0	0	0	0	0	0	1	0	0	0	0	0	0	1	1	0	0	0	0	2	0	0	0	0	0	0	1	0	0	0	0	0	0	0	0	0	0	0	0	0	0	0	1	0	0	0	1	0	0	0	0	0	0	0	0	0	0	0	0	0	0	0	0	0	0	0	0	0	0	0	18	0	0	0	0	0	0	0	0	0	0	0	0	0	0	0	0	0	0	0	0	0	0	0	1	0	0	0	0	0	0	0	0	0	1	0	0	0	0	0	0	2	0	0	0	0	0	1	0	0	0	0	0	0	0	0	0	0	0	0	0	1	0	0	0	0	0	0	0	0	0	0	0	0	0	0	0	0	0	0	0	0	0	0	0	0	0	0	0	0	0	1	19	1	0	0	0	1	1	2	3	1	0	0	0	3	0	3	4	0	0	1	5	0	0	0	0	1	0	4	1	0	0	27	0	0	0	0	0	0	0	0	0	1	0	0	0	0	0	0	0	1	0	0	0	0	0	0	0	0	0	1	0	0	4	4	3	5	0	1	1	0	0	2	1	0	0	0	0	0	0	0	0	0	0	1	0	0	0	0	1	0	0	0	0	0	3	0	0	0	1	0	0	0	0	0	0	0	0	3	1	0	0	0	2	2	0	0	0	0	0	0	2	0	0	0	0	1	0	0	0	0	0	0	0	0	0	0	0	0	0	0	0	0	0	0	0	0	0	0	0	0	0	0	0	0	0	0	0	0	0	0	0	0	0	0	0	0	0	1	0	0	0	0	0	0	0	0	0	0	0	0	0	0	0	0	0	0	0	0	0	0
PHYLLO18	11879	0	0	0	51	258	24	0	66	0	1	14	18	0	5	0	0	0	0	1	4	0	0	0	9	1	0	5	1	7	0	0	9	3	0	0	9	0	0	0	0	0	0	0	9	0	0	0	0	2	11	0	16	35	36	2	97	1	3	0	11	0	0	1	10	17	0	3	0	0	5	2	0	0	1	0	0	0	0	0	0	0	60	30	18	19	0	16	1	7	0	27	5	22	20	1	26	1	17	0	0	14	0	40	0	15	28	0	3	3	0	0	15	8	0	6	2	3	0	0	10	3	15	1	2	31	12	16	1	5	1	1	0	0	3	0	0	43	3	1	7	14	14	0	0	10	4	0	0	5	0	0	0	3	0	0	0	1	25	15	1	0	3	32	1	6	22	20	0	4	0	7	13	0	2	2	1	1	3	0	1	2	6	5	4	2	4	0	0	2	1	8	1	0	0	0	3	30	0	0	1	4	0	1	1	4	0	5	0	0	21	1	0	0	59	101	0	6	0	0	3	3	8	1	30	1	30	10	9	0	30	3	2	5	0	0	1	0	13	0	6	1	18	3	0	3	0	1	5	1	1	0	4	0	17	0	1	2	22	1	0	2	1	0	0	0	6	8	7	0	13	3	4	0	3	1	0	1	0	11	11	1	0	2	21	31	8	0	1	0	8	0	0	1	5	1	17	0	1	0	0	3	43	4	0	0	0	8	6	11	17	7	0	1	0	1	0	5	0	4	1	9	2	0	1	2	0	0	0	0	0	10	0	0	0	0	0	0	0	1	27	2	0	10	49	0	0	0	11	4	3	0	2	2	24	0	4	4	1	3	5	1	1	3	0	0	10	8	0	5	0	4	7	3	5	3	15	5	3	22	10	2	6	3	1	1	11	9	9	1	99	0	0	0	7	4	14	9	66	0	2	0	24	0	97	6	0	0	1	6	30	28	1	0	0	0	0	0	1	10	30	1	2	0	12	0	8	23	16	0	1	0	1	0	0	8	22	2	3	7	38	0	4	4	8	22	5	5	10	0	0	12	22	3	19	3	3	41	0	4	11	0	38	16	52	16	24	0	0	0	0	0	0	0	2	0	0	0	0	0	23	0	0	0	0	0	0	0	0	5	0	0	0	0	1	0	0	0	0	0	0	0	0	0	0	0	1	3	0	4	3	0	0	0	9	40	27	4	18	4	6	31	3	12	22	0	34	0	13	6	0	0	2	0	7	5	3	5	15	13	1	7	3	4	5	19	11	3	0	2	0	5	2	0	4	2	1	6	3	7	3	7	4	12	10	0	0	0	1	11	1	2	0	4	2	0	20	8	0	12	0	1	0	2	3	0	7	2	1	2	1	0	0	0	0	0	0	0	0	0	0	0	3	14	0	2	2	0	0	1	0	0	12	0	0	2	8	0	6	0	8	0	0	0	2	0	0	0	0	3	0	0	2	0	5	1	4	1	0	3	0	0	6	0	4	3	0	1	0	0	2	8	41	0	0	0	0	1	0	4	14	0	1	0	1	0	16	2	4	0	6	0	1	7	19	3	1	17	2	0	12	8	4	7	2	1	0	0	7	3	3	1	16	0	0	1	1	0	4	0	0	4	3	0	0	0	4	0	0	2	0	10	5	2	7	12	4	3	4	21	5	0	0	7	6	0	0	1	2	13	14	1	0	1	0	4	9	0	0	0	1	1	1	7	1	0	0	0	0	0	6	22	5	6	3	5	0	6	10	0	1	0	2	12	4	4	0	11	1	7	0	3	0	11	6	2	0	1	3	0	14	2	1	0	0	1	2	0	0	0	0	0	0	1	6	0	1	0	0	2	3	2	8	3	6	1	0	0	0	1	3	0	6	0	6	3	0	0	12	3	0	0	3	15	1	6	0	0	1	0	0	0	1	0	0	1	2	0	0	0	4	0	2	1	0	0	3	0	5	2	5	0	0	1	0	0	6	2	0	1	6	0	1	0	0	0	0	0	0	0	1	1	7	1	3	6	2	0	0	0	1	1	2	0	0	11	1	5	1	2	3	0	1	0	3	1	0	0	2	6	3	1	0	1	0	4	0	1	0	2	0	0	1	18	10	2	2	0	10	0	1	0	0	1	6	2	0	0	0	0	0	0	0	0	1	5	0	0	1	2	2	0	0	1	0	0	0	17	0	3	0	2	1	11	2	0	0	0	0	0	34	0	2	0	3	1	1	0	0	0	1	0	0	0	0	0	1	0	6	2	1	40	0	0	0	5	8	6	0	3	2	0	0	0	0	0	0	0	2	2	2	1	1	1	0	0	5	26	3	0	9	0	0	0	1	1	0	0	0	0	12	0	0	0	0	6	14	6	2	5	2	0	0	0	0	0	0	1	1	0	0	0	0	16	0	0	3	0	0	7	0	0	1	5	3	0	3	4	1	0	0	4	0	0	0	0	4	1	0	17	15	0	3	1	0	3	0	0	4	1	4	6	2	0	5	1	0	8	6	1	0	0	0	0	0	0	10	0	7	2	22	17	7	2	8	4	8	6	10	9	0	2	23	4	31	3	10	7	0	9	14	0	6	9	0	5	14	0	1	5	2	9	1	0	1	1	1	0	0	17	2	5	1	4	2	4	0	2	6	2	0	2	19	0	1	1	18	0	0	21	2	0	0	0	7	2	0	8	0	7	1	9	0	0	0	0	8	1	0	3	0	2	0	0	3	3	0	1	5	0	4	0	0	2	0	0	9	0	1	0	1	1	2	2	1	0	0	1	0	4	6	4	0	0	0	1	2	0	0	12	0	0	2	3	2	0	0	3	0	1	0	0	0	0	0	0	0	1	0	0	0	0	3	5	0	3	3	1	0	0	7	0	0	0	2	1	0	2	0	0	1	0	1	3	0	0	0	0	0	0	0	0	2	6	16	0	3	0	0	0	0	1	0	0	0	9	0	2	1	0	0	0	0	0	0	4	0	1	1	0	0	2	3	3	0	0	0	0	0	0	4	0	7	0	0	0	0	2	2	2	0	0	0	0	16	0	0	0	0	0	0	2	3	15	0	0	0	1	0	3	0	1	3	0	8	1	0	1	0	0	0	0	0	0	0	0	1	0	0	0	0	4	2	11	3	2	0	0	0	0	0	0	4	1	17	0	0	0	0	0	0	2	1	1	0	0	0	1	0	0	0	0	0	0	0	0	8	0	1	1	0	0	0	3	1	0	1	1	0	0	0	4	3	0	5	4	1	0	0	0	3	2	1	2	0	0	1	0	0	3	0	0	0	0	0	0	0	0	0	0	0	0	0	0	0	0	3	0	1	2	0	0	0	0	0	8	0	0	4	0	0	0	32	0	1	1	1	0	0	5	0	1	1	0	0	0	0	0	0	0	0	0	0	16	0	4	0	0	0	0	0	0	0	0	0	0	0	0	0	0	3	0	2	0	3	2	3	0	0	0	0	5	0	0	0	1	1	1	0	0	0	0	10	1	0	0	0	0	0	0	0	0	0	0	0	0	0	0	0	0	0	0	0	0	30	0	0	0	0	0	0	3	2	0	1	0	1	0	0	0	0	0	14	0	3	7	4	5	2	0	0	1	0	1	4	0	7	0	1	0	1	0	1	10	1	0	2	0	0	0	0	3	0	6	4	3	0	2	0	1	0	0	1	4	0	3	0	0	1	0	0	4	3	6	0	1	4	0	0	0	0	3	1	0	1	8	2	0	0	1	0	7	0	0	7	0	0	0	2	2	5	1	0	0	0	2	4	1	0	0	1	13	0	0	108	0	2	0	0	0	1	0	6	9	0	4	3	0	0	1	0	0	1	0	2	0	2	1	10	0	0	5	1	0	4	0	0	1	1	0	0	12	0	0	2	0	0	0	0	0	0	4	1	0	4	0	0	0	0	0	0	3	0	0	0	2	2	0	0	0	0	13	2	0	1	0	0	0	0	1	0	0	0	0	0	0	2	6	8	2	4	0	1	0	0	0	1	2	13	0	1	0	0	1	6	1	0	2	16	0	0	0	0	0	2	2	0	0	0	1	2	2	2	2	0	1	0	0	0	3	0	0	2	2	0	1	0	15	0	0	0	1	0	0	0	1	2	2	0	0	3	1	0	2	2	6	0	0	0	1	0	3	2	7	26	6	0	1	2	2	14	0	0	2	0	0	14	0	0	0	0	12	49	48	2	2	6	32	24	1	0	39	28	7	7	0	20	29	9	0	3	3	1	0	0	0	1	1	0	9	19	16	2	3	0	5	26	3	0	0	7	0	0	16	0	11	0	0	0	1	0	14	14	3	0	0	2	2	0	0	10	0	23	0	0	0	0	9	12	0	0	3	0	14	17	0	10	10	9	11	2	0	0	3	1	1	2	0	16	7	10	8	0	7	1	1	0	0	0	2	12	0	2	16	0	0	0	0	16	0	2	0	0	1	0	0	13	0	0	5	0	0	0	0	0	3	0	0	10	3	0	0	11	0	0	0	0	0	0	9	0	0	0	0	1	0	0	0	0	0	0	0	0	2	0	1	0	1	0	0	2	0	1	1	0	3	0	0	5	0	0	3	2	0	3	5	4	0	2	0	0	2	1	0	0	0	0	0	0	0	0	0	0	1	1	0	1	0	3	1	5	0	0	5	4	7	0	0	0	0	20	0	0	0	0	1	0	5	53	2	0	1	0	0	0	1	1	0	0	0	0	0	0	2	0	4	0	0	0	1	0	14	0	0	0	1	1	0	0	6	1	0	0	0	3	0	0	0	0	0	1	1	0	0	0	0	0	0	0	0	0	0	0	0	1	1	1	4	0	0	0	0	1	0	0	0	0	0	0	3	1	0	0	0	0	0	0	0	4	2	1	1	1	0	0	6	0	4	0	0	0	0	0	0	0	0	0	0	1	0	0	3	1	0	0	0	0	0	8	0	0	0	0	0	0	0	0	0	0	0	1	0	3	0	2	2	0	0	0	2	1	0	0	0	0	0	0	5	0	0	0	0	0	2	0	0	0	0	0	0	0	12	11	1	0	4	2	1	1	0	0	0	0	2	14	8	10	0	0	0	14	0	11	0	4	2	1	6	2	3	1	4	4	2	2	0	0	0	0	0	0	0	0	0	0	0	0	0	0	0	0	0	0	0	0	0	0	0	5	0	0	0	0	1	0	0	0	7	0	1	0	0	1	0	0	0	0	0	0	0	0	0	0	0	0	3	2	1	0	0	2	0	0	0	0	0	0	0	0	0	1	0	0	0	0	0	0	0	1	7	6	0	6	0	0	0	1	0	0	0	2	0	0	0	0	0	0	0	0	0	0	0	2	0	0	0	0	0	0	0	0	0	0	0	1	0	0	5	5	0	2	1	9	2	1	0	0	0	3	0	2	12	8	0	0	0	12	12	0	0	0	0	0	0	4	3	0	3	2	2	0	0	0	1	0	0	0	0	0	1	18	0	0	0	0	0	0	0	0	0	0	1	0	1	1	0	1	0	3	2	0	0	0	0	0	0	0	5	0	0	0	0	0	1	0	6	0	0	0	0	1	0	0	0	0	0	0	0	0	0	0	0	0	1	0	0	0	0	0	0	0	0	1	0	0	0	2	0	0	0	0	0	0	0	0	3	0	2	0	0	0	0	0	1	0	1	0	0	0	8	0	0	5	0	0	0	0	0	0	0	0	0	6	0	2	0	0	0	0	0	0	0	0	0	0	0	0	0	0	0	0	0	0	2	4	0	6	0	11	7	0	0	4	0	1	0	0	0	0	0	0	1	1	3	0	0	0	5	0	5	0	0	0	0	0	0	0	0	23	1	4	1	0	0	0	0	0	0	0	0	0	0	0	2	6	0	1	0	0	0	0	1	1	0	0	0	0	0	0	0	0	0	0	0	0	0	0	0	0	0	2	0	0	50	0	0	0	1	0	0	0	0	0	0	1	5	0	1	5	0	3	0	0	0	1	0	2	0	0	0	0	1	0	0	0	3	0	0	0	0	0	2	0	0	0	3	0	0	0	0	0	0	0	3	0	0	2	0	0	0	0	1	2	0	0	0	0	0	1	1	0	0	0	1	0	0	0	0	1	0	0	0	0	0	0	0	0	5	0	0	0	14	0	0	0	0	0	0	0	0	3	0	4	0	0	0	0	0	0	0	0	0	0	4	0	0	0	0	0	7	0	0	0	0	0	0	0	0	0	0	0	0	0	0	4	1	0	1	0	0	0	1	0	0	0	0	0	0	0	0	0	1	0	1	0	0	0	1	2	0	0	0	0	0	1	0	0	0	0	0	0	0	0	0	0	0	3	0	0	0	1	0	0	4	1	0	1	1	0	0	0	0	0	0	0	0	10	0	0	0	0	0	3	8	0	1	0	0	0	0	1	0	0	0	0	0	0	1	1	0	0	0	0	0	1	0	0	0	0	1	0	0	6	0	0	0	1	0	0	0	1	0	0	1	1	1	0	1	0	0	0	0	0	0	0	7	0	1	1	0	0	5	0	2	0	0	0	0	9	0	0	1	2	0	0	0	0	0	0	0	0	0	0	0	0	0	5	0	0	0	0	0	0	0	0	0	0	0	3	0	0	1	0	0	1	0	1	0	0	2	0	2	0	0	0	0	0	0	0	0	0	0	0	0	0	1	0	0	0	0	0	0	15	33	19	4	0	7	1	0	0	21	19	21	0	24	1	1	0	1	0	0	0	0	0	0	0	0	8	0	0	0	3	0	10	0	0	0	0	0	0	0	0	0	0	1	0	0	0	0	0	0	0	0	0	0	0	0	0	11	0	0	0	0	0	0	0	0	8	0	0	0	0	2	0	0	0	0	0	0	0	0	0	0	0	0	0	0	0	0	0	0	11	0	0	1	0	0	0	0	0	0	0	0	0	0	0	0	0	0	0	0	0	3	0	0	0	0	1	0	1	0	0	0	2	2	0	38	0	2	1	0	2	0	0	0	0	17	0	0	0	0	0	0	0	0	0	0	0	17	0	0	7	0	1	1	0	0	1	0	0	0	0	0	0	0	0	0	0	0	0	0	0	0	0	1	1	0	0	0	0	2	0	1	1	0	2	0	0	0	0	1	1	1	0	2	0	0	0	23	0	0	0	1	0	0	0	0	0	0	0	24	24	0	23	0	0	0	0	1	0	0	0	0	0	0	0	0	0	0	0	0	0	0	0	0	0	0	0	2	0	0	0	0	0	0	0	0	1	0	0	0	1	0	0	0	0	0	9	0	0	0	0	0	0	0	0	2	0	0	0	0	0	0	1	0	0	0	0	0	0	0	0	1	0	0	0	0	0	2	3	0	0	0	0	0	0	1	0	0	5	0	0	0	0	0	0	0	0	0	1	2	2	2	0	0	0	0	0	0	0	0	0	0	0	1	2	11	0	2	2	12	4	0	0	0	0	0	6	10	1	0	1	2	1	1	0	0	0	2	0	0	0	2	0	2	0	0	0	0	1	0	0	0	0	0	0	0	0	0	0	0	0	0	0	0	0	0	0	0	0	0	0	0	0	1	0	3	1	0	0	0	2	0	17	0	1	0	2	0	0	0	0	0	0	0	0	0	0	0	0	0	0	0	3	0	0	0	1	1	0	0	0	2	0	0	0	0	6	0	0	8	0	0	0	1	0	0	0	0	0	0	0	0	2	0	0	3	0	0	1	0	0	0	0	0	0	0	0	0	0	0	0	9	0	0	0	1	0	0	0	0	0	1	0	0	0	0	0	2	0	0	0	0	0	0	6	1	0	1	0	0	0	0	0	0	0	0	0	0	0	7	7	0	0	0	0	0	1	0	0	2	0	3	1	0	0	0	0	0	1	0	0	1	0	3	0	0	0	0	0	0	0	0	0	0	0	2	0	0	2	0	0	0	0	2	0	0	0	1	0	0	0	0	0	0	0	0	0	0	0	0	0	0	0	2	0	0	0	0	1	0	0	0	0	3	0	0	1	0	0	0	0	0	0	0	2	0	0	1	0	0	0	1	0	0	0	0	0	0	0	1	0	0	0	1	1	1	4	1	0	0	0	0	1	0	4	0	0	0	0	0	0	0	1	0	0	0	0	0	0	0	0	0	0	0	0	0	1	0	0	0	0	0	0	2	0	0	0	0	0	0	0	0	0	0	0	0	0	0	0	0	0	0	0	0	0	0	0	3	0	0	0	0	0	0	0	0	1	0	0	0	0	0	0	0	0	0	0	0	5	0	0	0	0	0	0	0	1	1	0	0	0	0	0	0	0	0	0	0	0	0	6	0	0	0	0	0	0	0	0	0	0	0	0	1	0	0	0	0	0	0	1	0	0	0	0	2	5	6	0	0	2	0	0	0	4	0	0	0	0	0	2	2	1	0	1	0	0	0	1	0	2	0	0	0	0	0	0	0	0	2	4	0	1	0	3	0	0	0	0	1	0	0	0	0	0	0	0	3	0	0	0	0	1	0	0	0	0	0	0	0	0	0	0	0	0	0	0	0	0	0	0	0	0	0	0	8	0	8	0	0	10	3	0	0	1	0	0	4	0	0	0	0	6	0	0	0	0	0	2	3	0	0	0	1	0	0	0	0	0	4	2	0	0	0	0	3	0	0	0	0	0	0	0	0	0	0	0	0	2	0	0	0	0	0	0	0	0	0	1	0	0	0	0	0	0	0	0	0	0	0	0	0	0	0	2	0	7	0	0	0	0	0	0	0	0	0	0	0	0	0	1	0	0	0	2	0	0	1	0	0	0	0	1	0	0	0	0	0	12	0	0	0	0	0	0	0	0	0	0	7	0	0	0	0	0	0	2	2	0	1	0	0	5	0	2	0	0	0	0	0	0	0	0	0	0	0	0	0	0	0	0	0	0	0	0	0	0	1	0	0	0	2	0	0	0	0	0	0	2	0	0	0	0	0	0	1	6	6	1	0	0	0	0	0	0	0	0	1	0	0	0	0	0	0	3	0	0	0	0	1	0	0	0	0	0	0	0	0	0	0	0	0	0	0	0	0	1	1	0	0	0	0	0	0	0	0	0	0	0	0	0	0	0	0	0	0	0	0	0	0	0	0	5	0	2	0	1	2	0	0	0	2	0	0	0	0	1	0	0	0	0	0	0	0	0	0	0	0	0	0	0	0	0	1	0	0	0	0	0	0	0	0	0	0	0	1	0	0	0	0	0	0	1	0	0	0	0	0	1	0	3	0	1	4	0	0	0	1	0	0	0	0	0	0	0	0	1	0	0	0	0	0	2	0	0	0	0	0	0	0	0	0	0	0	2	0	0	1	0	0	0	0	0	0	0	1	0	1	0	0	0	0	1	0	0	0	0	7	0	0	0	1	0	6	0	0	0	0	0	0	0	0	0	0	0	0	0	2	0	0	0	2	0	0	0	0	0	0	0	2	0	0	0	0	0	0	1	0	0	0	0	0	0	0	0	0	0	0	0	0	0	0	0	0	0	0	0	0	0	0	0	0	0	0	0	0	0	0	0	10	0	0	0	0	0	0	0	0	0	0	0	0	0	0	0	0	0	0	0	0	0	0	0	0	0	0	4	0	0	0	0	2	3	6	0	0	3	2	0	2	0	0	6	8	6	5	0	0	1	0	0	1	0	0	7	0	2	0	0	0	6	6	1	0	8	0	0	0	0	0	2	0	0	0	1	0	0	0	0	0	0	0	4	0	0	0	0	0	0	0	0	0	0	0	0	0	0	8	0	0	0	0	0	0	1	10	1	5	9	2	2	2	0	0	0	1	0	4	1	0	0	0	0	5	5	6	6	0	10	6	0	0	0	1	0	0	6	0	0	0	0	5	0	1	0	4	0	0	0	5	0	0	8	0	0	0	1	2	0	0	20	0	70	7	0	0	1	0	0	0	0	0	0	2	0	2	0	0	0	55	0	11	0	5	0	1	43	6	0	5	11	12	2	3	26	0	0	1	0	0	0	0	0	1	0	0	0	0	0	0	0	0	0	0	0	0	0	0	0	0	0	0	0	0	0	0	0	0	1	2	0	0	0	0	0	0	0	0	0	0	0	0	0	2	0	1	0	0	0	0	0	0	0	0	0	0	0	0	0	2	0	0	0	0	0	0	0	0	0	0	0	10	0	1	0	0	1	1	2	0	0	0	0	0	0	0	0	0	0	0	0	0	0	0	0	0	4	0	0	0	0	0	0	0	0	0	0	0	7	0	9	0	19	0	0	4	5	1	7	0	0	0	0	1	42	5	7	7	0	0	0	2	0	1	0	2	0	0	0	0	0	1	0	1	2	3	1	0	5	3	0	0	0	0	0	0	0	0	0	0	0	0	0	0	0	0	0	0	0	0	1	0	0	0	0	0	1	2	0	0	0	0	0	0	0	0	0	0	0	0	0	0	0	0	0	1	0	0	0	0	0	0	0	0	0	3	0	0	0	0	0	0	0	0	0	0	0	0	1	2	0	33	7	1	0	1	17	33	0	1	0	0	0	0	0	0	2	0	1	0	0	14	0	0	0	11	0	0	0	0	2	6	0	0	0	0	0	1	3	1	0	0	0	0	0	2	0	0	0	3	0	0	3	9	2	0	2	0	0	1	13	0	0	0	0	0	0	0	0	0	24	0	0	0	0	0	0	0	0	0	0	0	0	0	0	0	0	0	0	0	0	7	0	0	0	0	0	0	0	0	2	1	0	0	0	2	0	0	0	2	0	0	0	0	0	0	0	2	0	0	5	6	0	0	2	6	16	0	7	0	1	0	8	0	0	1	0	7	0	0	0	0	0	0	2	1	0	0	0	3	0	0	0	7	0	0	2	0	0	7	0	0	0	0	0	0	0	0	0	0	0	0	0	0	0	0	0	3	4	12	2	2	1	0	0	0	0	3	0	4	1	2	1	0	1	0	1	0	0	0	0	0	0	0	0	0	0	0	0	0	0	0	0	0	0	0	0	0	0	0	0	0	0	0	0	0	0	0	0	0	0	0	0	0	0	0	0	0	0	0	0	0	0	0	0	0	0	0	0	0	0	0	0	0	0	0	0	0	0	0	0	0	0	0	0	0	0	0	0	0	0	3	0	0	0	1	3	0	0	9	0	0	0	3	0	0	0	0	0	0	1	0	1	0	0	1	0	0	0	0	1	2	0	0	0	0	0	0	0	0	0	0	0	0	0	0	0	0	0	0	2	0	0	0	0	2	0	0	0	0	0	0	0	1	0	0	0	0	0	0	0	0	0	0	0	0	0	0	0	0	0	0	0	0	0	0	0	0	0	0	3	0	0	0	0	0	0	0	0	0	0	0	0	0	0	0	0	0	0	0	0	0	0	0	0	0	0	0	0	1	0	0	0	0	0	0	0	0	1	0	0	0	0	0	0	0	0	0	0	0	0	0	0	0	0	0	0	0	0	0	0	0	0	0	1	0	0	0	0	0	0	0	0	0	0	0	0	0	0	0	0	0	0	0	0	0	1	0	0	0	0	0	0	2	0	0	0	3	0	0	0	0	0	0	0	3	0	0	0	0	0	0	0	0	0	1	0	0	0	0	0	0	0	0	0	0	0	0	0	1	0	1	0	0	0	0	0	1	0	0	0	0	0	0	0	0	0	0	0	0	0	1	3	0	0	0	0	1	0	0	0	0	0	0	0	0	0	0	1	0	0	0	0	0	0	1	0	0	0	0	3	0	0	0	0	0	0	0	0	0	0	0	2	0	0	0	0	1	1	3	0	0	0	0	0	0	0	0	1	1	0	0	0	1	0	1	0	0	0	1	11	4	0	1	4	0	0	0	0	0	0	0	0	2	0	0	0	0	0	0	0	0	0	0	0	8	8	0	0	0	5	0	3	0	0	0	0	0	0	0	0	0	2	1	0	0	0	0	10	0	0	0	0	0	0	0	0	0	0	0	0	2	0	0	0	0	0	0	0	0	0	0	0	0	0	0	0	0	0	0	0	0	0	0	0	0	0	0	0	0	0	0	0	0	0	1	0	0	0	0	0	0	0	0	0	0	0	0	0	0	0	0	0	0	0	0	0	0	0	0	0	0	0	0	0	0	2	0	0	0	0	0	0	0	0	0	0	1	0	5	1	0	0	0	0	0	0	0	1	0	0	0	0	0	0	0	0	0	0	0	0	0	0	0	0	0	0	0	0	0	0	0	1	0	0	0	0	0	0	0	0	0	0	0	0	0	1	0	2	1	0	0	0	0	0	0	0	0	0	0	0	0	1	0	0	2	0	0	0	0	0	0	0	0	0	0	0	0	0	0	0	0	0	0	0	0	0	0	0	0	0	0	0	0	0	0	0	0	1	0	0	0	0	0	0	0	0	0	0	0	1	0	0	0	0	0	0	1	0	0	0	0	4	0	0	0	0	0	0	0	0	0	0	0	0	0	0	0	0	0	0	2	0	0	0	0	0	0	0	0	0	0	0	0	0	1	0	1	0	0	0	0	0	0	0	0	0	0	0	1	0	0	0	0	0	0	0	0	0	0	1	0	0	0	0	0	0	0	1	1	0	0	0	0	0	0	1	0	0	0	0	0	0	0	0	0	0	0	0	0	0	0	0	0	0	0	0	0	0	0	0	0	0	0	0	0	0	0	0	0	0	0	0	0	0	1	0	0	0	0	0	0	0	0	0	0	0	0	0	0	0	8	0	0	0	0	0	0	0	0	0	0	3	0	0	0	0	0	0	0	1	0	0	0	0	0	0	0	0	0	0	3	0	0	0	0	1	0	0	0	0	0	0	0	0	0	6	0	0	2	0	0	0	0	0	0	0	0	0	0	0	0	0	0	0	0	0	0	0	0	0	0	0	0	0	0	0	0	0	0	0	0	0	0	0	0	0	4	0	0	0	0	0	2	0	0	0	0	0	0	0	0	0	0	0	0	0	0	0	0	0	0	0	0	0	0	0	0	1	0	0	0	0	0	0	0	0	0	0	0	0	0	0	0	0	0	0	0	0	2	1	5	0	0	0	0	0	0	0	0	22	0	0	0	0	0	0	2	7	1	0	0	0	0	0	0	2	1	0	0	10	2	0	0	1	0	0	42	1	0	1	0	0	0	0	0	0	0	0	0	0	0	8	0	0	0	0	0	0	0	0	0	0	0	0	0	1	0	1	0	0	0	0	0	0	2	0	0	7	1	0	0	0	1	0	0	0	0	1	0	0	2	1	0	0	4	0	0	0	3	0	0	0	0	13	6	1	0	0	0	0	0	0	1	0	0	3	0	0	0	0	0	0	0	0	0	0	0	0	1	0	3	0	0	0	0	0	0	0	0	0	0	0	0	0	0	0	3	0	0	0	0	0	0	0	0	0	0	0	0	0	0	2	0	0	0	0	0	0	0	0	0	0	0	0	0	0	0	0	0	0	0	0	0	0	0	0	0	0	0	0	0	0	0	0	0	0	0	0	0	0	0	0	0	0	0	0	0	0	0	0	0	0	0	0	0	0	0	0	0	0	0	0	0	0	1	0	0	0	0	0	0	1	0	0	0	0	0	0	0	0	0	0	0	0	0	0	0	0	0	0	0	0	0	1	0	0	0	0	0	0	0	0	0	0	0	0	0	0	1	0	0	0	0	0	0	0	0	0	0	0	1	0	0	0	0	0	0	0	0	0	0	0	0	0	0	0	0	0	0	0	0	0	0	0	1	0	0	0	0	0	0	0	0	2	0	0	0	0	0	0	1	0	0	0	0	0	0	0	0	0	0	0	0	0	0	0	0	0	0	0	1	2	0	0	0	0	0	0	0	0	1	0	1	0	0	0	0	0	0	0	0	0	0	0	0	0	0	0	0	0	0	0	0	0	0	0	0	0	0	0	0	0	0	0	0	0	0	0	0	0	0	0	0	0	0	0	0	1	0	0	0	0	0	0	0	0	0	0	0	0	0	0	0	0	0	1	0	0	0	0	0	0	0	0	0	0	0	0	0	1	0	0	0	0	0	0	0	0	0	0	0	0	1	0	0	0	0	0	0	0	0	0	0	0	0	0	0	2	0	0	0	0	0	0	0	0	0	0	0	0	0	0	0	0	0	0	0	0	0	0	0	0	0	1	0	0	0	0	0	0	0	0	3	0	0	0	0	0	0	0	1	0	0	0	0	0	0	0	1	0	0	0	0	0	0	0	1	0	0	0	0	0	0	0	0	0	0	1	0	0	0	0	0	0	2	0	0	0	1	0	0	1	0	0	0	1	0	0	3	2	0	0	0	0	2	0	0	1	0	1	0	0	0	0	2	1	0	0	0	2	0	0	0	0	0	0	4	1	0	1	5	0	0	0	0	0	0	0	0	0	0	0	0	0	0	0	0	1	0	0	0	0	0	2	0	2	0	0	0	0	0	0	0	0	0	0	0	0	0	0	1	0	0	0	3	0	1	0	0	0	0	0	0	0	1	0	0	0	2	0	0	0	0	0	0	2	6	4	0	0	0	2	0	1	4	0	0	1	0	1	0	0	0	0	0	1	0	0	3	2	0	0	0	1	0	0	5	1	0	0	0	0	0	0	0	0	0	0	0	0	0	0	3	0	0	0	0	0	2	0	2	11	0	0	4	0	2	0	0	0	3	0	0	0	1	4	0	1	0	0	0	0	0	0	0	0	0	2	0	0	0	0	0	1	1	1	0	0	0	0	3	0	0	1	0	0	0	0	0	0	0	1	0	0	0	0	0	0	0	0	0	0	0	0	0	0	0	0	0	0	0	0	0	0	0	0	0	0	0	0	8	0	0	0	0	2	0	0	1	0	0	0	0	0	0	0	0	0	0	0	0	0	0	0	0	0	0	0	0	0	0	0	0	0	0	0	2	2	0	0	0	0	1	0	0	0	0	0	4	0	0	0	0	0	0	0	2	1	0	0	0	5	0	0	0	0	0	0	0	14	0	0	0	0	0	0	0	1	0	0	0	0	2	0	1	0	0	0	0	0	0	1	0	0	0	0	0	0	6	5	0	0	0	0	0	0	3	1	1	0	0	0	0	0	0	0	0	0	1	0	0	0	0	0	0	0	0	0	0	1	0	0	0	0	0	0	0	0	0	0	0	0	0	0	0	0	0	0	0	0	0	0	0	0	0	1	0	0	0	0	0	0	1	0	0	0	0	0	0	0	0	0	0	0	0	0	1	0	0	0	0	0	0	0	1	0	2	0	0	0	0	8	0	0	0	0	0	0	0	0	0	0	0	0	0	2	8	0	0	0	0	5	0	15	0	0	0	0	0	0	0	0	1	1	0	0	0	0	0	0	0	0	0	0	0	0	0	0	0	0	0	0	1	1	1	0	0	0	0	0	0	0	0	0	6	1	0	0	1	0	5	6	0	1	0	0	0	0	0	0	0	0	0	0	0	0	16	0	0	0	10	0	0	2	8	0	0	0	0	0	0	0	0	2	0	0	0	0	0	0	2	0	0	0	0	0	0	0	0	0	0	0	0	0	0	0	0	7	0	0	0	0	0	0	0	0	0	0	0	0	0	0	0	0	0	2	0	0	0	0	0	0	0	0	1	0	0	0	1	0	0	0	0	0	0	0	0	0	0	0	2	0	4	0	0	0	0	1	0	0	0	1	0	0	0	0	0	0	0	2	4	4	13	0	0	0	0	1	0	0	0	0	2	0	0	0	0	1	0	0	0	0	2	0	2	0	11	5	0	10	3	25	1	1	5	0	0	89	0	5	0	1	0	0	0	0	3	0	0	0	0	0	2	0	0	0	1	0	1	0	2	0	0	0	0	7	0	0	0	0	0	0	0	0	0	0	0	0	9	1	2	3	0	0	0	0	1	1	2	6	0	9	0	0	2	0	3	0	1	3	0	0	0	1	0	0	0	0	0	0	0	0	0	0	0	2	0	0	4	0	0	0	0	1	0	0	0	0	0	3	1	21	0	2	0	0	4	0	0	0	7	2	0	2	0	0	0	1	0	0	1	3	0	4	12	4	2	4	1	0	1	6	1	0	19	0	0	0	0	0	1	3	0	11	0	0	0	0	0	0	0	14	0	0	0	0	0	0	1	0	0	1	2	0	7	11	0	2	0	0	0	0	1	0	2	0	25	0	0	8	2	2	0	0	0	3	1	4	0	0	0	0	0	0	0	0	0	0	9	0	3	0	1	0	0	2	0	0	1	0	0	3	0	0	0	1	8	0	0	0	1	0	4	0	1	0	2	0	0	1	0	0	0	0	1	1	0	3	0	0	0	4	0	2	0	1	1	1	0	0	0	0	0	0	0	0	2	1	0	0	1	0	26	0	0	1	0	2	0	0	1	0	2	0	0	0	0	0	1	0	0	0	0	0	0	0	0	0	0	0	0	0	0	0	0	0	0	0	0	8	1	0	1	0	0	0	0	0	0	0	0	0	7	0	0	0	0	0	1	0	0	3	0	2	8	1	0	0	0	0	0	0	0	0	0	0	0	0	0	1	0	0	0	0	0	1	0	0	2	0	0	4	0	0	0	0	0	0	0	0	0	0	0	0	0	2	0	3	3	0	0	0	0	0	0	0	0	0	0	0	0	0	0	0	1	0	0	0	0	0	0	0	0	0	0	0	0	0	0	0	0	0	0	0	0	0	0	0	0	0	0	0	0	0	0	0	0	0	1	0	0	0	0	0	0	0	0	0	0	0	0	0	0	0	0	0	1	0	0	0	0	0	0	0	0	0	0	0	0	0	0	0	0	0	0	0	0	0	0	0	0	0	0	0	0	0	0	0	0	0	0	0	0	0	0	0	0	0	0	0	0	0	0	0	0	0	0	0	0	0	0	4	2	0	0	0	0	0	0	1	0	1	0	1	0	0	0	0	0	0	0	0	0	0	0	0	0	1	0	0	0	0	0	0	0	0	0	0	0	0	0	0	0	0	0	0	0	0	0	0	1	0	0	0	0	0	0	1	0	0	0	0	0	0	0	0	0	0	0	0	0	0	2	0	12	0	0	0	0	0	0	0	0	0	0	0	0	0	0	0	0	0	3	0	0	0	0	0	0	0	0	1	0	1	0	0	0	0	2	0	0	0	1	0	0	2	0	0	0	0	0	0	0	2	0	0	0	0	0	0	0	1	0	0	0	0	0	0	0	0	0	0	0	0	0	0	0	0	0	0	0	0	0	1	0	0	0	2	2	0	0	0	0	0	1	0	18	2	0	0	0	0	3	4	4	3	0	0	1	1	0	0	0	0	0	0	2	0	0	0	1	0	0	8	0	0	0	25	0	0	0	0	0	0	0	1	0	0	0	1	1	0	1	1	0	2	0	0	0	0	1	0	0	0	0	2	2	0	0	6	0	1	0	0	0	0	4	4	0	0	0	0	0	0	0	0	0	4	1	1	1	0	0	0	1	0	0	0	0	1	1	0	0	0	0	0	4	0	0	0	0	0	0	5	3	0	0	0	3	2	0	0	0	0	0	0	0	0	1	0	0	0	0	0	0	0	0	0	0	0	0	0	0	0	0	0	0	0	0	0	0	0	0	0	0	0	0	0	0	0	0	0	0	2	0	0	0	0	0	0	0	0	0	1	0	0	1	1	0	0	0	0	0	0	0	0	0	0	0	0	0	0	0	0	0	0
PHYLLO19	15587	0	0	0	55	252	22	0	28	1	3	9	18	0	44	0	0	5	0	6	3	0	0	2	13	0	0	6	1	3	2	0	1	1	1	4	7	0	0	0	0	0	0	0	3	0	0	0	0	0	0	0	17	32	43	0	123	5	1	1	258	0	0	4	4	39	0	3	0	0	3	6	0	0	0	2	1	0	1	0	0	0	58	51	22	38	0	16	0	6	0	23	5	34	7	3	16	1	35	0	0	99	0	31	0	25	45	0	4	4	0	0	6	7	0	13	11	10	0	0	17	2	9	1	3	49	16	28	2	1	6	0	0	4	3	4	0	50	31	0	8	19	25	3	0	14	4	1	7	5	0	0	0	5	1	0	0	0	18	10	6	0	5	29	0	22	27	17	8	7	2	9	10	2	3	3	0	3	3	0	5	2	7	0	1	3	7	0	0	1	3	12	0	0	0	3	7	22	0	0	0	1	1	3	1	3	0	6	0	1	17	0	5	0	67	99	0	5	1	4	1	0	17	9	40	4	39	10	13	5	20	4	1	14	0	2	6	0	8	2	6	5	24	7	0	0	0	6	11	0	0	1	12	0	10	0	4	2	30	0	0	2	2	0	0	3	4	6	8	2	5	2	1	0	7	1	0	3	0	12	21	4	4	2	36	25	3	1	4	0	6	0	0	8	10	6	42	0	2	0	0	8	34	1	0	2	2	18	7	14	35	1	12	0	4	2	0	20	0	17	0	15	1	0	0	0	0	4	0	0	0	16	0	0	0	0	2	3	0	4	14	6	0	28	53	4	0	0	10	2	3	0	3	4	22	0	1	7	2	2	5	6	0	1	0	0	4	8	3	10	0	9	9	4	2	4	18	4	4	32	6	12	2	1	3	7	36	22	6	1	105	0	0	0	4	0	14	3	114	0	5	0	19	0	112	15	0	0	2	7	39	23	0	0	1	1	1	0	1	5	65	8	1	1	10	0	18	14	49	0	0	3	0	0	0	5	26	0	2	3	53	0	3	13	15	37	13	1	21	0	2	13	19	3	46	13	3	72	6	9	3	0	11	4	21	3	16	0	3	2	1	1	0	1	4	0	0	0	0	0	12	0	0	3	1	0	0	0	2	4	0	0	5	0	6	0	0	0	0	0	0	2	1	1	0	0	0	0	0	2	2	0	0	0	7	44	70	6	37	2	3	76	1	19	13	2	12	0	10	1	1	0	1	0	6	6	7	2	15	17	2	30	0	1	15	37	11	7	0	3	0	6	3	6	8	1	2	4	16	17	3	7	0	13	5	0	0	0	0	6	1	3	1	9	4	0	12	7	2	6	0	1	4	1	5	0	2	2	4	4	6	1	4	0	0	0	1	2	0	1	0	1	8	11	0	3	0	0	0	1	0	0	15	0	4	3	3	0	11	0	4	4	2	0	1	1	0	0	0	6	0	0	2	0	8	4	8	0	0	1	0	1	7	0	13	0	0	1	0	0	1	14	118	2	2	0	5	2	0	0	12	2	0	0	2	5	30	0	14	1	2	0	4	7	43	0	3	23	11	1	10	7	1	12	5	6	0	0	10	0	2	0	12	3	0	0	3	2	1	1	0	1	8	0	0	0	12	0	1	4	0	11	16	2	4	8	18	7	13	60	6	2	0	10	2	0	0	1	0	14	5	1	0	0	0	5	13	0	2	0	2	2	2	0	3	0	0	4	0	0	6	23	1	9	2	10	0	7	7	0	4	2	4	12	12	3	4	9	0	8	0	3	0	8	2	3	1	4	6	0	13	5	0	0	0	3	1	0	0	0	0	1	0	12	16	0	0	0	0	2	3	4	10	0	2	2	0	0	1	1	0	0	12	5	4	0	4	1	21	1	2	1	6	12	1	2	0	1	0	0	1	0	1	0	0	1	0	0	0	0	10	0	3	1	0	0	2	0	5	3	5	0	0	0	0	0	2	3	0	1	2	2	0	1	0	0	0	3	0	2	0	0	13	2	1	4	1	0	0	0	1	0	5	0	2	9	0	3	6	0	2	0	0	0	1	0	0	0	2	1	0	0	0	0	0	1	1	2	0	3	2	0	2	23	5	7	6	0	19	0	0	0	0	2	7	2	0	0	1	0	0	0	0	1	0	1	0	0	6	6	2	0	1	0	1	0	0	16	1	5	0	8	1	11	1	0	0	0	0	0	19	2	3	0	0	6	2	0	0	0	0	1	0	0	0	0	0	0	11	8	0	51	0	0	0	1	8	2	0	1	2	4	0	0	2	0	0	0	8	4	1	0	0	3	0	0	5	9	2	0	12	0	1	0	2	2	0	0	0	0	8	0	0	0	1	2	8	16	8	14	0	0	1	0	0	0	0	3	1	0	0	0	0	4	1	0	15	0	0	5	0	1	0	8	0	0	1	3	9	0	1	13	0	0	1	1	6	0	0	20	21	2	10	0	1	1	1	0	2	0	3	12	0	2	8	3	0	7	8	24	7	2	0	3	0	0	5	0	8	9	17	8	4	7	12	3	7	1	10	14	0	4	19	6	30	5	6	5	0	8	8	0	2	11	0	11	21	2	0	12	2	2	1	0	0	3	1	0	0	25	10	6	8	16	4	2	12	1	20	0	0	1	11	0	6	1	7	1	4	24	1	0	1	0	4	2	0	16	0	0	0	3	0	2	4	0	5	2	0	0	0	1	0	0	0	6	0	1	7	5	3	0	1	0	2	0	9	0	3	0	0	1	0	3	0	0	0	13	0	5	8	10	1	5	0	4	0	0	0	29	2	0	2	4	2	0	2	2	4	2	1	0	0	1	0	0	0	0	0	0	0	0	1	3	0	2	2	0	1	2	10	0	3	0	7	3	1	8	0	0	1	0	4	2	0	0	0	0	2	0	11	0	0	6	13	0	2	0	2	0	0	2	0	0	0	6	0	1	2	0	0	0	0	0	0	5	0	0	0	0	0	0	4	2	0	0	1	0	1	1	2	2	2	0	0	0	1	0	0	5	0	0	0	2	9	1	0	0	0	0	1	2	1	18	0	2	0	0	0	3	1	3	1	0	3	1	0	8	1	0	0	0	0	0	0	0	0	1	0	2	1	9	3	13	0	2	0	5	0	0	0	1	4	0	15	0	0	0	0	0	1	1	2	0	0	0	0	0	0	0	0	0	0	0	0	0	0	0	0	1	0	3	0	3	0	0	3	3	0	0	0	2	0	0	4	1	1	0	0	0	14	1	0	0	0	0	4	1	2	2	0	0	0	0	0	0	1	1	0	0	4	3	0	0	1	0	4	1	0	11	0	0	0	0	0	11	0	0	2	0	0	0	9	1	3	4	0	0	0	1	2	0	0	0	0	0	0	1	0	0	0	0	0	11	0	15	0	0	0	0	2	0	0	3	0	0	0	0	0	0	2	0	5	1	0	1	4	0	0	0	0	12	1	0	0	2	1	0	0	1	0	0	17	0	0	0	1	3	0	0	0	0	0	0	0	0	2	0	0	0	4	0	0	2	20	8	0	0	2	0	0	16	2	0	2	0	0	0	0	0	0	1	4	0	2	3	4	1	3	2	2	0	4	0	0	0	5	0	3	0	8	1	0	6	2	0	1	2	1	0	1	4	0	3	7	5	0	1	0	3	0	1	5	1	2	2	2	0	3	0	0	2	0	11	3	1	1	0	0	1	0	0	1	0	0	16	0	3	0	1	2	12	4	1	0	2	0	0	1	5	4	0	0	0	0	0	9	0	0	1	4	15	2	2	168	0	3	0	2	11	0	0	2	13	2	0	1	3	1	2	5	4	0	0	3	1	1	3	1	3	0	7	5	6	1	0	0	1	1	1	3	11	1	2	0	2	0	0	1	2	1	3	2	0	1	0	0	0	0	0	1	1	0	0	0	0	3	1	0	0	1	9	5	0	0	0	1	0	3	2	2	0	1	0	2	2	2	3	8	2	3	2	1	0	1	0	1	2	12	1	0	0	0	1	1	2	0	4	28	0	0	0	0	0	1	0	0	0	1	3	0	7	1	2	0	2	1	2	0	3	0	0	3	6	1	2	0	17	0	0	1	8	2	1	0	0	5	5	0	3	1	1	0	3	3	5	0	0	0	3	6	1	0	16	23	11	0	1	10	1	3	0	0	3	3	2	17	0	0	6	6	13	50	52	6	6	7	41	31	4	0	28	15	9	5	3	28	41	12	0	0	2	0	0	0	5	0	4	0	7	36	22	1	7	0	5	13	7	0	0	4	0	0	21	0	19	0	0	0	0	0	9	13	2	0	0	3	3	0	0	18	1	13	0	1	0	0	3	18	0	0	5	0	13	13	0	15	15	16	10	1	2	1	3	5	2	0	0	5	9	16	5	0	5	0	6	0	0	0	7	26	3	2	16	1	0	0	0	8	0	3	0	0	2	0	2	12	0	0	3	0	0	0	0	0	1	0	2	23	1	0	0	10	0	0	0	0	0	0	4	2	0	0	0	0	0	0	0	0	15	0	0	1	0	0	4	0	0	0	3	1	2	0	6	0	1	0	0	14	1	0	4	4	0	12	3	3	0	2	0	0	1	1	0	0	0	0	0	0	0	1	0	0	0	3	0	0	0	2	1	1	0	1	2	3	4	2	0	0	0	8	0	0	0	0	8	2	5	25	7	0	0	0	0	0	0	3	2	0	0	0	0	0	5	1	2	1	4	1	0	0	10	0	0	3	0	1	1	0	2	0	0	0	0	2	0	2	0	0	0	0	0	0	0	0	0	0	0	0	0	0	0	2	0	2	2	0	0	0	0	0	0	2	0	0	0	0	0	0	1	2	0	0	0	1	0	1	0	8	0	1	1	3	1	0	4	0	6	0	0	0	0	0	0	1	3	1	0	1	2	1	3	0	0	0	0	0	0	29	2	0	0	0	0	0	0	7	0	0	0	0	0	34	0	3	1	0	0	2	4	0	0	0	0	0	0	0	2	0	0	0	1	0	5	1	0	2	0	0	0	0	7	7	4	2	1	0	6	6	0	0	0	1	1	13	1	3	0	0	0	99	0	5	1	1	0	1	15	0	9	3	8	7	4	3	0	0	0	0	0	0	0	0	1	0	0	7	1	0	0	0	0	0	0	0	2	0	0	0	0	0	0	0	1	0	0	0	5	0	0	1	0	0	0	1	0	0	2	0	1	1	0	0	0	0	1	1	1	0	0	2	1	0	0	0	3	0	0	0	0	5	0	0	0	2	1	2	0	1	7	6	0	7	0	0	0	7	0	2	0	1	0	0	2	3	0	0	0	0	0	2	0	4	0	0	0	0	0	0	0	0	0	0	0	1	2	2	2	8	4	2	2	11	2	3	0	0	0	18	0	2	7	8	0	0	0	19	18	0	0	1	1	0	0	11	4	1	6	0	9	0	0	0	1	0	0	1	0	1	0	7	0	1	0	5	1	2	0	0	0	2	2	0	0	0	0	0	0	4	6	0	1	0	0	0	0	1	1	2	3	0	0	0	7	0	4	0	0	2	0	0	0	0	0	0	0	0	0	1	2	0	0	0	2	0	0	0	0	0	0	1	0	0	3	2	0	1	0	1	7	0	0	0	1	1	0	0	7	2	1	2	0	0	0	0	0	0	0	0	7	1	0	1	0	0	0	0	0	0	0	0	0	2	0	0	0	2	0	2	0	4	0	0	0	0	0	0	0	1	0	0	0	0	1	4	1	8	4	10	6	0	0	5	0	2	0	0	1	0	0	0	5	2	4	0	0	1	5	0	0	0	0	0	0	0	0	0	0	12	0	1	0	0	2	0	2	1	0	0	0	0	0	0	2	0	0	0	0	0	0	0	2	0	0	0	0	0	0	1	0	0	0	0	0	0	0	0	1	1	0	4	0	1	45	1	0	0	1	0	0	0	0	0	0	0	6	0	2	5	0	0	0	0	0	3	0	18	0	0	0	2	0	0	1	1	7	0	0	0	0	0	2	0	0	0	2	0	0	0	0	0	0	1	1	0	0	1	0	0	0	0	0	0	0	0	1	0	0	0	0	1	3	0	5	0	0	0	0	0	1	0	0	0	0	0	2	0	5	0	2	0	6	0	0	0	0	0	0	0	0	4	0	9	0	0	0	0	0	4	2	0	0	1	4	0	0	0	2	0	1	1	1	0	0	0	0	0	1	0	0	1	1	0	0	1	0	2	0	2	0	1	0	0	0	0	0	0	1	0	0	1	0	0	0	0	0	0	5	0	0	2	0	0	0	0	1	2	1	0	0	2	0	0	0	0	2	0	0	0	0	1	1	0	2	0	0	1	1	0	0	0	1	0	0	2	0	7	1	0	0	0	0	1	10	0	0	0	0	0	1	0	1	0	0	3	0	0	1	1	0	0	0	0	2	8	0	0	0	0	1	0	0	3	0	4	0	0	0	0	1	1	0	0	1	1	1	0	0	0	3	1	0	3	0	0	2	1	0	2	0	0	2	0	0	1	1	0	0	16	0	0	0	2	0	0	0	0	0	0	0	0	0	0	0	0	0	1	0	0	0	0	0	3	0	0	0	0	2	4	0	0	0	0	0	0	2	0	1	3	1	0	1	0	2	3	0	0	0	0	0	0	0	0	0	0	1	0	0	0	0	0	4	6	14	10	0	0	5	5	0	0	14	19	19	0	14	0	0	0	1	0	2	0	0	0	0	0	0	16	2	8	0	0	0	5	0	0	0	0	7	0	2	0	4	0	0	0	0	0	0	0	0	0	0	0	4	0	0	0	6	0	1	0	0	0	0	0	1	9	0	24	0	0	0	0	0	0	0	0	0	0	0	0	0	0	0	0	0	0	0	0	0	4	0	0	0	0	0	2	0	0	0	0	2	0	0	0	0	0	0	0	0	0	0	0	0	0	0	3	0	0	0	0	0	0	0	0	21	0	0	0	0	0	0	0	0	0	15	0	0	1	0	0	0	1	1	0	0	0	20	0	0	16	0	0	0	0	0	0	0	0	2	0	0	0	0	0	1	0	0	0	3	0	0	1	2	1	0	0	0	0	0	0	0	5	0	2	0	0	0	0	1	1	0	1	1	0	0	0	12	2	0	6	0	0	0	0	0	0	0	3	10	12	0	13	0	0	0	0	0	0	1	0	0	4	0	0	1	2	2	0	0	0	0	0	0	0	0	0	1	0	0	0	0	0	0	0	3	1	0	2	0	7	1	1	0	0	2	7	0	0	0	0	0	2	0	1	0	0	0	0	0	0	0	3	2	0	0	0	0	0	2	0	0	0	0	2	0	3	0	1	0	0	0	0	0	0	0	0	0	7	0	4	0	0	0	0	0	0	2	4	0	0	4	0	0	0	0	0	0	0	1	12	1	10	2	14	19	0	3	3	14	3	0	0	0	0	0	3	4	0	0	0	2	10	1	0	0	2	1	0	1	0	0	0	2	0	0	0	2	0	0	0	0	0	1	0	3	1	0	0	3	0	0	2	0	3	0	0	0	0	0	1	0	0	0	1	2	0	0	0	0	2	0	11	0	6	0	2	0	0	0	0	0	0	1	1	0	0	0	0	1	0	0	0	1	1	2	0	0	0	0	0	1	0	0	2	0	4	0	0	5	0	0	0	4	0	0	1	0	4	0	0	0	0	0	1	0	1	1	0	1	0	1	1	0	0	0	0	0	0	0	0	5	14	4	0	16	0	0	0	0	0	0	0	0	0	0	0	0	1	0	0	0	0	2	3	0	0	0	0	0	0	1	1	1	1	0	0	0	0	6	5	0	1	0	0	0	4	0	0	0	0	2	2	0	0	0	0	0	0	0	1	0	0	2	0	1	2	0	0	0	0	0	3	0	0	5	0	0	5	0	0	0	0	0	0	0	1	6	0	1	0	0	0	0	0	1	0	0	0	0	0	0	0	3	0	0	0	13	0	0	0	1	1	1	0	0	5	0	0	0	0	0	0	0	0	1	0	0	0	0	0	0	0	0	0	0	0	1	0	0	3	0	1	0	3	0	6	1	0	0	1	1	5	0	4	0	0	0	1	0	0	1	1	0	0	0	1	0	0	0	0	0	0	0	1	2	0	0	0	2	1	0	0	1	0	0	0	0	2	0	0	0	0	0	1	2	0	0	0	0	0	1	0	0	0	1	0	1	1	0	0	0	0	0	1	0	0	0	0	0	0	0	0	0	0	0	0	0	3	0	0	0	0	0	0	0	0	2	1	0	0	2	0	0	0	0	0	0	0	0	2	2	0	0	0	0	3	0	0	0	0	0	0	0	2	0	0	0	0	0	0	0	0	0	0	0	1	2	0	0	0	0	0	0	0	1	0	0	0	0	2	0	0	0	0	0	0	2	0	0	0	0	1	0	0	0	0	0	0	0	4	0	0	0	0	0	0	0	0	1	0	0	0	0	0	0	0	0	1	0	0	0	0	0	1	1	2	0	0	0	0	1	1	0	2	2	0	0	0	0	0	0	0	0	0	4	0	9	0	0	3	2	0	0	2	0	0	10	0	1	9	0	0	0	0	0	0	0	0	3	0	0	0	4	0	0	0	0	0	9	2	0	0	0	2	3	1	0	0	0	0	0	1	0	0	0	0	1	3	0	0	2	0	0	0	2	0	1	1	0	0	0	0	0	0	0	0	0	0	0	0	0	0	0	1	0	3	0	0	0	0	0	0	0	0	0	0	0	0	0	5	1	0	0	1	0	0	0	0	1	0	0	2	0	0	0	0	2	5	0	0	0	0	0	0	0	1	0	0	0	0	1	0	0	0	2	6	0	0	3	1	0	2	4	1	0	0	1	2	0	0	5	0	0	0	0	3	0	0	1	0	3	0	0	0	0	0	0	2	0	0	5	0	0	1	0	0	0	7	0	7	0	1	0	1	6	11	2	3	1	2	5	0	0	0	0	0	1	0	0	0	0	0	0	2	0	0	0	0	0	0	0	0	0	0	0	0	0	0	0	0	0	0	0	0	0	0	0	0	1	0	0	0	2	0	0	0	0	1	0	1	0	0	0	0	0	0	1	0	1	0	0	0	1	0	0	3	4	0	0	0	0	1	0	0	0	5	2	0	0	0	0	2	0	0	0	0	1	0	1	1	0	0	0	0	5	0	1	0	0	0	0	0	0	0	0	0	1	0	0	0	0	1	0	0	0	0	0	1	0	0	0	0	3	1	0	0	3	0	0	0	0	0	0	0	2	0	0	0	0	1	0	0	0	0	0	0	0	0	0	2	0	0	0	0	0	0	10	2	0	0	0	2	0	0	0	3	3	0	0	0	0	0	0	0	1	0	2	0	0	0	1	0	11	0	0	0	0	0	0	0	0	0	0	0	0	0	2	1	0	0	1	0	0	0	0	0	0	1	0	0	0	0	0	0	0	0	0	0	1	0	0	0	0	0	0	0	0	0	0	0	0	0	0	0	0	2	2	0	0	0	0	0	0	0	0	0	0	0	3	0	2	0	0	0	0	0	2	0	1	0	0	0	0	0	0	0	0	0	0	0	1	0	0	0	0	0	0	1	1	0	1	3	2	1	0	2	0	0	1	0	2	0	0	4	4	0	0	2	0	0	0	1	0	3	0	2	1	0	0	8	11	2	0	2	0	0	0	0	0	0	0	0	0	2	0	0	0	0	0	0	0	2	0	0	0	0	0	0	0	0	4	0	0	0	0	0	3	0	0	0	0	0	0	0	0	0	1	0	0	0	0	0	0	0	0	1	0	0	0	0	0	0	0	0	0	0	0	0	0	0	0	0	0	4	0	4	0	0	0	0	5	0	2	0	1	0	0	0	3	0	0	8	0	0	0	0	4	1	0	14	0	138	0	0	3	2	1	0	0	0	0	0	6	11	0	0	0	0	77	0	15	0	5	0	2	30	3	1	8	12	12	10	13	15	0	0	0	0	0	0	0	0	3	0	0	2	0	0	2	1	0	0	0	0	0	0	0	0	0	0	0	0	2	0	0	0	0	5	5	0	1	0	0	0	0	0	0	3	0	0	0	0	2	0	1	1	0	0	0	0	0	0	0	0	0	0	0	0	10	2	0	0	0	0	0	1	1	0	0	0	6	2	6	0	0	0	0	1	0	0	3	0	2	0	0	0	0	1	1	0	1	0	0	0	2	1	0	0	0	0	0	2	0	0	0	0	0	9	0	9	0	21	0	1	2	5	0	3	0	1	1	0	3	58	8	0	7	0	0	0	0	0	0	0	2	0	1	0	0	0	1	0	1	2	1	0	3	1	3	0	1	0	0	0	2	0	0	0	0	0	0	0	1	1	1	0	0	0	3	1	0	0	0	0	0	0	2	0	0	0	0	0	0	2	0	0	0	0	0	0	1	0	0	0	3	5	0	0	0	0	0	0	0	0	5	0	0	0	0	0	0	0	0	0	0	0	0	2	1	0	48	5	12	0	0	22	45	0	2	1	0	0	1	0	0	7	0	1	0	0	5	2	3	0	3	0	0	0	0	6	6	0	0	0	0	0	0	0	0	0	0	0	1	0	1	0	0	0	3	1	0	4	0	7	0	4	0	142	2	13	0	0	1	2	0	2	1	2	0	28	1	1	0	0	0	3	1	0	0	1	2	0	0	0	0	2	4	1	2	0	10	3	0	0	2	0	0	0	0	5	1	4	0	0	2	0	0	0	0	0	0	0	0	1	0	0	2	0	0	3	2	3	1	2	30	17	0	4	0	0	0	3	0	1	4	1	6	0	1	8	0	0	0	0	0	0	0	0	0	0	0	0	0	2	1	2	0	3	4	0	0	0	2	0	0	1	0	0	0	0	0	2	0	0	1	0	11	4	5	1	0	3	2	0	0	1	3	0	2	5	3	3	0	0	0	1	0	0	0	0	0	0	0	0	0	0	0	0	0	0	0	0	0	0	0	0	0	0	0	0	0	0	0	0	0	0	0	0	0	0	0	0	1	0	0	0	0	0	0	0	0	0	0	0	0	0	2	0	0	0	0	0	0	0	0	0	0	0	0	0	0	0	0	0	0	0	0	0	0	0	22	0	0	0	1	2	0	7	5	0	0	0	0	0	0	0	0	0	1	0	0	0	0	2	4	0	1	0	0	0	0	0	0	0	1	1	0	0	0	0	0	0	0	0	0	0	0	0	0	7	0	2	0	0	0	0	0	0	0	0	2	0	0	0	0	0	2	0	0	0	0	0	0	1	0	0	0	0	0	0	0	0	0	1	0	0	0	0	1	0	0	0	0	0	0	0	0	0	0	0	0	0	0	0	0	0	0	0	0	0	0	0	0	0	0	0	0	0	0	0	1	0	1	0	0	1	0	1	0	0	0	0	0	2	0	0	0	1	0	0	0	1	0	0	0	0	0	0	0	0	0	2	0	0	1	0	0	0	0	0	0	0	0	0	0	0	0	0	0	0	0	0	0	1	0	1	1	0	0	0	0	0	0	0	0	0	0	0	0	0	0	0	3	0	10	0	0	0	0	0	0	0	0	1	1	0	0	0	0	0	0	0	0	1	0	0	0	0	1	0	0	0	0	0	0	0	0	0	3	0	0	0	0	0	0	0	0	1	4	0	0	2	0	0	0	0	1	0	2	0	0	0	0	0	0	0	1	0	0	0	0	0	0	0	3	0	0	0	0	3	0	0	0	0	6	0	0	0	0	0	5	0	0	1	0	0	0	3	4	4	0	0	0	0	0	0	0	0	0	2	0	0	0	0	1	1	0	0	0	14	5	3	0	18	0	0	0	0	0	0	0	0	1	1	0	0	0	1	0	0	0	0	3	2	4	7	0	0	0	5	0	7	0	0	1	0	0	0	0	0	0	5	4	0	0	0	0	1	0	0	0	0	0	0	0	0	0	0	0	0	1	0	0	0	0	0	0	0	0	0	0	0	1	0	0	0	0	0	0	2	1	0	0	0	2	0	0	0	0	0	0	0	0	0	0	0	0	0	0	0	0	0	1	0	0	0	0	0	0	0	0	0	0	0	1	0	1	0	0	0	0	0	0	0	0	0	0	0	0	0	0	0	0	0	0	0	0	3	3	0	0	0	0	0	0	0	0	0	0	0	0	0	0	0	0	0	0	0	0	0	0	0	0	0	2	0	0	0	0	1	0	0	0	1	0	0	2	0	0	0	0	0	0	0	0	0	0	0	1	0	0	0	0	2	0	0	0	0	0	0	0	0	0	0	1	0	0	1	0	0	0	0	0	0	0	0	0	0	1	0	0	0	0	0	0	0	0	0	0	0	1	0	0	0	0	0	0	1	0	0	0	0	0	0	0	0	0	0	0	0	0	0	2	0	0	0	1	0	0	0	0	0	2	0	1	0	0	0	0	1	0	0	0	0	0	0	0	0	0	0	1	0	0	1	0	0	0	1	0	0	0	0	0	0	0	0	0	2	0	0	0	0	0	1	0	0	0	0	0	0	0	0	0	0	0	0	0	0	0	0	2	0	0	0	0	0	0	1	0	0	0	0	0	0	0	0	0	1	0	2	0	0	0	0	1	0	0	0	0	0	0	0	1	0	0	0	0	0	0	0	0	0	0	0	1	0	1	0	0	0	0	0	0	0	1	0	0	1	0	0	0	0	0	1	1	0	0	0	3	0	1	0	0	0	0	2	2	0	0	0	0	2	0	0	18	0	1	0	0	0	0	0	0	2	1	1	0	1	0	2	0	1	0	2	2	1	0	0	0	0	1	0	0	0	0	10	0	0	0	0	0	0	0	0	0	0	0	0	0	0	1	0	0	0	0	0	1	0	0	0	0	0	0	0	0	0	0	0	0	0	0	0	0	0	1	0	2	0	0	0	0	0	0	0	0	0	1	0	0	0	0	0	0	0	0	0	0	2	0	0	0	0	0	0	0	0	0	0	0	0	0	0	0	0	2	0	0	0	0	2	0	0	0	0	0	1	1	0	0	0	2	1	0	0	0	0	0	0	0	14	0	0	0	0	0	0	3	3	1	0	0	0	0	0	0	5	1	2	1	5	5	2	0	4	0	0	22	0	0	0	0	0	1	2	1	0	0	0	0	0	0	9	1	0	0	0	0	0	0	0	2	0	0	0	0	0	0	1	0	4	0	0	0	0	4	1	0	14	0	0	1	2	3	0	0	0	0	2	0	0	1	2	0	0	1	0	2	0	1	0	0	0	0	10	13	0	0	0	1	1	1	0	2	0	0	6	0	0	0	0	0	0	0	0	0	0	0	0	1	0	0	0	0	0	0	0	2	2	0	0	0	0	0	0	0	0	3	0	0	0	2	0	0	0	0	0	0	0	0	0	0	0	0	0	0	0	0	0	0	0	0	1	0	0	0	0	0	0	0	1	0	0	0	0	0	0	0	0	0	0	0	0	1	0	0	0	0	0	0	0	0	0	0	0	0	0	0	0	0	0	0	0	0	0	0	0	0	0	0	0	0	0	0	0	0	0	1	0	1	0	1	0	1	0	0	0	0	0	0	0	0	0	0	0	0	0	0	0	0	0	0	0	0	0	0	0	0	0	0	0	0	0	0	0	0	0	1	0	0	0	0	2	0	0	1	0	1	0	0	0	0	0	0	2	0	0	0	0	0	0	0	0	0	0	0	0	0	0	0	0	0	0	0	0	1	0	0	0	0	6	0	0	1	0	0	0	0	0	0	0	1	0	0	0	0	0	0	0	0	0	1	0	0	0	0	0	1	0	1	0	0	0	0	0	0	0	0	0	3	0	1	0	0	1	0	0	0	0	0	0	0	0	0	0	0	0	0	0	0	0	1	0	0	1	1	0	0	0	0	0	0	0	1	0	0	0	0	0	0	0	0	0	0	0	0	0	0	0	1	0	2	0	0	0	0	0	0	0	0	0	1	0	1	0	0	0	1	0	0	0	0	0	0	0	0	0	0	0	0	0	0	0	0	0	0	0	0	0	0	0	0	1	4	0	0	0	0	0	0	0	0	1	0	0	0	0	0	0	0	1	0	0	0	0	0	0	0	0	0	0	0	0	0	0	0	0	0	0	1	0	1	2	0	0	0	0	0	0	0	0	0	0	5	0	0	0	0	0	0	0	0	0	0	0	0	0	0	0	2	0	0	0	0	0	0	0	0	0	0	0	0	0	2	0	0	0	0	0	0	0	0	0	0	0	0	0	0	0	0	0	0	0	0	0	1	0	0	0	3	0	0	0	0	0	0	0	0	2	1	0	0	0	0	0	0	0	0	0	0	1	0	0	0	0	1	9	0	0	0	5	8	0	0	0	0	1	1	0	0	0	2	0	0	0	0	4	0	0	0	0	0	0	0	4	0	4	2	0	1	1	0	1	0	0	0	0	0	0	1	0	3	0	0	0	1	0	0	0	0	2	0	0	2	0	4	0	0	1	1	0	0	3	0	0	0	2	0	13	0	2	1	0	0	0	0	2	0	1	0	0	0	0	0	1	0	0	0	0	6	3	0	0	0	2	0	0	6	0	1	0	0	0	0	1	0	6	0	0	0	0	0	11	0	0	0	0	0	0	0	0	0	3	0	0	0	0	0	0	0	0	6	0	0	0	0	0	0	0	0	0	0	0	0	0	0	0	0	1	0	1	0	0	0	0	1	0	0	0	0	0	1	0	0	0	0	0	0	0	0	0	0	0	0	0	0	0	0	0	0	0	0	0	1	0	0	0	0	0	0	1	1	1	0	0	0	0	0	1	0	0	5	0	0	0	0	5	0	0	0	0	0	0	0	0	0	4	0	0	0	0	0	0	0	0	0	0	0	0	0	0	0	0	0	0	0	1	0	0	2	0	0	2	0	0	0	0	0	1	0	0	0	0	0	0	0	0	0	0	0	0	1	3	0	0	0	0	2	0	0	6	0	0	0	0	0	0	2	1	0	0	0	0	0	0	0	2	2	0	0	0	0	0	0	0	0	0	0	0	7	4	0	0	0	0	0	1	1	0	3	0	1	0	0	0	0	0	2	0	0	0	0	1	0	0	0	0	2	3	0	0	0	2	0	0	2	0	0	0	0	0	0	0	0	3	0	0	0	0	0	0	4	0	0	0	0	0	2	0	0	0	0	0	0	0	0	0	0	1	0	0	0	0	0	0	0	0	0	0	0	0	0	0	3	0	1	1	3	0	0	0	0	5	1	0	0	0	0	1	1	0	0	0	0	0	0	0	12	0	8	0	0	11	0	9	0	0	0	0	4	1	0	2	1	12	0	1	0	0	0	0	0	0	0	0	0	3	0	6	0	0	0	2	4	1	0	2	0	2	0	1	1	2	1	0	7	5	0	2	1	2	5	10	0	1	1	0	0	0	0	0	0	0	0	0	0	0	37	0	0	0	10	1	0	5	8	0	0	1	0	0	0	0	0	1	0	1	0	0	1	0	0	0	0	0	0	0	0	0	1	0	0	2	0	0	0	2	0	8	1	0	0	0	0	0	0	0	0	0	0	0	1	0	0	0	0	3	0	0	0	0	0	0	0	0	1	0	0	0	0	0	0	0	0	1	0	0	0	0	0	0	10	1	8	0	1	2	0	0	1	0	0	1	0	0	0	0	0	0	0	3	9	8	9	0	0	0	0	1	0	0	1	0	0	2	0	0	0	2	0	0	0	1	4	0	3	1	11	2	0	14	11	17	0	5	20	0	2	82	1	1	0	0	0	0	0	0	0	0	0	0	0	0	0	0	0	0	1	0	0	0	1	0	2	1	0	8	0	0	1	0	0	0	0	0	0	0	0	0	23	1	8	3	0	0	0	0	2	0	2	4	18	2	0	0	3	0	11	2	0	12	0	0	0	1	0	0	0	1	0	0	0	0	0	0	7	2	7	0	3	0	4	2	2	1	0	0	0	0	1	9	0	38	0	0	0	0	4	3	0	0	4	2	1	0	0	0	3	1	0	1	2	3	0	2	12	1	2	6	5	1	11	8	0	0	37	1	0	1	0	0	2	7	0	2	0	0	1	0	2	0	0	38	0	2	1	1	2	0	0	0	4	0	2	0	0	3	0	6	0	0	0	2	1	0	0	0	12	0	0	5	9	4	0	0	0	4	1	0	0	1	5	0	0	0	0	0	0	0	21	2	0	1	0	0	1	1	0	1	0	0	2	12	0	0	0	0	13	0	0	0	3	0	6	0	2	0	4	0	2	2	0	0	0	0	6	4	0	7	0	0	0	8	0	1	7	1	0	3	0	0	0	0	0	0	0	0	0	25	0	0	0	0	6	3	0	0	1	3	0	0	0	0	0	1	0	0	0	0	1	1	0	0	0	0	0	0	0	0	0	0	0	0	0	0	0	0	0	0	0	5	0	1	10	0	1	1	0	0	0	0	1	0	4	0	3	0	1	0	0	0	0	3	3	0	8	0	4	0	1	1	0	0	1	0	0	0	0	0	0	0	0	2	0	2	0	0	0	0	1	0	0	3	0	0	3	0	0	0	0	0	0	0	1	0	0	5	0	2	2	0	1	0	0	0	0	0	0	0	0	0	0	0	0	0	0	0	0	0	0	0	0	0	0	0	0	0	0	0	0	0	1	0	0	0	0	0	0	0	0	0	0	0	0	0	1	0	1	0	2	1	0	0	0	0	0	2	0	0	0	0	0	0	0	0	0	0	0	2	0	0	0	0	0	0	0	0	0	0	0	0	1	0	0	0	0	0	0	0	0	0	0	0	0	0	0	0	0	0	0	0	0	2	0	0	0	0	0	0	0	0	0	0	0	0	0	0	0	0	0	0	1	0	0	0	0	0	0	0	0	0	0	0	4	0	0	0	0	0	0	0	0	0	0	0	0	0	0	0	0	0	2	0	0	0	0	0	0	0	0	1	0	0	0	0	0	0	0	0	0	0	0	0	0	0	0	0	0	0	0	0	0	3	4	0	0	0	0	0	0	0	0	1	0	2	5	0	0	0	0	0	0	6	0	0	0	0	0	0	0	0	0	3	0	0	1	0	0	0	1	0	0	0	0	2	0	1	0	0	0	0	0	0	0	0	0	0	1	0	0	0	0	2	0	0	0	0	0	0	0	0	0	0	0	0	0	0	0	0	0	0	0	0	2	0	0	2	0	0	0	0	0	0	0	1	0	0	0	1	0	0	0	1	0	0	3	0	7	0	0	0	0	0	0	1	1	3	1	0	0	3	0	0	22	0	1	3	1	0	1	0	3	0	0	4	0	0	0	16	0	0	0	5	0	0	0	0	0	2	0	1	1	0	2	1	0	3	0	0	0	0	5	0	0	0	0	0	0	0	4	13	4	3	0	2	3	0	2	3	1	0	0	0	0	0	0	2	2	0	0	3	0	2	0	2	0	0	3	0	0	0	0	0	0	0	2	3	3	0	0	0	1	0	0	7	3	0	1	0	1	2	0	0	0	0	0	0	0	0	1	0	0	0	0	0	0	0	0	1	0	0	0	0	0	1	0	0	0	0	0	0	0	0	0	0	0	0	0	1	0	0	0	0	0	0	2	0	0	0	0	0	0	0	0	1	0	0	0	0	0	0	0	0	0	0	0	0	0	0	0	0	0	0	0	0	2	0
PHYLLO20	6387	0	0	0	22	104	4	0	34	0	0	6	4	0	4	0	0	0	0	0	0	0	0	0	4	0	0	4	2	0	2	0	0	0	0	0	2	0	0	0	0	0	0	0	4	0	0	0	0	0	12	0	10	18	24	0	34	0	0	0	137	0	0	4	8	7	0	4	0	0	0	0	0	0	0	0	0	0	0	0	0	0	52	14	8	1	0	12	0	8	0	4	0	4	4	4	2	0	19	0	0	26	4	4	0	4	12	0	10	1	0	0	0	4	0	2	8	4	0	0	8	0	12	0	0	14	12	6	0	0	0	4	0	4	0	0	0	16	0	0	6	8	12	0	0	0	4	0	0	4	4	0	0	0	0	0	0	0	10	8	12	0	0	6	0	4	0	6	12	4	0	8	2	0	8	0	0	0	4	0	0	2	0	2	0	0	4	0	0	0	0	10	0	0	0	0	10	4	0	0	0	0	0	0	0	0	0	10	0	0	14	0	0	0	16	26	0	8	0	0	0	0	6	0	12	0	8	30	2	0	12	0	0	0	0	0	0	0	0	0	8	0	14	0	0	0	0	0	2	0	0	0	4	0	4	0	0	0	8	0	0	0	0	0	0	0	4	8	0	4	4	0	2	0	4	0	0	0	0	4	0	4	0	4	16	12	0	0	8	0	2	0	0	0	2	0	26	0	0	0	0	0	16	0	0	0	0	4	0	4	16	0	0	0	0	0	0	0	0	8	0	2	0	0	0	0	0	0	0	0	0	0	0	0	0	0	2	0	0	0	1	7	0	20	21	0	0	0	0	0	0	2	2	0	16	0	2	2	0	0	4	0	0	0	0	0	4	8	0	12	0	8	4	0	0	0	24	0	4	18	0	0	0	2	4	0	8	2	0	0	44	0	0	0	12	4	24	4	22	0	0	0	0	0	26	4	0	0	0	4	14	22	0	0	0	4	0	0	0	8	2	2	0	0	12	0	0	6	12	0	0	0	0	0	0	2	10	0	0	0	14	4	0	6	0	16	10	4	0	0	0	2	10	4	12	4	2	28	8	0	2	0	134	22	56	12	24	0	0	0	0	2	0	0	0	0	0	0	0	0	8	0	0	0	0	0	0	0	0	4	0	0	0	0	2	0	0	0	0	0	0	0	0	0	0	0	0	0	0	0	0	0	0	0	12	8	34	0	4	4	4	10	0	0	4	0	20	0	8	0	0	0	4	0	0	0	2	0	0	12	0	2	0	4	0	17	0	0	0	0	0	4	0	4	10	0	2	0	2	14	0	8	0	0	0	0	0	0	0	8	0	4	0	0	0	0	8	1	0	6	0	0	0	0	0	0	0	6	0	4	0	0	0	0	0	0	0	0	0	0	0	0	0	8	0	0	2	0	0	0	0	0	0	0	0	6	4	0	0	0	0	0	0	0	0	2	0	0	0	0	0	0	4	0	2	0	0	0	0	8	0	0	0	0	2	0	0	0	0	0	0	8	54	2	2	0	4	2	0	4	4	0	0	0	0	0	4	0	10	0	0	0	0	4	20	0	2	12	2	0	8	4	4	4	4	4	0	0	2	0	0	0	4	0	0	0	0	0	0	0	0	0	4	0	0	0	0	2	0	4	0	8	0	0	0	6	4	0	6	12	2	0	0	4	8	0	0	0	0	0	4	0	0	0	0	4	12	0	0	0	0	0	0	0	4	0	0	0	0	0	4	4	0	0	2	0	0	0	8	0	0	10	2	12	0	0	0	2	0	4	0	4	0	0	4	4	0	0	0	0	12	16	0	0	0	0	4	0	0	0	0	0	0	4	0	0	0	0	0	0	0	0	4	0	0	0	0	0	0	0	0	0	8	0	4	2	12	0	4	0	0	0	4	0	0	0	0	0	0	0	0	0	0	0	0	0	0	0	0	0	8	0	4	0	0	0	4	0	0	0	0	0	0	0	0	0	4	4	0	0	8	0	0	0	0	0	0	4	0	0	8	0	0	0	0	0	4	0	0	0	0	4	0	0	0	7	0	0	4	0	0	0	6	0	4	0	4	0	0	0	0	0	0	0	0	0	0	0	0	0	0	0	0	0	0	6	0	0	16	0	0	0	0	0	0	4	0	0	0	0	0	0	0	0	0	4	0	4	2	0	0	0	0	0	0	0	0	8	0	4	0	0	0	4	6	0	0	0	0	0	24	0	0	0	0	6	0	0	0	0	4	0	0	0	0	0	0	0	12	2	0	12	0	0	0	0	10	2	0	4	12	0	0	0	0	0	0	0	0	0	0	0	0	4	0	0	0	4	0	0	0	0	0	0	5	4	0	0	0	0	6	0	0	0	0	0	0	0	10	0	0	0	0	0	0	0	0	0	0	0	0	0	0	0	0	0	4	0	0	0	0	0	0	4	4	0	0	4	2	0	0	0	0	0	0	0	8	0	0	6	0	0	0	0	0	0	0	0	2	0	4	0	0	0	4	0	0	4	2	18	0	0	0	2	0	0	0	0	0	0	12	0	4	0	2	4	8	0	0	0	0	0	15	6	9	4	0	5	0	0	0	0	0	0	0	0	4	0	0	0	4	0	4	0	0	4	0	0	0	43	0	8	0	4	4	0	0	0	2	2	0	0	2	0	4	0	4	0	0	6	0	0	0	0	4	0	0	6	0	0	0	0	0	0	0	0	0	0	0	0	0	0	0	0	0	6	0	6	0	0	2	0	0	0	4	0	8	0	0	0	0	2	0	0	0	0	0	4	0	0	4	2	0	0	0	2	0	0	0	12	0	0	0	0	4	0	0	4	0	0	0	0	0	0	0	0	0	0	0	4	0	0	4	0	0	0	0	0	0	0	0	0	0	0	0	0	0	0	0	0	0	0	0	0	0	0	0	0	0	0	12	0	0	8	8	0	4	0	0	0	0	0	0	0	0	0	0	0	0	0	0	0	0	0	0	0	0	0	0	0	0	0	0	0	0	0	0	0	0	0	0	4	0	0	0	0	0	0	0	0	0	0	0	0	4	0	0	0	0	0	0	0	0	12	0	0	0	0	0	0	0	4	0	0	2	0	2	0	2	0	0	0	0	0	0	0	0	0	0	0	0	0	2	8	0	0	0	2	0	0	0	4	12	0	4	0	0	0	0	0	0	0	0	0	0	0	0	0	0	0	0	0	0	0	0	0	0	0	0	0	0	0	0	0	0	0	0	2	0	0	0	0	0	0	4	0	0	0	0	0	0	4	0	0	0	0	4	4	0	0	0	0	0	0	0	0	0	0	0	0	0	0	0	0	0	0	0	0	0	0	0	0	0	0	0	0	0	0	0	0	0	0	0	0	0	2	0	0	0	4	0	0	0	0	0	0	0	0	0	0	0	0	0	0	0	6	0	0	0	0	0	0	0	0	0	0	0	0	0	0	0	0	0	4	0	0	0	0	0	0	0	0	0	0	0	0	0	0	0	0	0	0	2	0	0	0	0	0	0	0	0	0	0	0	0	0	0	0	0	0	0	0	0	4	4	8	0	0	0	0	0	16	0	0	0	0	0	0	0	0	0	0	4	0	8	8	4	0	0	0	0	0	0	0	0	0	4	0	2	0	8	0	0	12	0	0	0	0	0	0	0	8	0	0	4	0	0	0	0	0	0	0	0	8	0	0	0	0	0	0	0	0	0	0	0	2	0	0	0	0	0	2	0	0	0	0	0	4	0	0	0	8	0	0	0	0	0	0	0	2	8	0	0	0	0	4	4	0	0	0	0	0	0	0	29	0	0	0	0	4	0	0	0	8	0	0	0	0	0	0	4	0	0	0	4	0	0	0	0	0	0	4	0	0	0	0	0	0	0	0	4	0	0	0	0	0	0	0	0	0	0	4	0	0	0	0	0	0	0	0	0	0	0	0	0	0	0	0	0	0	0	0	0	0	0	0	4	0	0	0	4	0	0	0	0	0	0	8	0	0	8	0	0	0	0	0	0	0	0	0	0	0	0	4	0	0	0	0	12	0	0	0	0	0	0	0	0	0	0	0	0	0	2	0	0	4	0	0	0	0	0	0	4	0	0	0	0	14	0	4	0	4	0	0	0	0	4	4	0	0	0	0	4	0	0	4	0	0	0	0	0	4	0	14	8	12	0	0	0	4	0	0	0	0	0	4	10	0	0	4	4	2	21	22	7	8	4	2	6	4	0	12	8	4	2	0	12	12	0	0	0	0	0	0	0	0	0	0	0	2	1	6	0	0	0	8	12	4	0	0	8	0	0	14	0	4	0	0	0	0	0	0	0	4	0	0	4	4	0	0	8	0	4	0	0	0	0	4	2	0	0	0	0	0	12	0	6	6	6	0	0	0	0	2	0	0	0	0	0	0	4	4	0	0	0	4	0	0	0	4	4	2	0	14	0	0	0	0	2	0	4	0	0	0	0	0	0	0	0	2	0	0	0	0	0	4	0	0	4	4	0	0	0	0	0	0	4	0	0	0	0	0	0	0	0	0	0	4	0	12	0	0	0	0	0	0	0	0	0	0	0	0	0	10	0	0	0	0	6	4	0	0	0	0	0	2	0	0	0	0	0	0	0	0	0	0	0	0	0	0	0	0	0	0	4	0	0	0	0	0	2	0	0	8	4	4	0	0	0	0	6	0	0	0	0	0	0	4	32	0	0	0	0	0	0	0	0	0	0	0	0	0	0	4	0	0	0	4	0	0	0	0	0	0	0	0	0	0	0	0	0	0	0	0	0	0	0	0	0	0	0	0	0	0	0	0	0	0	0	0	0	0	0	0	0	4	0	0	0	0	0	0	0	0	0	0	0	0	0	0	0	2	0	0	0	0	0	0	4	4	0	0	0	0	0	0	4	0	0	0	0	0	0	0	0	0	0	0	0	4	0	4	0	0	0	0	0	0	20	0	0	0	0	0	0	0	4	0	0	0	0	4	0	0	0	0	0	0	0	0	0	0	0	0	0	0	0	0	0	0	0	0	0	4	0	0	2	0	0	2	4	0	8	0	0	0	0	2	2	0	0	0	0	0	12	0	4	0	0	0	22	0	0	0	0	0	0	8	0	0	0	0	0	0	0	0	0	0	0	0	0	0	0	0	0	0	0	0	0	0	0	0	0	0	2	0	0	4	0	4	2	0	0	0	0	0	0	8	2	0	0	0	0	0	0	0	0	0	0	0	0	0	0	0	0	0	0	0	0	0	0	0	0	0	2	0	0	0	0	0	0	0	0	0	0	0	0	0	4	0	0	0	0	0	0	0	0	0	0	0	0	0	0	0	0	0	0	0	0	0	0	0	0	0	0	0	0	0	0	0	0	0	0	8	0	0	0	0	4	0	0	4	4	4	0	0	0	0	8	0	0	6	6	0	0	0	4	4	0	0	0	0	0	0	8	0	4	4	0	6	2	4	0	0	0	0	0	0	0	0	10	0	4	0	0	0	0	0	0	0	4	4	0	0	0	0	4	0	4	2	0	0	0	0	0	0	0	0	0	0	4	6	0	0	0	0	0	0	0	0	0	0	0	0	0	0	0	0	0	0	0	0	0	0	0	0	0	0	0	0	0	0	0	0	0	0	4	0	0	0	0	0	0	0	0	0	0	0	0	0	0	0	0	0	0	0	0	0	0	0	0	0	0	0	0	0	0	0	0	0	0	0	0	0	0	0	4	0	0	0	0	0	0	0	0	0	0	0	0	0	0	0	0	0	4	0	0	0	2	8	0	0	4	0	0	0	0	0	4	0	0	0	0	8	0	0	0	0	0	0	0	0	0	0	0	0	0	0	0	4	0	0	0	0	0	0	0	0	0	0	0	0	0	4	0	0	0	0	0	0	0	0	0	0	0	0	0	0	0	0	0	0	4	0	0	0	0	0	0	0	0	0	0	24	0	0	0	0	0	0	0	0	0	0	0	4	0	2	0	0	0	0	0	0	0	0	0	0	0	0	0	0	0	0	0	4	0	0	0	0	0	0	0	0	0	0	0	0	0	0	0	0	0	0	0	0	0	0	0	0	0	0	0	0	0	0	0	0	0	0	0	0	0	0	0	0	0	0	0	0	0	0	0	0	0	0	0	0	0	0	0	2	0	0	0	0	0	0	0	0	0	0	0	0	0	0	0	0	0	0	0	0	0	0	0	0	0	0	0	0	0	0	0	0	0	0	0	0	0	0	0	0	0	2	0	0	0	0	0	0	0	0	0	0	0	0	0	0	0	0	0	0	0	0	0	0	0	0	0	0	0	0	0	0	0	0	0	0	0	0	0	0	0	0	0	0	0	0	0	0	2	0	0	0	0	0	0	4	0	0	0	0	0	0	0	0	4	0	0	0	0	0	0	8	0	0	0	0	0	0	0	0	0	0	0	0	0	0	0	0	0	0	0	0	0	0	0	0	0	0	4	0	0	0	0	0	0	0	0	0	0	0	0	0	4	4	0	0	0	0	0	0	0	0	0	0	0	0	0	0	0	4	0	0	0	0	0	0	2	0	0	0	0	0	0	0	0	0	0	0	0	0	0	0	0	0	0	0	0	0	0	0	0	0	0	0	0	0	0	0	0	0	0	0	0	0	0	0	6	0	4	0	0	0	0	0	0	0	0	0	0	0	0	0	0	0	0	0	0	0	0	0	0	2	0	0	0	0	0	0	0	6	6	6	0	6	0	0	0	0	0	0	0	0	0	0	0	0	14	0	0	0	4	0	4	0	0	0	0	4	0	0	0	4	0	0	0	0	0	0	0	0	0	0	0	0	0	0	0	0	0	0	0	0	0	0	0	0	0	0	2	0	0	0	0	0	0	4	0	0	0	0	0	0	0	0	0	0	0	0	0	0	2	0	0	0	0	0	0	0	0	0	0	4	0	0	0	0	0	0	0	0	0	0	0	0	0	0	0	0	0	0	0	0	0	0	0	10	0	0	0	0	0	0	0	0	0	8	0	0	0	0	0	0	0	0	0	0	0	6	0	0	0	0	0	0	0	0	0	0	0	0	0	0	0	0	4	0	0	0	0	0	0	0	0	0	0	0	0	0	0	0	0	0	0	0	0	0	0	0	0	2	0	0	0	0	0	0	0	8	0	0	0	0	0	0	4	0	0	0	0	12	8	0	8	0	0	0	0	0	0	4	0	0	0	0	0	0	0	0	0	0	0	0	0	0	0	0	0	4	0	0	0	0	0	0	0	0	0	0	0	0	0	0	0	0	0	0	4	0	0	0	0	0	0	0	0	0	0	0	4	0	0	0	0	0	0	4	0	2	0	0	0	0	0	0	0	0	0	0	0	0	0	0	0	0	0	0	0	0	0	0	0	0	0	0	0	4	0	0	0	0	0	0	0	0	0	0	0	0	0	0	0	0	0	0	0	0	0	0	0	0	4	0	0	0	0	0	4	0	0	0	0	0	0	0	0	0	0	0	0	0	0	0	0	0	0	0	0	0	0	0	0	0	0	0	0	0	0	4	0	0	0	0	0	0	0	0	0	0	0	0	0	0	0	0	0	0	0	0	0	0	0	0	0	0	0	0	0	0	0	0	0	0	0	0	0	0	0	0	0	0	0	0	0	0	0	0	0	0	0	0	0	0	0	0	0	0	4	0	0	4	0	0	0	0	0	0	0	0	0	0	0	0	0	0	0	0	0	0	0	0	2	0	0	0	0	0	0	0	0	0	0	0	0	0	0	20	0	0	0	0	0	0	0	0	0	0	0	0	0	0	0	0	0	0	0	0	0	0	0	0	0	0	0	0	0	0	0	0	0	6	6	0	0	0	0	0	0	0	0	0	0	0	0	0	0	0	0	0	0	0	0	0	0	0	0	0	0	0	0	0	0	0	4	0	0	4	0	0	0	0	0	0	0	0	0	0	0	0	0	0	0	0	0	0	0	0	0	0	0	0	0	0	0	0	0	0	0	4	0	0	0	0	0	0	0	0	0	0	0	0	0	0	0	0	0	0	0	0	0	0	0	0	0	0	0	0	0	0	0	0	10	0	0	0	0	0	4	2	0	0	0	0	0	0	0	0	0	0	0	0	0	0	0	0	0	0	0	0	0	0	0	0	0	0	0	0	0	0	0	0	0	0	0	0	0	0	0	0	0	0	0	0	0	0	0	0	0	0	0	0	4	0	0	0	0	8	0	4	0	0	0	0	0	0	0	0	0	0	0	0	0	4	0	0	0	0	0	0	4	0	0	0	0	0	0	0	0	0	0	0	0	2	0	0	0	0	0	0	0	0	0	0	0	0	0	0	0	0	0	0	0	0	0	0	0	0	0	0	0	0	0	0	0	0	0	0	0	0	0	0	4	0	0	0	0	0	0	0	0	0	0	0	0	0	0	0	0	0	0	0	0	0	0	0	0	0	0	0	0	0	0	0	0	0	4	0	0	0	0	0	0	0	0	0	0	0	0	0	6	0	0	0	0	0	0	0	0	0	0	0	0	0	0	0	0	0	0	0	0	0	0	0	0	0	0	0	0	4	0	0	0	0	0	0	0	0	0	0	0	0	4	0	0	0	0	0	0	0	0	0	0	0	0	0	0	0	0	0	0	0	0	0	0	0	0	6	0	0	0	0	0	0	0	0	0	0	0	0	0	0	0	0	0	0	0	0	0	0	0	0	0	0	0	0	0	0	0	0	0	0	0	0	0	0	0	0	0	0	0	0	0	0	0	0	0	0	0	0	0	0	5	0	0	0	8	0	0	0	0	0	0	0	0	0	0	0	0	0	2	0	0	0	0	0	0	0	0	0	0	0	0	0	0	0	0	0	0	0	4	0	0	0	4	12	0	0	0	0	0	0	0	12	0	0	0	0	0	0	8	0	0	0	0	0	0	0	0	0	0	0	0	8	0	0	0	0	0	0	6	0	0	0	0	0	0	0	0	0	4	0	0	0	0	0	0	0	0	0	0	0	0	0	0	0	4	0	2	0	0	0	0	0	0	0	0	0	0	0	0	0	0	0	0	0	0	0	0	0	0	0	0	0	0	0	0	0	0	0	0	0	0	0	0	0	0	0	0	0	0	0	0	0	0	0	0	0	0	4	0	0	0	0	0	0	0	0	4	4	0	0	0	0	0	0	0	0	0	0	0	4	0	0	0	0	0	4	0	0	0	0	0	0	0	0	0	0	0	0	0	0	0	0	0	0	0	0	0	0	0	0	0	0	0	0	0	0	0	3	0	0	0	0	0	0	0	0	0	0	0	0	0	0	0	0	0	0	0	4	0	0	0	0	0	0	0	0	0	0	0	0	0	0	4	0	0	0	4	0	0	0	0	0	0	0	0	0	0	3	0	0	0	6	0	0	0	0	0	0	0	0	0	0	0	0	0	0	0	10	0	0	0	4	0	0	0	0	0	0	0	0	0	0	0	0	0	0	0	0	0	0	0	2	0	0	0	0	0	0	0	0	0	0	0	0	0	0	0	0	0	0	0	4	0	0	0	0	0	0	0	2	0	0	0	0	0	0	0	0	0	0	0	0	0	0	0	0	0	0	0	0	0	0	0	0	0	0	0	0	0	0	0	0	0	0	0	0	0	0	0	0	0	0	0	2	4	4	0	0	4	0	0	0	4	0	6	0	0	0	4	4	0	0	0	0	2	0	0	0	0	0	0	0	0	0	0	0	0	0	0	0	0	0	4	0	0	0	0	0	4	0	0	0	0	0	0	0	0	0	0	0	0	0	0	0	0	0	0	0	0	0	0	0	0	0	0	0	0	0	0	0	0	0	0	0	0	0	0	0	0	0	0	0	0	0	0	0	0	0	0	0	0	0	0	0	0	8	0	0	4	8	0	0	4	0	3	0	0	8	2	0	4	0	58	4	0	0	0	0	0	0	0	0	0	8	4	0	0	0	0	24	0	2	0	0	0	0	8	0	0	0	4	4	0	0	12	0	0	0	0	0	0	0	0	0	0	0	0	0	0	0	0	0	0	0	0	0	0	0	0	0	0	0	0	0	0	0	0	0	0	0	0	0	0	0	0	0	0	0	0	0	0	0	0	2	0	0	0	0	0	0	0	0	0	0	0	0	0	0	0	0	0	0	0	0	0	0	0	0	0	0	0	2	0	0	0	0	0	0	4	0	0	0	0	0	0	0	0	0	0	0	0	0	0	8	0	3	4	0	0	0	0	0	0	0	0	0	0	0	4	0	0	0	4	0	0	0	0	0	4	0	0	0	0	0	26	2	0	6	0	0	0	0	0	4	0	0	0	0	0	0	0	4	0	0	0	0	0	0	0	0	0	0	0	0	0	0	0	0	0	0	0	0	0	0	0	0	0	0	0	0	6	0	0	0	0	0	0	0	0	0	0	0	0	0	0	0	0	0	0	0	0	0	0	0	0	4	0	0	0	0	0	0	0	0	0	0	0	0	0	0	0	0	0	0	0	0	0	0	0	0	2	14	6	0	0	0	11	11	0	4	0	0	0	0	0	0	0	0	0	0	0	2	6	0	0	2	0	0	0	0	8	8	0	0	0	0	0	0	2	0	0	0	0	0	0	0	0	0	0	0	0	0	0	0	0	0	0	0	121	0	8	0	0	0	2	0	0	0	0	0	12	0	3	0	0	0	0	0	0	0	2	0	0	0	0	0	2	0	4	0	0	4	0	0	0	0	0	0	0	0	8	0	0	0	0	0	0	0	0	0	0	0	0	0	0	0	0	0	0	0	0	0	0	0	4	8	4	0	0	0	0	0	0	0	0	4	0	0	0	0	0	0	0	4	0	0	0	0	0	0	0	0	0	4	0	0	0	0	4	8	0	0	0	0	0	0	0	0	0	0	0	0	0	0	0	0	0	4	0	0	0	0	0	0	0	0	0	4	0	0	0	4	0	0	0	0	0	0	0	0	0	0	0	0	0	0	0	0	0	0	0	0	0	0	0	0	0	0	0	0	0	0	0	0	0	0	0	0	0	0	0	0	0	0	0	0	0	0	0	0	0	0	0	0	0	0	0	0	0	0	0	0	0	0	0	0	0	0	0	0	0	0	0	0	0	0	0	0	0	0	0	0	0	0	0	0	0	0	0	0	0	0	3	0	0	0	0	0	0	0	0	0	0	0	0	0	0	0	0	0	0	0	0	0	0	0	0	0	0	0	0	0	0	0	0	0	0	0	0	0	0	0	0	0	4	0	0	0	0	0	0	0	0	0	0	0	0	0	0	0	0	0	0	0	0	0	0	0	0	0	0	0	0	0	0	0	0	0	0	0	0	0	0	0	0	0	0	0	0	0	0	0	0	0	0	0	0	0	0	0	0	0	0	0	0	0	0	0	0	0	0	0	0	0	0	0	0	2	0	0	0	0	0	0	0	0	0	0	0	0	0	0	0	0	0	0	0	2	0	0	0	0	0	0	0	0	0	0	0	0	0	0	0	0	0	0	0	0	0	0	0	0	0	0	0	0	0	0	0	0	0	0	0	0	0	0	0	0	0	0	0	0	0	0	0	6	0	0	0	0	0	0	0	0	2	2	0	0	0	0	0	0	0	0	0	0	0	0	0	0	0	0	0	0	0	0	4	0	0	0	0	0	0	0	0	0	0	0	0	0	0	0	0	0	0	0	0	0	0	0	0	0	0	0	0	0	0	0	0	0	0	0	0	0	0	0	0	0	0	0	0	0	0	0	0	0	0	0	0	0	0	0	0	0	0	0	0	0	0	0	4	0	0	0	0	0	0	0	0	0	0	0	0	0	0	0	0	0	0	0	0	0	0	0	4	0	0	0	0	0	0	0	0	0	0	0	0	0	0	0	0	0	0	0	0	0	0	0	0	0	0	0	0	0	0	0	0	0	0	0	0	0	2	4	0	0	0	0	0	0	0	0	0	0	0	4	0	0	0	0	0	4	0	0	0	0	0	0	0	0	0	0	0	0	0	0	0	0	0	0	0	0	0	0	0	0	0	0	0	0	0	0	0	0	0	0	0	0	0	0	0	0	0	0	0	0	0	0	0	0	0	0	0	0	0	0	0	0	0	0	0	0	0	0	0	0	0	0	0	0	0	0	0	0	0	0	0	0	4	0	0	0	0	0	0	0	0	0	0	0	0	4	0	0	0	0	0	0	0	0	0	0	0	0	0	0	0	0	0	0	0	0	0	0	0	0	0	6	0	0	0	0	0	0	0	0	4	0	0	0	0	0	0	0	0	0	0	0	0	0	0	0	0	0	0	0	0	0	0	0	0	0	0	0	0	0	0	0	0	0	0	0	0	0	0	0	0	0	0	0	0	0	0	0	0	4	0	0	0	0	0	0	0	0	0	0	0	0	0	0	0	0	0	0	0	0	0	0	0	0	0	0	4	0	4	0	0	0	0	0	4	0	0	0	0	0	0	0	0	0	0	0	0	0	8	0	0	0	0	0	0	4	0	0	0	0	0	0	0	0	0	0	0	0	0	0	0	0	0	0	0	0	0	0	0	0	0	4	0	0	0	0	0	0	0	0	0	0	2	6	0	0	0	0	0	0	0	0	2	0	0	0	0	0	0	0	0	4	0	0	0	0	0	0	0	0	0	0	0	0	0	0	0	4	0	0	0	0	0	0	0	0	0	0	0	0	0	0	0	0	0	0	0	0	0	0	0	0	0	8	0	2	0	0	0	0	0	0	0	0	0	0	0	0	0	2	0	4	0	0	4	0	0	0	0	0	0	0	0	0	0	0	0	0	0	0	4	0	0	0	0	0	0	0	0	0	0	0	0	0	0	0	0	0	0	0	0	0	0	0	0	0	0	0	0	0	0	0	0	0	0	0	0	0	0	0	0	0	0	0	0	0	0	0	0	0	0	4	0	0	0	0	0	0	0	0	0	0	0	0	0	0	0	0	0	0	0	0	0	0	0	0	0	0	0	4	0	0	0	0	0	0	0	0	0	0	0	0	0	0	0	0	0	0	0	0	0	0	0	0	0	0	0	0	0	0	0	0	0	0	6	0	0	0	0	0	0	0	2	0	0	0	0	0	0	0	0	0	4	0	4	4	0	0	8	0	0	8	0	0	0	0	0	0	0	0	0	0	0	0	0	2	4	0	0	0	0	0	0	0	0	0	0	0	0	0	0	0	4	0	0	0	0	0	0	4	0	0	0	0	0	0	0	0	0	0	0	0	0	0	0	0	0	0	0	1	0	3	0	2	0	0	0	0	8	0	0	0	0	0	0	0	0	0	0	0	0	0	0	0	0	0	0	0	0	0	0	0	0	0	0	0	0	0	0	0	0	0	0	0	0	0	0	0	0	0	0	0	0	0	0	0	0	0	0	0	0	0	0	0	0	0	0	0	0	0	0	2	0	0	0	0	0	0	0	0	0	0	0	0	0	0	0	0	0	0	0	0	0	0	0	0	0	0	0	0	0	0	0	0	0	0	0	0	0	0	0	0	0	0	0	0	0	0	0	0	0	0	0	0	0	0	0	0	0	0	0	0	0	0	0	0	4	0	0	0	0	0	0	0	0	0	0	0	0	0	0	0	0	0	0	0	0	0	0	0	0	0	0	0	0	0	0	0	0	0	0	0	0	0	0	0	0	0	0	0	0	0	0	0	0	0	0	0	0	0	0	0	0	0	0	0	0	0	0	0	0	0	0	0	0	0	0	0	0	0	0	0	0	0	0	0	0	0	0	0	0	0	0	0	0	0	0	0	0	0	0	0	0	0	0	0	0	0	0	0	0	1	0	0	0	0	0	2	0	0	0	0	0	0	0	0	0	0	0	0	0	0	0	0	0	0	0	0	0	0	0	0	0	0	0	0	0	0	0	0	0	0	0	0	0	0	0	0	0	0	0	0	0	0	0	0	0	0	0	0	0	0	0	0	0	0	0	0	0	0	0	0	0	0	0	0	0	0	0	0	0	0	0	0	0	0	0	0	0	0	0	0	0	0	0	0	0	0	0	0	0	0	0	0	0	0	0	2	0	0	0	0	0	0	0	0	0	0	0	0	0	0	0	0	0	0	0	0	0	0	0	0	0	0	4	0	0	0	0	0	0	0	0	4	0	0	0	0	0	0	0	0	0	0	0	0	0	8	0	0	0	0	0	0	0	0	0	0	0	0	0	0	0	0	0	0	0	0	0	4	0	0	0	0	0	0	0	0	0	0	0	0	0	0	0	0	0	0	0	0	0	0	0	0	0	0	0	0	0	0	0	0	0	0	0	0	0	0	0	0	0	0	0	0	0	0	0	0	0	4	0	0	0	0	0	0	0	0	0	0	4	0	0	0	0	0	0	0	0	0	0	0	0	0	0	0	0	0	0	0	8	0	0	0	0	0	0	0	0	0	0	0	0	0	4	0	0	0	0	0	0	0	0	0	0	0	0	0	0	0	0	0	0	0	0	0	0	0	0	8	0	0	0	0	0	0	0	0	0	0	0	4	2	0	0	0	0	0	0	0	0	0	0	0	0	0	0	0	0	0	0	0	0	0	0	0	0	0	0	0	0	0	0	0	0	0	0	0	0	0	0	0	0	0	0	0	4	0	0	0	0	0	0	0	0	0	2	0	0	0	0	0	0	0	0	4	0	0	0	0	0	0	0	0	0	0	0	4	0	0	0	0	0	0	0	0	0	0	0	0	0	0	0	0	0	0	0	0	0	0	0	0	0	0	0	0	0	0	0	0	0	0	0	0	0	0	0	0	4	0	0	0	0	0	0	0	0	0	0	0	0	0	0	0	0	8	0	0	0	0	0	0	0	0	0	0	0	0	0	0	0	0	0	0	0	0	0	0	0	0	0	0	0	0	0	0	0	0	0	0	0	0	0	0	0	0	0	0	0	0	0	0	0	0	0	0	0	0	0	0	0	4	5	0	0	0	0	0	0	0	0	0	0	0	0	0	0	0	0	0	0	0	0	0	0	4	0	0	0	0	0	3	0	0	0	0	0	3	0	4	0	4	0	4	0	0	0	0	0	0	0	0	0	6	0	0	0	0	0	0	0	0	0	0	0	0	0	0	0	2	0	0	0	0	0	0	0	0	4	0	0	0	0	0	0	0	0	0	0	0	0	0	0	0	0	6	0	0	0	0	0	0	0	0	0	0	0	0	0	0	0	0	0	0	0	0	0	0	0	0	0	0	0	4	0	0	0	0	0	0	0	0	0	4	0	0	0	0	0	0	0	0	0	0	0	0	0	0	0	0	8	0	0	4	0	0	2	0	10	0	0	0	0	0	0	0	0	0	2	0	0	0	0	0	0	0	0	0	0	4	0	0	0	0	0	0	0	0	0	0	0	0	0	0	0	0	0	0	0	0	0	0	0	0	0	0	3	0	0	0	0	0	0	0	0	0	0	0	0	0	0	12	0	0	0	4	0	0	0	4	0	0	0	0	0	0	0	0	4	0	0	0	0	0	0	0	0	0	0	0	0	0	0	0	0	0	0	0	0	0	4	0	0	0	0	0	0	0	0	0	0	0	0	0	0	0	0	0	0	4	0	0	0	0	0	0	0	0	0	0	0	0	0	0	0	0	0	0	0	0	0	0	0	0	0	1	0	1	4	0	0	0	0	2	0	0	0	0	0	0	0	0	0	0	0	4	4	6	0	0	0	0	0	0	0	0	0	0	0	0	0	0	0	0	0	0	0	0	0	0	0	0	0	0	9	4	0	0	0	4	0	0	40	0	0	0	0	0	0	0	0	0	0	0	0	0	0	0	0	0	0	0	0	0	0	4	0	0	0	0	8	0	0	0	0	0	0	0	0	0	0	0	0	21	0	0	0	0	0	0	0	0	0	0	0	2	0	0	0	0	0	8	0	0	0	0	0	0	0	0	0	0	0	0	0	0	0	0	0	0	4	0	0	0	0	0	8	0	0	0	0	0	0	0	2	0	16	0	0	0	0	0	0	0	0	0	0	0	0	0	0	0	0	0	0	0	4	0	0	4	2	0	4	0	0	4	0	0	0	12	0	0	0	0	0	0	4	0	0	0	0	0	0	4	0	0	6	0	2	0	0	0	0	0	0	0	0	0	0	0	0	0	0	0	0	0	0	0	0	0	0	4	0	0	6	0	0	0	0	0	0	0	0	0	0	0	0	0	0	0	0	0	0	6	0	3	0	0	0	0	0	4	0	0	0	0	0	0	0	0	0	0	0	0	0	0	0	4	0	0	0	0	0	0	0	0	0	0	0	4	0	0	0	0	0	0	0	0	2	0	0	0	0	0	0	0	0	0	0	0	0	0	18	0	0	0	0	2	0	0	0	0	4	0	0	0	0	0	0	0	0	0	0	0	0	0	0	0	0	0	0	0	0	0	0	0	0	0	0	0	0	0	0	0	0	0	0	0	0	0	0	0	0	0	0	0	0	4	0	0	0	0	0	0	0	0	4	0	0	0	0	0	0	0	0	0	0	0	0	0	0	0	0	0	0	0	0	0	0	0	0	0	0	2	0	0	4	0	0	10	0	0	0	0	0	0	0	0	0	0	4	0	0	0	0	0	0	0	0	0	0	0	0	0	0	0	0	0	0	0	0	0	0	0	0	0	0	0	0	0	0	0	0	0	0	0	0	0	0	0	0	0	0	0	0	0	0	0	0	0	0	0	0	0	0	0	0	0	0	0	0	0	0	0	0	0	0	0	0	0	0	0	0	0	0	0	0	0	0	0	0	0	0	0	0	0	0	0	0	0	0	0	0	0	0	0	0	0	0	0	0	0	0	0	0	0	0	0	0	0	0	0	0	0	0	0	0	0	0	0	0	0	0	0	0	0	0	0	0	0	0	0	0	0	0	0	0	4	0	0	0	0	0	0	0	0	0	0	0	0	0	0	0	0	0	0	0	0	0	0	0	0	0	0	0	0	0	0	0	0	0	0	0	0	0	0	0	0	0	0	0	0	0	0	0	0	0	6	0	0	0	0	0	0	0	0	0	0	0	0	0	0	0	0	0	0	0	0	0	0	0	0	0	0	0	0	0	0	0	0	0	0	0	0	0	0	0	0	0	0	0	0	0	4	0	0	0	0	0	0	0	0	4	0	0	0	0	0	0	0	0	0	0	0	0	0	0	0	0	0	0	0	0	0	0	0	0	0	0	0	0	0	0	0	0	0	0	0	0	0	0	0	0	0	0	0	0	0	0	0	0	10	0	0	0	0	0	0	1	1	0	0	0	0	0	0	0	13	0	0	0	0	0	0	0	4	0	0	0	0	0	0	12	0	0	0	0	0	0	0	0	0	2	0	0	0	0	0	0	4	6	0	0	0	0	0	0	0	0	0	0	0	0	0	4	0	0	0	0	0	0	0	4	0	0	0	0	0	0	0	0	0	0	0	0	0	0	0	0	0	0	0	0	0	0	0	0	0	2	0	0	0	0	0	0	0	0	0	0	0	0	0	0	0	0	0	0	0	0	0	0	0	0	0	0	0	0	0	0	0	0	0	0	0	0	0	0	0	0	0	0	0	0	0	0	0	0	0	0	0	0	0	0	0	0	0	0	0	0	0	0	0	0	0	0	0	0	0	0	0	0	0	0	0	0	0	0	0	0	0	0	0	0	0	0	0	0	0	0	0	0
PHYLLO21	61402	0	1	0	272	867	101	0	207	5	7	59	39	0	120	4	0	15	0	9	12	1	2	2	32	7	0	28	15	27	7	0	11	11	12	37	32	0	2	0	0	0	0	0	13	0	0	0	0	22	26	0	59	169	202	12	501	15	23	2	78	0	6	10	43	163	0	17	6	0	17	5	0	0	4	2	18	0	3	2	0	0	211	212	88	101	0	65	0	26	4	131	53	88	58	21	51	13	145	13	0	271	1	123	4	94	140	5	18	27	2	0	19	25	2	42	18	32	0	2	66	23	52	10	14	215	41	111	19	9	5	8	0	6	13	15	1	202	27	19	17	79	104	6	10	50	11	1	13	31	6	1	3	11	0	1	2	1	48	54	56	0	10	109	1	70	83	76	21	22	11	11	18	6	12	10	0	8	12	3	20	20	35	16	11	16	29	0	0	4	9	21	7	0	1	20	8	107	2	1	4	6	3	25	10	39	0	37	0	2	78	8	19	0	342	502	2	38	1	23	11	17	41	20	175	11	95	45	55	16	77	10	12	28	0	0	17	0	56	4	30	8	79	16	8	10	1	7	39	13	1	0	98	0	80	0	18	6	98	1	4	5	1	0	6	4	25	29	32	6	24	5	35	1	17	5	1	45	0	31	78	13	33	16	174	119	13	6	26	4	43	0	0	2	36	7	82	0	1	10	7	22	137	25	0	0	0	68	43	56	117	9	26	1	3	12	0	97	2	43	0	44	14	6	9	3	8	4	9	7	3	44	1	1	0	0	2	3	0	4	65	22	8	92	133	20	3	3	23	23	13	1	29	17	85	0	29	18	9	14	21	35	6	13	0	0	23	39	17	44	0	31	23	21	15	16	66	21	5	88	34	46	12	22	4	9	123	103	18	14	293	1	1	1	52	3	17	25	437	1	25	8	92	0	379	85	0	0	10	28	105	60	1	0	0	1	7	1	2	33	128	33	2	0	69	6	45	63	187	4	3	12	1	0	4	37	124	8	7	15	158	1	23	11	30	118	39	17	61	2	15	80	78	30	127	38	13	474	39	26	25	9	21	5	32	28	18	0	8	6	7	9	11	1	9	2	2	11	15	2	78	6	5	11	9	0	0	0	2	11	0	7	8	0	16	0	1	3	0	3	1	6	0	6	0	0	8	6	0	20	4	6	0	1	75	175	266	15	89	19	19	243	11	73	62	1	95	0	42	17	0	5	9	0	40	43	50	10	55	81	6	60	6	20	41	141	55	8	0	7	0	23	6	5	27	14	7	27	68	51	13	19	0	75	23	3	0	0	0	29	9	16	0	64	33	4	98	11	3	17	0	9	23	12	30	3	23	26	17	28	7	11	8	11	0	6	8	5	0	2	0	2	26	71	1	15	3	8	1	2	7	1	66	1	5	13	18	1	69	0	7	0	0	0	2	1	3	5	0	14	0	1	13	0	9	45	8	0	0	17	0	16	41	0	57	4	1	1	4	0	11	24	277	17	19	0	6	12	1	17	57	12	3	0	5	9	56	3	52	3	42	1	11	32	100	11	26	61	36	2	34	58	24	58	25	14	0	6	49	25	5	11	89	0	2	3	2	0	16	0	0	12	25	1	0	0	21	5	14	13	0	54	28	24	24	44	59	17	50	252	20	9	1	84	12	0	3	6	0	40	40	4	1	3	0	16	17	3	7	1	2	21	8	7	8	0	9	10	3	2	27	49	29	14	13	64	0	8	36	0	19	31	4	39	22	15	11	49	11	11	0	13	5	28	18	15	1	8	17	0	62	18	0	1	1	0	4	0	0	0	0	1	1	26	41	0	6	0	1	3	16	22	28	22	9	3	1	0	1	5	3	2	36	14	23	5	25	0	45	10	0	2	32	33	11	10	0	1	0	0	2	0	5	3	0	1	4	1	0	1	29	7	12	26	0	2	16	4	16	6	9	6	5	3	0	0	21	17	0	11	13	9	7	4	0	0	1	14	2	8	6	1	28	13	7	9	9	0	0	6	7	2	2	1	13	53	7	11	12	2	7	1	24	2	17	6	1	0	2	14	8	3	1	1	0	4	0	1	0	11	6	5	10	81	12	8	14	0	119	1	5	0	0	9	17	24	0	0	4	0	0	0	0	6	3	15	0	10	12	10	6	2	7	1	4	1	0	38	2	22	0	21	1	30	10	1	1	6	1	0	133	2	30	0	0	19	2	43	9	0	3	6	0	0	0	6	0	0	40	33	13	114	0	0	0	12	52	32	0	20	4	13	6	0	13	0	0	2	18	3	12	0	9	0	0	0	20	85	15	0	43	2	9	1	15	10	0	2	3	6	47	2	2	1	4	8	41	51	28	32	3	0	1	0	0	10	0	13	14	0	0	1	0	18	1	0	50	1	0	13	1	0	1	21	5	0	5	9	31	0	2	44	0	5	5	5	28	7	0	47	64	7	23	0	8	4	5	3	20	9	10	15	10	6	31	16	5	28	31	17	19	1	0	10	3	0	52	0	27	38	82	36	13	33	74	28	15	23	30	25	0	8	64	17	101	25	20	21	2	23	43	0	8	52	3	45	91	4	3	25	31	13	5	2	0	17	1	0	0	108	6	56	16	32	31	23	30	15	63	6	2	7	41	1	14	10	23	6	1	59	14	2	8	0	28	25	1	60	0	9	0	20	0	5	0	0	18	9	0	4	0	15	0	0	11	12	0	11	14	6	7	0	0	7	11	1	11	0	5	0	9	8	6	7	1	1	0	20	2	10	28	36	1	29	0	17	3	0	2	105	6	2	8	26	22	1	1	6	18	8	4	0	0	0	0	1	0	4	0	4	0	0	12	7	4	11	8	0	2	3	24	2	13	0	20	25	3	29	2	0	5	0	11	11	3	0	0	1	11	1	22	0	1	30	99	8	10	0	0	0	0	4	5	0	2	20	0	5	0	6	2	0	7	0	0	15	0	8	0	0	0	2	8	6	0	0	1	3	3	0	6	17	8	5	0	0	2	1	0	15	0	0	0	7	82	6	0	0	3	0	5	0	15	125	0	11	0	3	0	4	0	2	10	1	30	4	1	20	2	0	0	0	0	0	0	0	0	0	0	5	2	23	29	81	8	18	0	7	0	0	0	10	14	1	70	6	0	0	0	0	1	4	1	0	1	1	0	0	0	0	0	1	0	0	0	0	2	0	7	2	2	0	0	28	6	5	0	8	0	0	4	4	1	0	12	3	2	1	0	0	34	9	0	4	0	0	12	18	0	28	0	0	2	6	2	9	3	4	1	0	5	0	0	1	4	2	11	7	6	32	5	0	0	0	5	91	0	0	3	2	1	0	80	4	10	2	1	0	0	16	3	3	4	0	0	0	2	2	1	1	4	0	0	37	1	26	0	0	0	0	4	0	2	4	0	0	0	7	0	0	11	0	10	5	15	3	4	4	0	3	3	42	0	2	0	13	13	3	3	2	0	0	64	6	2	0	2	2	1	0	0	0	0	0	0	0	1	0	0	0	27	0	0	7	79	17	0	0	0	0	0	74	14	0	2	0	0	6	2	0	0	2	23	11	10	14	42	11	10	9	3	7	10	3	1	0	15	7	2	4	48	2	9	38	8	1	0	4	1	1	2	26	0	13	23	16	0	1	0	2	0	3	11	16	3	3	0	0	6	2	0	12	13	13	9	12	10	0	1	0	0	7	1	3	0	63	8	1	2	0	1	21	9	0	13	4	0	14	1	8	45	3	0	2	1	2	35	6	0	2	7	47	7	3	629	0	16	4	3	11	5	1	16	44	18	4	4	1	6	16	7	7	1	0	11	3	2	6	41	0	0	25	8	3	11	15	3	13	2	2	1	51	0	6	4	5	0	8	7	2	5	9	10	5	1	0	0	9	1	9	0	0	0	0	3	17	7	1	5	0	4	56	4	1	2	1	8	7	4	3	3	10	2	0	3	3	4	51	13	0	10	2	2	4	5	2	8	2	18	3	2	5	0	0	14	3	1	6	74	0	0	4	2	2	4	21	0	0	0	14	6	13	2	12	4	10	5	5	4	21	0	0	47	17	5	3	1	85	0	10	0	16	10	5	0	5	32	18	0	5	22	0	0	6	5	31	0	0	0	5	3	7	0	53	52	40	0	1	25	4	30	0	0	7	4	1	11	0	0	6	6	85	132	133	21	21	24	104	83	10	0	137	84	23	47	24	88	174	86	1	16	39	3	1	0	8	1	21	2	31	99	89	2	18	1	60	115	18	1	3	39	0	5	88	0	71	0	0	0	3	0	61	68	13	0	1	13	13	1	3	76	3	87	3	2	0	0	12	56	10	2	13	10	61	71	1	46	45	46	23	12	5	2	12	18	9	0	3	47	18	52	30	0	18	8	9	0	1	4	4	38	10	11	29	0	0	4	0	49	0	12	9	4	32	0	9	18	0	0	22	0	2	0	0	0	9	1	0	73	9	2	0	45	0	1	0	0	0	0	16	0	0	0	3	6	0	0	0	0	0	0	0	6	3	0	13	0	0	0	1	22	26	1	6	1	17	0	0	20	3	0	20	4	0	8	30	9	2	0	0	0	6	6	3	1	4	5	0	3	0	0	3	2	11	17	4	0	10	27	8	42	2	4	10	21	28	1	2	0	0	61	0	0	4	0	15	3	30	195	19	0	4	3	2	0	2	2	1	2	0	0	0	0	17	2	18	18	6	4	5	0	15	1	10	17	17	2	0	0	3	5	0	3	1	16	0	2	1	0	0	0	9	2	3	3	2	1	0	0	0	0	0	2	0	3	15	9	0	2	0	0	0	18	0	0	0	0	0	0	7	24	10	0	0	2	0	1	3	2	4	5	5	4	5	6	9	10	11	1	0	0	1	0	0	2	20	2	0	4	3	0	20	3	0	4	2	1	0	66	0	0	1	2	1	1	3	21	3	0	0	0	6	16	0	9	0	1	0	1	24	1	0	0	0	0	0	0	4	0	0	0	2	0	6	0	3	30	1	5	3	6	31	28	22	7	15	1	7	7	5	4	0	9	5	62	39	23	2	2	2	270	0	48	1	12	2	8	37	0	13	0	23	21	31	16	0	0	0	0	0	0	0	0	1	0	6	62	1	0	0	0	0	0	0	10	16	3	2	6	0	9	0	1	6	0	0	1	48	43	3	3	4	2	1	0	0	0	8	0	8	15	0	0	0	0	16	3	6	1	0	1	2	0	7	4	9	2	9	0	0	5	0	1	0	1	0	2	0	22	7	6	1	7	0	0	0	12	0	0	0	8	3	0	5	2	0	0	0	2	3	2	0	4	0	1	3	1	0	0	0	8	0	1	3	3	10	5	0	24	9	13	21	26	22	2	0	0	0	36	0	5	43	43	0	0	5	41	32	1	4	2	2	9	4	27	5	9	17	2	37	6	0	0	5	6	2	0	0	6	0	48	0	4	0	18	1	2	1	0	0	0	21	7	6	0	0	1	5	31	26	1	4	0	1	0	1	0	16	2	12	5	3	0	4	3	5	0	1	8	0	4	1	0	3	1	0	0	1	4	0	0	0	0	5	0	0	1	0	1	0	0	7	0	7	0	1	5	0	2	6	2	0	0	0	0	0	0	9	0	4	4	1	0	3	0	2	0	0	0	18	6	2	12	2	0	0	1	2	0	0	0	0	4	1	3	1	6	0	0	0	2	0	0	0	2	0	0	5	2	0	1	0	0	11	15	4	44	25	34	26	2	5	31	0	13	0	0	7	2	1	0	12	10	23	3	0	0	17	0	8	0	0	4	1	0	0	0	0	78	0	8	4	0	0	1	4	3	0	0	0	0	0	0	7	6	2	0	0	0	0	0	3	2	0	0	0	0	1	0	0	0	11	8	1	0	0	1	0	0	0	21	4	4	234	1	2	0	7	0	0	0	0	0	0	5	20	0	6	16	0	1	6	1	0	4	1	50	0	0	5	0	2	0	3	0	18	3	0	2	0	0	13	0	0	0	7	3	0	0	0	0	0	0	14	0	2	3	0	0	0	2	1	9	0	2	0	0	0	0	2	0	0	0	5	0	2	0	0	1	3	0	0	2	0	0	13	0	12	3	8	0	24	1	2	0	0	0	0	0	0	15	0	7	2	1	0	1	0	2	2	5	0	4	6	0	3	2	3	0	13	2	0	3	6	0	0	0	0	2	2	1	4	0	1	9	1	3	3	5	0	3	1	0	8	2	4	14	2	0	1	0	0	2	0	0	3	0	7	11	3	10	0	1	0	2	0	0	7	2	0	1	6	0	0	0	3	7	4	0	0	8	10	2	26	1	1	3	1	2	2	0	3	0	0	15	0	57	0	1	0	1	0	17	41	0	10	0	0	6	9	2	1	2	5	7	2	0	2	2	1	0	0	2	5	9	2	0	2	3	8	6	6	24	0	0	0	1	0	3	3	1	2	8	5	5	5	9	1	2	3	1	1	0	2	0	29	5	0	3	0	2	18	0	8	4	0	0	0	63	0	0	0	6	0	0	0	0	0	2	1	1	2	2	0	0	3	12	3	0	0	4	2	6	4	1	0	0	11	13	0	0	0	0	0	0	1	0	1	12	1	3	1	0	2	6	7	0	3	0	0	0	0	0	2	0	0	4	1	0	0	0	11	24	58	27	8	3	26	9	0	0	50	59	60	1	51	5	5	1	0	0	0	0	0	2	0	0	0	70	4	7	4	15	0	39	0	0	0	0	17	0	1	0	1	1	0	2	0	0	0	0	2	1	0	0	13	0	1	0	27	0	0	0	0	1	0	0	2	34	1	76	0	0	2	2	0	0	4	0	0	1	0	0	1	0	1	2	1	2	0	0	0	28	1	0	2	0	0	6	0	0	0	0	3	0	0	0	0	7	7	7	0	1	12	2	1	1	0	11	18	7	0	0	0	3	3	0	149	1	0	6	0	8	1	1	0	2	62	0	0	0	1	0	0	1	0	0	0	0	55	3	0	30	1	0	0	0	4	0	0	0	0	0	0	0	0	2	0	0	0	11	24	0	2	0	16	4	2	1	7	4	3	0	13	9	6	25	1	1	2	0	10	4	1	0	0	2	1	4	79	5	3	5	2	0	3	0	3	1	3	3	73	73	1	79	2	0	0	0	0	1	5	1	0	2	0	0	0	0	0	0	3	0	0	2	0	0	0	1	13	0	1	12	0	0	1	4	2	0	0	0	0	7	0	10	2	0	1	33	3	0	1	0	0	6	0	0	4	0	0	0	3	0	3	2	0	0	8	3	1	0	2	0	1	0	0	1	6	2	0	6	0	0	2	1	0	0	0	1	1	26	0	2	1	1	1	0	3	0	1	17	1	16	22	0	0	0	0	2	2	1	20	33	0	33	7	39	74	1	17	7	76	14	0	0	0	0	0	21	12	1	2	6	1	10	8	2	0	7	5	1	6	0	14	0	7	0	0	0	2	0	0	0	0	0	1	0	9	0	2	0	0	0	0	2	0	7	1	0	0	0	0	0	0	0	2	10	12	0	1	1	0	7	0	57	0	7	0	15	0	1	0	0	1	0	0	1	1	0	1	7	3	0	4	3	11	1	1	4	0	0	0	0	3	1	0	22	0	10	4	0	15	0	0	0	4	0	0	0	2	24	5	1	1	6	0	0	1	7	0	0	0	0	1	2	0	1	1	1	0	0	0	4	13	63	24	0	19	1	0	0	2	0	0	0	0	0	0	0	1	5	0	8	0	0	0	8	4	0	1	3	0	1	4	2	0	1	6	0	0	0	15	17	2	0	3	0	0	9	1	3	0	0	15	15	3	1	0	0	1	0	0	0	7	2	8	0	14	4	1	2	0	1	0	2	4	4	52	0	0	9	0	0	0	2	2	0	0	0	14	0	0	0	6	0	0	0	0	6	2	2	6	0	0	0	5	2	2	0	35	2	0	0	1	0	16	0	0	4	0	4	0	0	0	0	7	1	1	0	0	0	0	0	1	0	3	1	1	0	18	0	0	20	1	18	1	0	1	16	20	0	10	4	3	12	0	17	0	0	2	0	0	4	0	0	0	0	7	3	0	0	0	0	0	1	0	5	1	0	4	0	1	6	0	1	1	0	2	0	0	13	2	0	0	0	4	0	7	0	0	2	1	5	7	0	0	0	10	2	22	4	1	1	0	0	0	3	0	2	0	0	0	3	3	0	5	2	0	0	1	5	0	2	0	0	6	0	0	4	5	2	1	0	1	0	0	0	1	1	0	0	0	14	5	5	0	0	2	2	0	7	0	0	1	0	2	0	0	0	0	0	0	0	0	0	0	0	10	13	13	0	2	2	1	2	0	13	0	0	0	0	0	1	5	2	0	3	2	0	1	2	0	2	0	0	0	0	0	0	0	0	6	16	0	0	0	4	0	0	1	0	8	0	0	0	1	0	0	0	1	7	1	0	0	6	0	0	0	3	0	0	0	0	2	2	0	1	0	0	0	0	0	1	0	0	0	3	10	0	25	2	0	19	22	0	2	2	0	0	21	0	0	22	0	7	0	6	2	0	1	1	53	2	0	1	10	0	1	0	0	0	17	10	1	0	0	1	21	6	0	0	0	0	0	1	0	0	4	0	0	7	0	0	1	0	0	0	4	1	2	0	0	0	0	0	0	0	1	0	0	1	0	2	0	0	2	15	0	18	0	1	0	5	5	0	2	0	0	0	0	0	0	45	6	0	0	1	1	0	11	1	3	0	0	1	0	3	0	0	0	15	0	3	0	0	0	0	2	4	0	8	21	0	6	0	0	2	0	13	0	1	2	0	0	0	17	6	0	0	2	5	0	0	24	0	0	0	2	1	0	0	4	0	4	0	0	0	0	0	0	0	1	1	6	0	0	1	0	0	2	14	0	5	0	9	0	0	7	36	10	4	0	5	1	0	2	0	0	0	7	0	0	0	0	3	1	0	2	2	0	0	0	0	4	0	2	3	1	0	0	3	1	0	0	0	1	0	3	1	0	0	3	3	0	0	1	0	0	2	0	0	0	2	0	5	0	1	0	0	7	2	3	1	2	17	9	1	0	24	31	0	0	0	2	3	0	5	1	13	12	0	0	1	1	8	0	0	0	0	6	0	2	0	0	1	2	0	2	0	1	0	1	0	0	0	0	0	1	0	1	2	0	0	9	3	0	0	0	0	3	0	0	3	0	1	1	3	0	0	16	0	0	0	7	0	0	0	0	0	0	0	0	1	3	3	0	0	0	0	0	0	0	3	0	0	0	1	0	0	12	0	2	0	0	0	0	0	0	1	1	0	0	3	0	0	0	4	2	0	11	0	0	0	31	0	30	1	0	1	0	0	0	0	1	0	2	4	0	0	6	0	0	3	7	1	3	0	0	0	0	0	0	1	0	0	0	0	0	0	1	3	0	0	0	0	0	0	0	1	1	0	0	1	1	1	4	2	0	0	5	0	0	0	0	0	0	0	0	0	0	5	8	1	1	0	0	0	0	2	0	1	2	0	1	0	0	0	0	0	0	0	12	0	0	10	0	0	0	13	0	0	1	0	9	12	9	0	2	3	0	0	9	0	1	11	12	22	20	7	0	0	0	3	0	3	0	5	0	5	0	2	2	65	64	5	1	14	2	3	3	8	0	4	0	0	0	15	0	0	2	0	0	0	0	35	0	0	0	0	2	0	0	0	10	0	0	0	1	0	13	0	1	0	0	0	0	5	3	4	2	3	1	0	1	0	2	0	0	0	0	0	0	0	0	0	2	1	2	2	4	2	2	0	0	0	0	1	0	24	1	3	1	0	31	2	8	2	15	0	0	1	28	0	0	41	0	6	0	8	29	18	0	75	1	569	30	5	8	26	7	0	0	0	0	0	16	21	0	0	0	1	536	2	56	1	43	0	0	136	21	38	59	40	14	37	32	102	0	0	0	1	0	0	0	0	8	0	1	0	1	0	0	6	0	3	0	0	0	0	0	0	0	5	0	3	4	0	0	1	0	14	14	2	2	0	0	0	0	0	0	10	0	0	0	0	1	0	2	1	0	3	0	0	1	0	1	0	0	1	0	0	40	0	0	0	1	3	0	0	2	1	0	0	19	2	1	0	0	0	1	4	0	0	20	0	0	1	1	1	5	0	0	0	0	1	5	0	12	17	1	0	1	0	0	0	0	0	1	3	0	27	0	41	0	68	0	1	5	3	0	19	2	0	0	7	14	226	15	9	23	1	0	0	1	0	4	0	4	3	0	0	3	2	12	0	4	7	14	2	5	8	14	7	0	0	0	0	3	1	0	0	0	1	1	0	3	4	5	0	0	0	2	37	0	1	0	0	6	3	17	1	0	0	0	0	3	3	0	2	1	0	0	3	0	0	2	0	34	14	0	0	2	1	1	0	0	0	17	0	0	0	1	0	0	0	0	0	0	2	0	0	38	4	229	43	19	0	4	87	149	0	6	4	0	7	9	5	1	17	0	11	16	1	30	33	6	0	25	2	0	0	3	8	25	2	2	2	0	0	1	1	0	0	0	1	0	0	2	0	0	0	15	1	0	9	3	18	0	4	3	7	1	49	0	8	6	10	0	5	0	0	3	71	1	6	2	2	0	1	2	2	0	21	7	1	0	0	0	1	18	12	16	1	12	7	1	0	25	0	0	0	9	53	2	1	0	0	7	5	0	0	1	1	1	0	1	0	4	1	12	3	0	0	25	7	0	15	124	74	2	24	0	2	0	30	0	11	7	2	8	3	5	5	0	7	0	1	0	2	2	0	10	1	0	0	32	11	1	17	1	16	22	0	3	0	2	0	0	3	0	0	0	0	1	7	0	0	0	1	27	11	12	5	3	17	4	1	0	2	13	3	18	16	14	7	0	8	0	0	1	0	0	1	0	0	0	0	0	2	2	1	0	0	0	0	0	1	0	3	0	0	0	1	0	0	1	0	0	0	2	0	0	0	1	0	2	0	4	0	1	0	0	0	0	0	0	0	0	1	0	0	1	0	0	0	0	0	1	1	1	0	0	2	2	0	2	0	2	2	0	0	0	1	26	0	1	0	4	29	0	2	14	0	0	0	17	0	1	2	0	2	0	3	0	2	0	0	4	0	3	0	0	2	1	0	0	0	4	4	0	1	0	0	0	0	2	5	0	0	2	0	0	10	3	0	3	0	0	4	1	0	0	9	3	1	0	1	7	0	2	2	0	0	0	0	6	1	0	0	5	3	0	1	0	1	0	1	3	0	0	2	0	1	0	0	0	0	3	0	0	2	0	0	1	0	0	0	0	0	0	0	0	0	0	0	0	0	0	0	2	0	0	1	0	0	0	2	0	1	0	2	2	0	0	0	3	0	0	0	0	1	0	0	0	0	0	0	5	6	0	0	0	0	6	2	0	0	0	0	4	2	0	0	0	13	1	0	1	1	0	0	0	0	2	0	0	0	0	0	5	0	2	2	0	0	0	0	0	0	0	0	1	0	0	0	1	2	26	1	0	0	0	0	0	0	0	2	3	1	1	1	1	1	1	0	0	7	0	1	0	0	0	0	0	0	0	0	2	0	5	0	8	0	0	0	0	0	0	0	13	9	0	1	3	16	0	0	0	0	1	2	0	0	0	0	0	0	0	0	1	0	0	0	0	0	0	1	8	1	0	0	3	2	0	0	2	1	9	0	0	0	0	0	14	2	0	0	0	0	6	6	1	16	1	0	0	0	0	13	0	1	6	0	0	0	7	2	11	5	0	7	5	58	23	2	1	32	0	0	3	0	0	1	16	1	1	1	1	0	0	2	0	0	4	0	0	4	17	20	2	0	0	8	0	17	0	2	12	0	0	2	0	0	0	21	14	1	1	0	0	41	1	0	0	0	2	0	0	0	1	1	0	0	20	5	1	0	0	3	0	0	0	0	5	0	1	1	0	0	0	0	0	8	0	2	0	1	0	0	0	0	6	0	0	0	0	0	0	0	0	0	0	0	1	1	3	0	0	2	2	0	3	0	2	0	1	1	0	0	0	0	0	0	0	2	0	0	0	7	0	0	0	0	0	0	0	0	0	1	2	1	1	0	0	2	0	0	0	0	0	0	0	0	0	0	0	0	0	0	0	0	1	0	0	1	0	0	0	6	0	0	0	1	0	0	1	0	1	0	13	1	0	1	0	0	0	0	0	1	0	2	1	0	0	1	0	3	0	0	0	0	0	0	0	0	0	0	3	2	1	2	1	0	0	0	0	5	0	0	0	0	1	2	0	0	0	0	2	0	0	0	0	1	0	1	0	0	0	0	0	3	1	0	2	6	0	1	1	0	2	2	0	2	2	0	6	0	1	0	2	0	0	0	1	1	11	0	0	0	2	0	0	4	0	0	1	1	0	2	0	0	0	0	3	0	0	12	10	0	0	4	0	0	0	1	0	0	1	0	1	1	0	3	0	0	0	0	0	0	0	0	0	2	0	0	0	3	0	0	0	0	1	0	5	0	0	7	0	0	1	15	6	0	1	0	0	0	0	0	0	4	0	1	9	0	6	1	0	0	9	0	0	0	0	1	1	0	0	0	0	5	0	0	0	0	3	0	0	2	1	0	0	0	0	0	0	0	1	0	0	0	1	1	0	0	1	0	1	0	0	0	1	2	13	0	1	0	5	0	1	1	0	3	0	3	0	0	48	2	2	0	0	1	1	0	1	0	16	0	0	0	0	0	1	0	0	6	5	6	2	0	3	0	0	2	0	5	3	35	0	0	0	1	1	0	0	0	0	0	1	0	1	0	0	0	0	0	3	0	0	0	0	0	0	0	0	0	0	0	3	0	3	0	0	0	1	0	0	0	18	0	2	0	0	1	1	0	1	0	1	1	0	0	0	1	1	0	0	0	0	1	0	0	0	0	0	0	6	0	0	0	0	0	1	0	0	1	0	0	0	1	0	0	0	0	1	1	0	2	2	0	6	2	11	0	0	0	0	0	0	0	0	44	0	3	2	0	2	1	15	11	2	1	1	1	1	0	0	17	4	19	12	32	4	0	0	9	0	1	126	0	1	2	2	1	0	11	5	1	0	0	0	0	0	45	1	0	6	0	0	3	0	0	1	0	0	0	0	0	0	9	0	2	0	3	0	2	3	0	0	20	3	0	0	0	2	0	0	0	0	1	0	0	9	5	0	2	13	2	13	0	5	0	2	5	0	42	12	6	1	1	6	3	4	0	3	1	0	13	0	0	0	3	0	0	0	5	0	0	0	0	1	0	4	0	1	0	1	1	2	0	0	0	0	0	0	0	3	0	14	0	0	0	0	0	0	0	1	0	0	0	0	0	0	1	0	3	0	0	0	0	1	0	0	1	0	0	0	0	1	0	0	0	0	1	1	0	1	0	1	0	0	0	0	0	0	0	0	2	0	0	0	0	0	0	1	0	0	0	0	1	0	0	0	0	0	2	1	0	0	0	0	0	0	0	0	0	0	0	5	0	0	0	0	0	0	0	0	0	0	0	0	0	0	0	0	0	0	0	0	0	0	0	3	0	0	2	0	0	0	5	0	0	1	0	0	2	0	0	0	0	3	1	2	1	0	0	0	0	0	1	0	0	0	0	1	5	0	0	3	0	0	1	0	2	0	5	0	0	0	0	2	0	0	2	0	0	11	0	0	0	2	22	1	0	0	0	0	0	1	0	0	0	0	0	2	11	0	0	0	1	0	1	0	1	0	0	0	0	1	0	3	0	0	0	0	3	0	0	0	0	0	0	1	0	1	1	0	1	0	2	0	0	1	0	0	2	0	0	0	1	0	0	0	0	0	1	0	0	0	0	4	2	0	0	0	0	0	0	3	0	0	0	0	0	0	1	0	0	0	2	0	0	4	0	0	0	0	0	0	0	1	0	3	0	2	2	2	0	0	0	2	0	0	0	0	0	0	2	2	0	0	1	0	0	0	0	0	0	0	1	1	0	0	1	12	0	6	0	0	2	0	0	0	0	0	0	0	2	0	0	0	0	0	0	1	3	0	0	0	1	0	0	0	0	0	0	1	0	0	0	3	0	0	1	0	0	2	0	0	0	0	0	1	1	18	4	3	0	0	2	2	3	0	0	0	0	0	0	0	0	5	0	0	0	0	0	6	3	0	0	1	0	2	2	1	0	0	0	1	1	1	2	0	0	0	0	0	5	4	0	0	0	4	12	3	1	0	6	4	0	15	0	0	0	0	0	2	0	0	4	2	2	1	1	0	0	2	0	0	0	0	9	0	0	0	0	0	21	0	0	0	20	63	0	0	1	0	0	8	0	0	10	0	0	5	1	0	25	0	0	0	1	0	2	0	10	0	17	2	0	1	9	0	2	0	2	0	0	0	0	2	0	3	0	0	7	32	0	0	3	0	7	0	0	0	0	1	1	0	3	3	0	9	4	7	2	0	9	5	37	0	2	0	0	0	5	1	0	0	0	0	1	6	1	0	0	2	2	0	1	23	13	3	0	0	2	4	0	6	2	1	1	0	1	2	0	3	3	0	0	0	2	0	18	1	0	0	1	1	0	2	0	0	32	0	0	6	0	4	2	0	0	24	0	1	0	0	18	0	0	2	0	4	0	0	1	0	0	0	3	5	8	0	1	2	1	5	0	0	1	4	0	1	0	2	1	2	2	0	0	1	0	0	1	1	2	0	0	0	0	0	0	3	0	0	0	0	0	2	0	0	5	24	0	0	0	3	3	0	2	0	0	30	1	0	1	2	23	5	2	0	0	0	0	1	0	0	2	1	0	0	1	0	4	0	0	1	0	0	0	0	15	0	0	1	1	0	5	3	3	0	0	0	0	0	2	0	0	0	0	1	0	0	0	0	0	0	1	3	4	1	0	0	14	0	0	0	0	1	2	0	42	1	0	0	4	0	0	1	4	0	0	0	0	0	0	0	0	5	0	0	6	0	0	0	1	2	2	0	2	31	2	0	2	0	0	0	2	0	0	1	2	8	0	2	2	0	4	0	0	4	1	0	1	3	1	0	0	0	0	0	1	5	1	1	1	0	0	3	0	0	0	0	0	0	1	0	0	0	0	0	0	1	2	3	0	1	1	0	0	1	1	1	0	5	1	0	0	0	1	1	2	4	0	0	0	0	0	13	1	1	0	0	0	5	1	9	14	15	0	10	0	0	8	3	0	0	0	0	0	0	1	0	0	0	0	0	6	16	0	0	0	0	36	0	68	0	0	0	0	0	2	0	1	0	25	0	0	0	0	2	0	0	1	0	0	4	2	0	3	5	0	0	2	4	1	0	26	0	25	9	1	11	4	12	11	31	7	1	8	5	5	15	33	5	0	1	0	0	2	0	1	0	2	2	0	1	3	157	1	1	0	25	4	7	12	13	0	0	1	3	0	0	0	0	6	0	0	0	0	7	0	2	0	0	0	0	1	0	0	0	1	0	0	0	1	0	1	1	19	1	0	1	0	3	0	0	0	0	0	0	0	16	0	0	0	1	10	0	0	0	0	0	0	3	3	1	0	1	1	0	0	0	0	0	0	0	0	1	0	3	0	17	5	16	1	0	2	0	2	11	0	3	1	0	0	1	2	0	0	0	10	35	35	29	0	0	1	0	6	0	1	0	0	2	20	0	0	10	7	0	0	2	0	18	0	15	5	68	29	0	22	26	37	9	2	61	0	3	228	1	13	1	1	0	0	1	2	0	0	0	0	0	0	0	0	0	0	4	0	4	3	10	1	1	13	11	24	1	0	0	1	0	0	0	10	0	5	0	1	69	0	22	11	0	1	1	0	13	0	12	27	51	9	0	0	22	0	24	1	0	27	0	0	0	0	1	0	0	0	1	0	2	0	0	0	30	12	10	5	3	0	27	1	5	0	0	4	0	4	0	37	0	123	1	1	0	0	14	12	0	3	11	7	2	18	2	0	1	2	3	1	4	3	4	9	43	1	15	16	28	3	38	66	0	5	144	0	3	7	2	0	41	6	0	37	0	0	0	0	2	0	1	34	1	7	5	3	4	1	4	0	4	3	4	0	38	15	5	4	0	4	0	2	25	0	14	0	62	0	8	21	19	7	0	2	0	7	4	7	0	3	15	0	13	0	0	1	1	0	26	7	9	1	6	0	2	8	1	1	1	0	1	40	2	0	1	0	30	0	1	2	1	0	39	4	1	0	6	11	10	5	0	1	0	0	6	8	1	26	0	0	3	20	0	14	11	4	9	10	0	0	0	1	0	1	2	3	1	17	0	0	1	0	79	4	3	15	12	11	2	0	0	0	15	2	1	0	10	0	28	38	1	1	0	0	0	0	0	0	0	0	1	0	0	0	0	6	1	0	0	17	0	0	14	0	0	1	0	0	3	1	0	4	37	0	1	1	0	0	0	0	0	21	2	0	15	1	10	0	7	7	1	0	6	0	1	0	0	0	0	0	0	0	0	0	2	6	1	2	1	0	5	19	0	0	17	0	0	0	0	1	0	0	0	0	2	21	0	20	18	0	5	0	2	0	0	3	20	0	0	0	0	0	0	0	3	0	0	0	0	0	0	0	1	0	0	3	1	0	0	1	0	0	1	0	0	0	0	0	0	0	1	0	3	0	3	0	0	0	6	0	0	0	0	0	1	12	0	0	0	0	0	0	0	0	0	0	1	0	0	0	0	0	0	0	2	0	0	0	0	6	1	0	0	0	0	0	0	0	0	0	1	2	0	0	0	0	0	0	1	0	0	1	0	0	0	0	2	0	0	0	0	0	0	0	0	0	0	1	1	0	0	4	0	0	0	0	1	0	0	1	0	1	4	1	0	0	0	0	0	0	4	0	1	0	0	0	1	1	0	0	3	0	0	0	0	1	9	2	0	4	0	0	0	0	0	0	0	0	0	0	0	0	0	0	0	0	0	7	1	0	0	0	3	0	0	0	0	0	0	0	0	1	1	0	71	0	0	1	0	2	0	4	1	0	0	0	0	0	2	0	1	19	0	0	0	0	0	0	0	0	0	1	0	0	2	0	0	2	3	0	10	2	0	0	0	4	0	0	4	0	0	1	0	1	0	0	0	2	0	0	0	0	3	1	3	0	0	4	1	2	1	2	0	1	3	2	2	0	0	0	0	0	0	2	0	0	0	0	0	0	0	0	0	0	6	5	52	7	0	0	0	6	7	13	13	21	3	0	0	4	0	5	10	0	2	0	2	1	0	0	3	2	0	19	0	0	0	98	0	1	0	0	5	0	1	0	2	7	2	2	2	0	2	2	0	3	0	2	2	2	8	2	2	0	2	2	0	1	3	23	12	7	6	0	5	0	18	8	9	1	0	1	1	0	0	0	1	14	4	6	1	0	0	1	0	0	4	0	0	1	6	1	0	17	6	6	9	0	0	2	7	0	0	19	8	0	0	0	24	21	0	0	1	8	7	1	0	0	2	0	1	0	0	0	0	3	2	2	0	0	0	1	0	0	0	0	0	0	0	1	0	0	0	0	0	0	0	0	0	0	0	0	0	1	0	0	0	0	0	0	0	0	1	1	0	0	3	3	0	0	0	0	0	0	0	0	1	0	0	0	0	0	4	0	1	0
PHYLLO22	43989	9	2	0	238	615	111	12	234	6	0	66	40	0	29	2	2	19	0	4	12	2	0	1	27	7	0	8	6	9	8	2	11	17	4	17	21	0	4	1	0	1	5	6	14	9	5	1	1	17	3	0	36	86	119	6	246	18	27	59	421	0	1	5	16	106	3	10	3	1	42	3	1	0	16	2	32	3	0	5	2	2	115	108	74	68	0	26	0	13	0	71	15	86	45	8	27	2	109	2	2	162	0	64	9	72	104	3	11	11	0	0	38	20	2	27	12	12	1	3	37	8	48	8	15	117	41	40	9	22	5	7	0	4	12	16	4	116	33	19	10	47	65	11	3	30	15	4	15	36	5	1	3	24	1	2	1	0	26	37	43	0	8	79	0	44	47	68	4	13	2	12	9	3	14	6	0	8	6	1	22	12	35	13	6	12	27	1	0	3	6	17	2	1	2	10	1	56	5	6	6	4	1	23	8	23	4	20	2	0	59	5	12	0	231	322	2	28	1	18	8	12	30	13	110	9	94	33	39	4	48	3	7	19	0	0	9	0	56	9	26	5	41	19	0	12	0	7	29	15	0	2	89	8	22	0	11	14	84	1	0	6	1	1	6	1	22	10	14	2	19	9	15	4	7	0	0	18	0	19	42	13	20	4	71	75	7	2	34	2	17	0	4	1	35	2	60	3	6	18	2	7	125	10	0	6	6	35	22	56	50	20	25	4	6	9	0	82	0	36	0	36	6	6	0	4	11	3	4	5	1	21	0	0	2	9	3	3	15	14	64	12	6	47	118	8	2	0	28	10	6	1	18	8	85	1	18	24	4	5	29	35	3	15	0	0	31	20	11	42	0	27	6	9	2	16	41	8	5	41	20	36	7	6	10	1	57	39	16	4	209	0	3	1	16	8	2	16	199	2	15	21	63	0	213	51	3	2	6	23	62	64	12	2	3	1	2	0	2	37	73	22	3	0	47	8	31	85	74	1	0	9	0	0	8	18	93	2	6	13	175	1	14	22	35	95	33	14	43	0	11	47	67	18	146	30	30	207	41	22	2	7	5	1	3	4	1	1	6	4	7	1	1	5	2	8	7	6	11	4	82	13	5	11	11	0	1	2	6	9	0	4	3	1	5	2	0	5	1	0	0	9	1	4	0	1	18	6	0	7	5	3	1	0	22	119	408	12	43	7	19	87	8	47	49	6	115	2	44	21	1	1	4	1	23	23	25	14	51	68	7	41	0	7	19	104	13	7	0	7	1	12	16	25	31	11	1	13	39	39	7	15	2	39	16	0	7	1	1	17	9	16	1	56	31	0	60	6	0	17	1	1	12	11	30	0	7	14	13	49	13	5	11	4	4	0	7	9	1	3	2	0	27	50	2	7	3	1	0	2	5	2	22	0	4	16	13	2	39	0	9	0	2	0	3	0	3	0	0	17	0	0	8	0	7	44	5	0	1	4	1	3	17	0	43	3	0	1	0	1	12	13	141	10	5	3	7	13	2	21	39	3	2	0	3	8	57	3	44	7	28	0	8	19	94	4	8	59	35	1	34	47	15	39	14	13	1	8	38	6	5	4	44	0	0	0	3	4	11	0	0	12	15	1	0	0	31	3	7	8	0	27	21	17	9	24	37	21	31	139	17	1	0	46	31	0	0	2	0	38	11	1	0	2	1	9	10	0	6	0	1	19	8	6	7	1	4	12	5	1	17	44	13	16	7	47	1	7	22	0	6	46	4	28	20	13	5	29	12	19	0	15	4	18	18	11	1	9	6	1	57	5	2	0	0	1	0	2	0	0	2	5	1	26	34	2	6	1	0	1	11	21	27	7	2	2	1	0	2	6	3	0	34	9	36	4	18	4	37	9	0	2	18	53	6	11	0	0	0	1	2	1	10	0	1	0	0	3	0	0	12	2	10	15	0	3	7	1	6	9	10	5	6	2	0	0	14	5	0	0	33	0	3	2	0	0	0	19	1	5	2	2	22	6	8	7	4	0	1	6	7	0	10	1	4	51	5	6	10	1	9	1	13	2	11	3	5	0	3	8	2	4	0	2	0	4	0	1	1	4	3	3	7	29	15	6	9	0	67	0	1	0	1	13	14	7	0	0	2	0	0	0	0	4	2	3	0	7	7	14	3	5	4	4	5	2	0	16	0	21	0	5	0	17	4	0	0	2	0	0	87	0	7	0	0	11	2	49	5	0	1	0	0	16	0	3	2	4	33	20	6	81	1	0	0	10	50	23	0	26	4	4	10	7	13	0	0	0	21	1	16	2	3	0	0	0	13	36	5	2	34	4	9	1	9	3	0	0	2	1	43	3	0	0	8	7	32	34	45	37	6	1	0	1	1	1	2	14	4	0	1	0	0	18	0	1	50	0	0	15	0	0	3	13	7	1	3	12	31	0	4	33	0	3	6	7	35	10	0	29	34	0	16	8	8	5	3	0	18	6	14	15	9	1	23	2	8	14	15	18	10	2	0	1	0	0	37	0	23	35	66	24	17	28	40	18	14	27	25	12	0	9	58	11	78	12	15	19	1	10	21	3	4	32	1	32	42	0	0	11	22	6	5	2	0	9	0	5	0	89	5	40	4	27	14	15	28	12	52	2	0	15	27	4	12	6	4	4	4	43	9	2	4	0	22	12	0	47	0	4	1	10	0	2	0	0	15	7	0	6	0	7	0	0	8	39	1	10	10	4	7	9	3	8	9	0	27	0	2	0	2	1	7	5	4	0	0	14	0	8	6	31	3	8	0	7	3	0	0	73	2	3	2	20	18	1	0	4	5	4	0	0	0	0	1	0	0	0	1	4	1	0	5	15	4	4	5	1	3	2	12	0	6	2	17	17	0	31	7	0	8	0	6	12	1	0	2	1	1	1	11	0	3	12	47	1	10	0	0	0	1	3	1	0	0	13	0	4	2	2	3	0	5	0	0	5	2	1	0	0	0	0	6	4	0	0	0	2	0	0	0	5	6	1	0	1	0	2	3	20	0	0	0	1	32	7	0	2	0	0	3	4	6	94	0	2	0	1	0	2	1	3	3	0	23	0	0	6	0	0	1	0	0	0	0	0	4	0	0	6	0	11	9	42	3	17	1	1	0	0	0	5	5	0	51	6	2	0	0	1	1	4	7	0	0	0	0	1	1	0	0	3	0	2	0	0	2	0	4	2	3	1	3	12	2	6	2	1	0	0	0	6	2	0	6	0	0	2	0	0	18	5	0	3	1	2	3	21	0	25	0	0	0	4	1	7	1	4	0	0	6	0	0	1	1	0	4	4	10	5	0	2	1	5	3	77	0	3	8	2	0	0	65	3	14	3	0	0	1	15	0	1	1	1	2	0	0	0	0	0	3	0	2	22	4	27	3	0	0	2	1	2	0	9	0	10	0	4	2	0	17	1	5	4	9	0	14	1	0	3	4	26	1	0	2	12	11	1	8	2	2	0	47	2	0	1	2	0	0	3	1	0	0	0	0	0	2	0	0	0	10	0	0	4	28	13	0	2	0	1	0	38	8	1	1	0	1	0	0	0	0	1	20	8	6	6	21	9	1	4	3	2	5	2	3	2	17	12	4	9	57	0	6	20	12	13	1	5	1	0	0	13	2	16	15	10	0	3	1	1	2	2	17	17	1	4	0	0	1	0	0	4	20	9	6	7	5	2	1	0	0	3	1	3	0	48	6	3	1	0	1	20	11	2	9	6	1	6	0	14	8	4	2	5	0	2	25	3	5	3	8	40	1	4	300	0	10	4	1	6	3	1	11	43	16	5	1	0	7	14	4	6	1	0	6	6	3	6	36	2	1	9	9	3	14	7	3	5	2	2	2	18	1	3	2	2	0	1	7	1	2	11	7	2	4	0	0	1	1	4	0	1	1	4	4	12	1	0	5	0	1	19	3	0	0	0	0	7	1	5	4	5	3	1	6	3	1	27	7	0	16	1	4	0	0	2	1	5	16	0	3	0	1	3	4	1	0	11	39	1	0	0	1	0	0	9	0	0	0	11	4	20	0	11	1	2	1	2	2	14	0	0	26	12	10	2	3	52	2	3	0	8	13	2	0	2	21	5	1	4	13	2	0	9	6	36	0	0	4	3	3	2	1	40	21	34	0	0	10	0	22	0	1	5	1	1	13	0	1	30	29	50	116	130	14	13	23	56	46	5	0	126	90	6	19	18	47	113	57	0	15	8	0	0	2	7	0	8	2	21	65	69	2	15	1	42	58	13	6	6	28	2	0	53	0	39	0	0	0	2	0	13	16	6	5	0	11	11	1	1	40	5	63	1	0	1	1	14	43	1	3	10	6	46	75	0	37	38	38	26	10	6	0	31	22	8	2	2	18	6	50	5	0	15	6	14	6	1	2	6	32	15	4	31	1	0	4	2	25	0	11	1	8	3	0	5	14	0	0	12	0	0	0	3	0	7	0	0	34	7	0	0	16	0	0	2	0	0	0	21	0	0	0	3	2	0	0	1	0	2	1	0	3	4	0	16	0	0	1	1	12	16	1	2	8	17	0	0	10	2	0	13	1	0	15	21	8	1	4	0	0	5	13	0	0	0	0	0	0	0	0	0	7	8	5	1	0	3	10	6	23	1	2	28	21	23	3	2	1	2	67	0	2	0	1	0	5	36	224	20	1	3	2	0	0	1	3	0	1	0	0	1	1	9	0	10	2	6	4	3	0	10	1	2	11	34	0	0	2	4	3	2	3	3	11	0	0	0	0	0	0	11	4	0	9	3	0	0	0	0	0	0	2	0	3	26	4	4	1	1	0	0	10	0	2	0	0	2	0	10	21	2	1	0	2	1	0	2	3	2	8	7	1	0	0	8	3	9	0	0	0	2	0	1	0	19	0	0	4	3	1	13	0	0	0	2	0	0	36	2	0	0	1	0	0	1	27	3	0	2	2	5	4	2	6	2	0	1	0	10	0	0	0	0	0	0	0	0	0	0	0	18	0	3	0	1	9	0	2	1	2	28	17	5	12	11	1	7	7	0	1	0	2	7	57	35	29	3	3	4	162	0	47	0	6	0	6	39	0	9	1	21	21	29	12	0	1	1	0	0	0	0	1	6	0	2	13	0	0	0	0	0	1	2	7	11	4	3	4	0	12	1	1	11	13	0	1	29	4	2	0	0	0	0	4	0	2	7	0	5	6	0	0	0	0	17	1	3	1	0	0	2	1	5	4	12	0	6	1	6	3	0	0	0	0	0	0	0	13	6	2	2	5	2	0	0	4	2	0	0	3	0	0	3	1	0	0	0	0	4	0	2	7	0	0	1	0	0	0	0	6	0	0	1	1	1	1	0	7	5	11	7	12	6	5	2	0	0	32	0	6	23	22	0	0	4	37	33	4	0	1	1	59	5	11	7	9	8	1	38	2	0	0	0	1	0	0	0	1	0	52	1	2	3	10	0	3	0	0	0	1	7	2	3	0	0	4	3	50	15	1	4	1	0	0	1	2	12	3	10	7	1	0	1	0	3	0	0	3	0	3	0	3	2	4	0	0	0	0	2	0	0	0	4	0	0	0	0	5	0	0	0	0	4	0	0	2	0	0	1	0	0	0	2	2	0	0	26	1	1	7	0	0	2	0	0	0	4	0	2	1	0	10	3	0	0	0	1	0	0	3	2	1	3	0	0	4	0	5	0	0	1	0	2	3	0	0	2	0	0	1	0	0	6	16	2	22	22	18	11	8	4	17	0	7	0	0	3	0	0	0	19	12	15	1	1	0	12	0	25	0	0	0	2	1	0	0	2	57	4	6	0	0	0	0	6	0	1	0	0	0	0	0	4	2	2	0	0	0	0	0	1	3	0	0	1	0	0	0	0	0	4	5	2	1	0	0	1	2	0	9	6	2	174	2	1	0	6	0	0	0	0	3	2	1	6	0	2	18	0	2	4	1	0	1	0	41	2	3	7	0	3	0	0	2	13	0	0	0	1	1	10	0	1	0	2	0	0	0	0	0	3	0	3	0	0	0	0	1	0	0	0	15	0	2	0	0	0	2	4	0	0	0	0	3	0	1	0	1	0	5	1	0	0	0	4	0	5	5	11	0	7	0	1	1	0	0	0	0	0	9	1	4	0	0	0	2	0	0	3	1	0	2	5	0	0	3	13	0	2	3	1	0	1	0	1	1	2	0	8	0	3	3	1	6	1	1	4	14	3	0	3	0	6	0	0	5	0	0	3	2	0	5	0	0	2	0	4	7	0	5	0	2	0	0	1	0	2	0	1	0	2	0	0	0	3	5	1	2	0	4	4	8	6	0	0	0	4	0	0	2	0	0	0	5	0	65	0	2	0	2	0	1	30	1	9	0	0	6	3	0	1	0	2	2	1	3	0	1	1	1	0	3	4	11	2	0	0	0	0	2	3	18	1	2	2	1	0	1	1	2	2	4	1	3	3	8	0	1	2	0	3	2	0	0	10	2	1	1	0	0	4	1	5	4	0	2	0	30	0	0	1	5	0	0	0	0	0	0	1	0	2	1	0	0	5	18	2	1	0	1	0	4	5	3	2	0	6	14	0	0	0	0	1	3	2	0	0	3	2	1	2	0	1	7	2	2	2	1	0	1	0	1	0	0	0	0	0	1	0	0	6	45	72	53	33	0	21	5	0	0	54	62	58	0	58	2	4	0	0	0	1	0	1	2	1	1	0	45	2	2	1	3	0	17	0	0	0	0	19	0	0	0	2	0	0	5	0	0	0	0	0	1	0	0	4	1	1	0	16	0	0	0	0	0	0	0	2	14	0	50	0	0	0	0	0	0	2	0	0	0	0	0	3	0	0	7	1	6	0	1	2	26	0	0	5	1	0	1	0	0	3	2	0	0	0	1	1	2	2	2	0	0	2	0	0	0	0	4	1	0	0	1	0	0	0	0	107	1	0	3	0	6	1	1	1	0	75	0	2	0	0	0	4	0	0	0	0	0	32	0	0	11	1	0	0	1	1	0	0	0	0	0	0	0	2	0	0	0	0	0	25	0	0	0	2	1	0	0	4	0	5	2	5	5	1	17	0	0	1	0	10	3	1	3	1	0	3	6	79	14	2	14	0	0	0	0	0	0	0	3	82	92	2	84	0	0	0	0	0	0	0	0	0	1	0	1	0	0	0	0	1	0	0	0	0	0	0	0	2	0	0	2	0	0	0	0	0	3	0	2	0	0	0	1	0	1	0	7	0	0	0	0	0	0	2	0	1	0	1	0	2	0	4	3	0	0	1	3	2	0	0	0	0	2	1	1	2	10	1	4	0	2	0	2	0	0	0	0	2	18	0	0	1	0	0	0	1	0	2	11	2	10	10	0	1	0	0	0	0	0	20	29	3	32	4	32	48	6	5	7	42	16	0	0	0	2	0	19	16	0	0	14	4	6	0	1	2	6	0	0	0	0	7	0	3	0	0	0	3	0	0	0	0	0	1	1	1	3	0	0	0	1	0	0	0	4	2	1	0	0	1	0	0	0	1	3	0	0	0	0	1	1	1	38	0	10	0	17	26	0	0	0	0	0	0	1	1	1	0	3	0	0	8	1	7	1	0	1	0	0	0	0	5	0	4	3	0	6	6	0	9	0	0	0	3	1	0	0	1	36	3	0	0	1	0	0	2	14	0	0	0	2	0	0	0	0	0	0	0	0	24	0	10	18	0	3	13	0	1	0	1	1	0	0	0	0	1	0	1	3	1	0	0	0	0	7	0	0	1	0	0	0	4	0	1	0	5	0	1	0	6	3	0	8	0	6	8	4	2	2	2	0	12	11	6	1	0	0	2	0	0	3	0	0	8	0	7	4	0	0	1	0	1	3	0	1	51	0	0	10	0	0	0	1	2	0	0	0	8	0	2	0	6	2	0	0	0	0	0	0	3	1	0	0	1	0	0	0	1	6	0	0	0	0	10	0	0	7	1	0	0	3	0	3	2	2	1	0	0	0	0	0	3	0	1	0	0	0	5	1	0	16	5	8	0	0	0	8	8	0	23	3	2	1	0	11	1	0	2	0	1	3	0	4	0	0	7	0	0	1	0	0	0	0	0	2	3	1	1	0	3	6	1	1	0	0	1	0	0	11	2	0	0	0	0	0	4	0	0	0	0	7	0	0	0	0	7	1	12	2	5	0	0	0	0	0	0	4	1	0	0	6	1	0	2	1	1	0	1	5	0	1	0	0	5	1	0	9	4	0	1	0	0	0	0	0	1	0	0	0	0	7	0	3	0	0	0	0	1	4	0	0	0	0	0	1	0	0	0	1	0	0	0	0	0	2	6	7	7	0	0	1	0	0	3	5	0	2	0	0	0	0	0	1	0	0	2	0	4	1	0	0	0	0	0	0	2	0	0	1	0	10	0	3	1	3	0	1	0	0	0	0	0	0	1	0	0	2	3	5	0	0	0	6	0	0	1	0	0	0	2	0	0	1	0	0	3	0	0	0	2	2	0	0	0	2	7	1	14	1	0	25	11	3	5	9	0	3	23	0	0	17	1	7	0	2	3	0	1	0	10	0	3	0	10	0	0	2	1	2	12	6	0	0	0	0	38	6	0	0	0	0	0	0	0	0	0	0	0	7	1	0	0	0	0	0	3	0	0	0	0	0	2	1	0	0	0	0	0	0	0	0	0	0	0	7	0	15	3	0	0	1	2	0	0	0	1	0	1	0	0	34	1	0	0	1	0	0	0	0	0	0	0	3	0	0	0	0	1	10	0	0	0	0	0	0	2	5	0	1	11	0	13	0	0	0	0	9	1	2	5	0	1	3	17	4	0	0	4	3	0	1	17	2	4	1	0	2	0	0	2	1	4	0	0	0	1	0	10	0	0	0	12	0	0	3	2	0	0	30	0	6	3	2	0	2	3	38	10	6	1	5	1	0	0	2	0	0	2	0	0	0	2	0	0	3	4	4	0	0	0	2	0	1	3	0	2	1	1	0	0	4	0	0	4	0	0	1	0	0	0	0	0	0	0	0	0	0	0	1	1	1	0	0	2	0	1	0	0	3	2	0	0	5	0	0	0	13	13	0	1	0	4	0	2	3	0	8	1	0	0	0	0	3	0	0	0	0	0	0	2	0	0	1	0	0	2	0	1	0	0	1	0	1	0	0	0	1	3	2	0	2	3	1	0	0	0	2	3	1	0	1	0	0	0	3	0	0	17	0	2	0	2	0	0	1	2	2	1	1	0	0	1	0	1	0	0	0	0	0	0	3	0	0	0	0	0	0	4	2	0	0	0	0	0	0	0	3	0	1	0	0	0	0	0	2	2	0	8	0	0	1	4	0	29	0	0	1	0	0	0	0	0	2	0	0	0	0	2	0	0	3	3	6	0	0	0	0	1	0	0	0	1	3	0	1	0	1	0	0	1	0	0	0	0	0	0	1	0	0	0	3	0	0	0	0	0	2	4	0	0	0	0	0	0	0	0	0	0	4	8	0	0	0	0	0	2	2	1	0	0	0	0	0	0	0	0	0	0	0	2	0	0	1	0	0	0	3	0	0	0	0	3	12	7	0	0	1	1	1	3	0	0	1	1	39	34	2	1	4	1	1	1	0	0	4	0	4	0	1	1	47	47	1	5	10	2	0	0	3	4	0	0	0	0	3	0	0	1	2	0	1	1	24	0	0	0	0	1	0	0	0	6	0	0	0	2	3	2	3	0	0	0	0	0	3	4	3	2	4	1	2	7	0	0	0	0	0	0	0	0	0	0	0	1	1	1	1	0	3	1	0	2	14	0	9	1	35	0	5	2	0	13	0	4	0	20	0	0	1	24	0	0	22	0	2	14	1	3	6	0	59	1	335	4	7	4	11	3	0	0	2	0	0	3	11	0	1	1	6	224	0	24	0	21	0	2	114	8	35	39	17	7	33	28	59	0	3	1	2	3	0	0	1	9	0	0	0	0	0	0	2	1	0	0	0	0	0	0	0	0	6	0	0	2	0	0	0	0	7	5	0	2	0	0	0	0	0	0	11	0	0	0	1	4	0	2	0	2	1	0	0	0	1	0	0	0	0	3	0	21	0	0	0	0	0	0	0	0	0	0	0	15	0	7	0	0	0	1	6	0	0	1	0	0	1	2	0	0	1	0	0	0	0	1	0	1	3	1	0	0	0	0	0	0	0	0	0	0	19	0	4	0	57	0	1	7	8	2	6	2	0	0	0	14	136	4	4	15	0	0	0	0	0	5	0	6	0	0	0	0	0	4	0	1	3	17	9	4	9	7	2	0	0	0	1	2	3	1	0	0	0	0	0	5	5	5	1	0	0	0	23	1	0	0	1	0	1	5	0	1	1	2	2	0	1	1	1	0	0	2	0	1	0	0	1	30	9	1	2	3	0	2	0	2	1	8	0	0	1	0	0	0	1	0	2	0	0	0	0	14	6	105	14	5	3	2	90	111	0	18	1	0	0	15	0	4	18	1	6	4	1	12	18	5	0	2	1	0	0	1	10	22	0	0	1	0	0	0	1	0	1	0	1	0	0	0	0	0	0	14	2	0	5	4	15	0	10	0	14	1	29	0	0	1	0	4	1	2	2	3	51	3	8	1	1	0	0	1	0	0	18	14	2	0	0	0	1	17	2	13	1	20	10	0	0	16	0	0	0	0	29	0	4	1	0	5	4	0	2	3	2	0	0	0	0	7	0	11	0	0	7	22	4	0	4	34	35	2	12	4	0	0	34	0	7	11	1	10	3	4	2	0	4	1	3	0	0	0	0	4	0	0	0	5	2	7	7	0	19	31	0	2	0	0	0	0	0	4	1	0	0	2	0	0	2	1	0	28	4	6	4	0	2	8	0	1	2	9	1	5	13	9	6	1	0	0	0	1	1	0	0	0	0	0	0	0	1	0	0	0	1	0	0	0	0	0	1	0	0	0	0	1	1	3	0	0	0	0	1	1	0	0	0	0	0	0	0	0	0	1	0	0	0	3	0	0	4	5	0	0	0	4	0	0	0	0	1	0	1	0	0	0	0	0	3	1	2	1	0	0	1	24	0	3	0	2	6	0	5	10	0	0	0	6	0	0	0	0	0	0	1	0	1	0	2	3	1	0	4	1	0	1	0	1	0	3	3	7	0	0	2	0	1	1	2	0	0	0	0	0	6	1	0	1	0	0	0	1	0	2	8	2	2	0	0	6	0	1	5	1	0	0	0	0	0	0	0	1	0	1	1	0	1	0	1	1	0	0	0	0	1	0	3	0	1	0	0	0	0	0	0	0	0	0	0	0	0	0	0	4	0	0	0	0	0	0	0	0	0	0	0	0	0	0	1	0	0	0	0	0	1	0	0	0	2	0	0	0	0	0	0	0	0	0	0	0	0	0	0	0	0	0	2	1	0	0	0	6	0	0	0	1	2	0	2	0	0	0	0	0	0	4	0	0	0	0	1	2	0	1	1	0	0	0	0	0	1	1	0	0	0	0	1	1	0	24	0	0	0	0	0	0	0	0	1	1	0	0	0	0	0	1	0	1	0	0	0	3	0	2	0	1	0	0	0	0	0	5	0	2	1	0	0	0	0	0	0	5	2	0	0	0	13	0	0	0	0	0	5	1	0	0	1	0	0	0	0	1	0	1	0	0	1	0	1	9	1	0	0	0	3	0	0	0	0	2	1	0	0	0	1	7	3	0	0	0	0	0	4	10	18	0	0	0	0	0	5	8	1	12	0	0	0	3	2	2	19	3	1	2	48	20	0	79	23	1	0	0	0	0	2	6	1	0	0	0	0	0	2	0	0	0	0	0	3	2	3	0	0	0	5	0	17	0	0	4	0	0	1	3	1	0	7	14	0	0	0	0	15	1	0	0	0	0	0	2	0	0	1	0	0	5	2	2	0	0	0	0	0	1	0	0	0	0	0	0	0	0	0	3	2	0	0	0	0	0	2	0	0	4	0	0	0	0	0	0	0	0	0	0	0	0	0	2	0	0	2	0	0	0	0	1	0	0	0	0	0	0	0	0	0	0	2	0	0	0	3	0	0	0	0	0	0	0	0	1	2	2	3	1	0	0	0	0	0	0	0	1	0	0	0	0	0	0	0	1	0	0	0	0	0	0	0	1	0	2	0	0	0	0	1	0	3	0	0	1	0	5	1	0	0	1	1	2	0	0	8	0	0	0	0	0	0	0	1	0	0	1	1	0	0	0	0	0	0	2	0	0	0	0	0	1	2	0	0	1	0	0	0	0	0	2	0	0	0	0	1	0	0	0	1	0	0	0	0	0	0	0	5	2	0	0	1	0	0	1	0	0	0	0	1	2	1	0	0	0	0	2	0	0	0	0	2	0	0	0	0	2	0	0	2	0	0	0	0	0	1	0	0	0	0	3	0	1	4	5	0	0	4	0	0	0	0	0	2	0	0	0	2	0	2	0	0	0	0	0	0	0	0	1	0	0	0	0	2	0	0	0	0	0	1	4	0	0	4	0	0	1	2	2	0	2	0	0	0	0	0	0	5	0	3	0	0	1	1	0	2	0	1	0	0	0	0	0	0	0	0	0	1	0	0	0	0	1	0	0	0	1	0	1	0	0	0	0	0	1	0	0	0	0	4	0	1	2	2	0	0	0	0	3	0	7	2	0	1	0	0	0	0	0	8	0	1	0	0	42	3	0	2	0	2	0	0	0	1	15	0	0	1	4	2	1	0	0	2	0	8	0	0	1	0	0	0	0	1	11	46	0	1	1	1	0	0	3	0	0	0	0	2	1	2	1	0	0	0	0	0	0	0	0	0	0	0	0	0	0	0	0	0	0	2	0	0	0	1	0	0	9	0	0	0	1	1	0	0	2	0	0	2	0	0	2	1	0	0	0	0	0	1	0	0	1	0	1	0	2	0	0	0	0	0	1	0	1	1	1	0	0	1	0	1	0	0	1	0	2	1	2	0	4	2	2	4	3	0	3	0	0	0	0	55	0	0	0	0	0	0	16	8	0	3	0	0	0	0	0	18	3	2	16	15	8	0	0	6	0	2	107	0	2	0	0	0	1	2	0	0	0	0	0	0	0	27	2	0	3	0	0	0	1	0	1	0	1	1	2	0	3	10	0	0	0	1	0	0	5	1	0	14	0	1	2	0	2	0	1	0	0	4	0	0	2	2	0	0	4	0	5	1	3	0	2	0	1	39	9	4	0	0	5	5	5	0	3	0	0	5	4	1	0	0	0	0	1	0	0	0	0	0	2	2	1	0	0	1	0	0	0	0	0	0	0	0	0	0	6	0	11	0	0	0	0	0	0	0	2	2	0	1	0	0	1	0	0	2	0	0	0	0	0	0	0	0	0	0	0	1	3	0	0	0	0	0	0	0	2	0	0	0	0	0	0	0	0	0	0	0	0	0	0	0	0	0	0	0	0	1	0	0	0	0	0	0	0	0	0	0	0	0	0	0	0	0	0	0	0	0	2	0	0	0	0	1	1	2	1	0	0	0	0	0	0	0	6	0	0	0	0	0	0	0	1	0	0	4	0	0	0	3	0	0	0	0	0	0	0	0	0	0	1	0	0	0	0	0	0	0	0	0	0	0	1	0	0	0	0	2	1	0	0	0	0	0	4	0	0	0	0	0	0	0	0	0	0	0	7	0	0	0	0	5	3	0	0	0	0	3	0	0	0	0	0	0	0	0	0	2	0	0	0	2	0	1	0	0	0	0	0	0	5	0	0	0	0	0	0	0	0	0	1	2	0	0	0	0	0	0	0	2	0	0	0	1	2	0	0	0	0	0	0	0	0	0	0	0	0	0	0	0	1	0	1	0	1	0	0	0	0	0	0	0	0	0	0	0	0	0	0	0	0	0	1	0	0	0	0	0	0	0	0	0	0	0	1	0	0	1	0	0	0	0	0	0	0	0	0	0	2	0	0	1	0	0	0	4	0	0	0	0	0	0	0	5	9	0	2	0	0	0	0	0	0	2	0	0	0	1	0	4	0	0	0	0	0	0	0	0	0	0	0	0	0	0	3	0	1	0	0	0	1	0	0	0	1	0	1	0	1	0	0	0	0	0	12	4	0	0	4	0	0	0	0	1	0	0	0	0	0	0	0	0	0	0	0	0	6	2	0	0	1	0	1	1	0	0	0	0	0	0	0	1	1	4	1	0	0	0	8	0	0	0	1	5	1	0	0	9	0	0	8	0	2	0	0	0	0	4	0	2	0	0	0	0	0	0	1	1	0	0	0	6	0	0	0	0	1	17	4	0	0	9	36	0	0	1	1	2	10	0	0	3	0	0	2	0	0	19	0	0	0	0	3	0	0	14	0	8	1	0	2	4	0	3	0	4	0	0	1	0	2	0	2	2	1	7	37	0	3	0	0	1	0	0	0	0	1	2	0	3	2	0	7	3	2	1	0	0	0	16	4	0	0	0	0	2	5	0	0	2	1	0	3	0	0	0	16	2	0	0	15	6	1	0	0	0	0	1	4	1	3	0	0	0	0	0	2	3	0	0	0	0	3	10	3	1	0	0	0	0	0	0	0	27	0	0	2	0	1	0	0	0	14	2	0	1	1	16	0	2	1	0	5	0	2	0	0	1	0	0	1	0	2	0	0	1	0	0	0	2	0	0	3	0	3	0	0	0	3	0	0	0	0	0	0	0	0	0	0	0	2	0	0	1	0	0	0	0	0	1	0	5	6	0	2	0	1	1	2	0	2	0	17	0	0	3	1	19	1	1	1	0	0	0	0	0	0	1	0	5	0	3	1	1	1	0	1	2	3	0	0	1	0	0	0	0	0	2	0	0	2	2	0	0	0	1	0	0	0	0	2	0	0	0	0	0	0	0	5	2	0	1	0	32	1	0	0	0	3	0	2	18	1	3	0	0	0	0	3	3	0	0	0	1	0	0	3	3	5	0	0	0	0	0	6	1	0	0	0	0	18	0	5	3	1	2	4	0	1	0	1	1	0	2	4	2	0	4	0	0	5	0	0	0	2	3	0	0	0	2	0	0	4	0	0	0	0	0	0	0	0	0	1	0	0	1	2	0	0	0	2	0	0	1	0	0	0	2	0	0	5	2	1	0	2	0	0	1	0	2	0	1	1	0	0	0	0	1	4	0	1	0	0	2	4	0	2	0	15	2	6	0	0	10	2	0	0	0	0	0	0	6	5	0	0	0	0	2	27	1	1	2	2	21	4	39	0	0	0	0	0	2	0	1	0	4	0	0	0	2	1	2	0	2	0	0	5	2	0	6	0	0	0	2	5	8	0	16	0	18	4	0	5	2	8	8	44	1	2	6	7	5	18	19	0	1	1	2	5	4	0	1	0	1	1	0	0	2	68	0	1	2	17	1	3	4	9	0	1	3	1	0	0	0	0	1	0	0	1	1	1	0	1	0	0	0	0	2	0	0	1	1	0	0	0	0	0	1	1	17	0	0	0	0	3	0	0	0	0	0	0	1	10	0	3	0	0	0	0	0	0	0	0	1	0	0	0	0	0	0	0	0	0	0	0	1	0	0	2	0	6	0	6	3	6	4	0	0	0	0	6	0	2	0	0	0	0	0	0	0	0	4	25	25	40	0	0	0	0	5	0	0	0	0	0	4	0	3	3	1	0	0	1	0	11	0	12	4	42	11	0	21	29	16	14	2	23	0	18	185	4	10	0	0	1	0	0	0	0	0	0	0	0	0	0	0	0	1	6	0	3	6	9	3	0	17	6	15	2	0	0	2	2	0	0	7	0	7	0	0	51	0	9	4	0	2	0	1	2	1	11	34	42	6	0	0	19	0	5	1	1	17	0	0	0	0	2	0	0	0	0	0	1	2	2	0	1	5	7	2	1	0	22	0	5	1	0	1	0	1	0	34	7	95	2	2	0	1	7	0	0	3	7	2	0	8	0	0	1	6	1	1	1	4	0	6	11	4	11	8	17	3	26	43	0	0	67	0	0	3	1	0	23	17	0	9	3	0	1	0	6	0	0	38	0	1	0	1	1	0	0	0	4	4	1	0	12	11	2	3	0	17	0	1	12	0	12	0	45	0	2	12	25	3	0	4	0	3	2	0	0	3	10	0	9	0	0	0	0	0	6	5	1	1	0	0	0	4	0	0	0	0	0	32	1	1	0	0	11	0	2	0	0	0	15	1	1	0	10	7	10	11	0	0	0	0	12	5	1	28	0	0	1	10	0	4	3	3	0	6	0	0	0	1	0	0	0	0	0	11	0	1	1	3	20	2	3	2	17	6	2	0	0	0	10	4	0	0	9	1	7	18	0	0	0	0	0	3	0	0	0	0	0	0	2	0	0	0	0	0	0	31	0	0	11	5	2	0	1	0	1	0	0	0	7	0	0	0	0	0	0	0	0	8	3	0	13	0	16	0	3	3	0	0	4	2	0	0	0	0	0	0	1	5	1	0	0	3	0	0	0	0	0	26	0	0	44	0	0	0	1	0	0	0	0	0	7	13	0	12	10	0	1	0	9	2	0	3	24	0	0	0	0	0	0	0	1	0	0	0	0	0	0	0	0	0	0	1	0	0	0	1	0	0	0	0	0	0	0	0	0	1	0	0	0	0	0	0	0	2	1	0	0	0	0	0	0	16	1	0	0	0	0	0	0	0	0	2	1	0	0	0	0	0	0	0	0	0	0	0	0	5	2	0	0	0	0	0	0	0	0	0	0	0	0	0	1	0	0	0	0	0	0	0	0	0	0	0	0	0	0	0	0	0	2	0	0	0	0	0	0	0	0	4	2	0	1	12	0	0	0	0	3	0	6	0	0	0	0	0	0	1	0	0	0	0	0	0	1	0	0	1	0	5	0	0	0	0	3	0	4	0	0	0	0	0	0	0	0	0	0	0	1	0	0	0	0	0	0	2	0	9	0	1	2	0	0	0	0	0	4	0	1	0	2	0	26	0	0	0	0	9	0	7	0	0	1	0	0	1	0	0	0	7	1	0	0	0	0	0	1	0	0	1	0	0	1	0	0	0	0	0	5	3	0	0	0	0	0	0	3	0	0	3	0	6	0	0	0	0	0	1	2	0	0	0	0	0	0	0	3	1	0	0	3	0	1	0	0	1	0	0	0	0	0	1	0	0	0	0	4	0	0	3	1	0	6	3	46	6	0	0	1	0	2	4	4	8	0	0	0	0	0	4	26	0	0	2	2	2	9	0	10	1	1	29	1	0	0	57	0	2	0	7	0	0	0	0	1	7	0	0	0	0	1	0	1	6	0	3	3	3	0	3	1	0	1	2	2	1	2	11	2	26	5	4	2	0	4	2	4	0	0	0	0	0	0	0	0	8	1	4	1	0	1	5	1	0	2	0	2	0	9	0	0	17	5	6	6	1	1	0	3	0	0	9	2	5	1	2	26	11	2	2	1	3	3	0	0	1	0	0	0	0	0	1	0	5	0	0	0	0	0	0	0	2	0	0	0	0	0	0	0	0	1	0	0	0	0	0	0	0	0	0	0	0	0	0	0	0	0	0	0	0	0	0	0	0	0	0	0	0	0	0	0	1	2	0	0	0	1	0	0	0	0	4	1	0
PHYLLO23	236825	1	0	0	962	3476	397	1	843	15	17	254	176	1	700	2	0	18	0	17	34	3	1	12	166	1	1	79	34	135	29	1	25	120	32	111	105	0	4	0	0	0	0	0	51	0	0	0	1	26	0	0	155	354	753	16	1995	30	54	1	119	0	33	28	113	518	0	91	36	0	82	5	0	0	23	7	10	0	0	5	0	0	950	609	368	280	0	180	2	98	3	411	124	382	129	73	203	28	431	8	3	1115	13	682	4	352	612	12	61	51	17	2	140	101	2	170	68	77	0	2	337	64	271	24	65	771	263	355	79	45	30	13	0	19	17	27	6	884	197	49	82	247	258	28	10	145	44	19	87	121	15	2	17	47	9	4	8	6	235	238	207	2	23	382	12	284	304	270	89	92	13	103	92	29	49	24	0	35	66	1	92	22	97	30	31	92	76	1	0	21	28	79	11	5	1	80	96	313	4	6	28	20	14	132	27	79	3	199	15	14	275	17	94	0	1225	1654	3	195	17	103	48	72	159	84	583	45	514	234	138	29	314	46	17	114	2	1	57	0	210	13	141	88	339	108	16	14	1	58	205	41	0	6	354	19	342	8	18	34	395	26	4	33	22	0	26	14	67	100	114	25	106	67	79	8	48	15	0	55	0	159	221	39	126	53	540	421	38	18	70	39	162	0	0	3	194	29	410	0	16	77	2	84	531	35	1	3	4	226	145	279	465	34	64	6	11	54	0	146	0	156	0	165	35	21	9	10	5	15	24	23	1	125	0	0	25	0	9	5	1	43	346	87	8	312	815	27	9	4	116	40	29	18	60	38	327	2	81	111	30	65	95	102	23	56	0	0	145	216	45	163	0	116	66	76	27	97	268	80	29	360	144	124	57	64	14	35	438	342	74	27	1357	0	5	4	3	21	0	87	1665	5	66	15	290	0	1494	217	0	0	28	98	431	527	3	0	6	21	11	13	13	109	432	124	6	1	252	5	138	301	800	8	10	20	0	1	8	106	568	41	34	58	679	8	129	119	157	429	204	104	284	14	73	298	351	128	396	129	79	2166	94	81	0	0	0	0	5	0	2	0	12	6	6	12	8	5	9	5	5	14	22	1	340	32	9	38	11	1	0	0	17	38	0	12	21	2	94	0	0	6	0	4	0	15	0	4	1	2	18	31	0	75	7	26	0	6	222	604	430	40	263	88	81	1066	46	263	349	34	418	0	206	35	1	25	35	0	72	73	210	38	263	293	21	157	5	82	147	419	128	45	1	24	1	71	40	77	123	50	34	136	309	284	59	75	16	267	74	7	5	1	0	124	19	49	5	207	117	5	310	102	7	110	0	12	67	46	100	2	42	129	75	130	39	12	28	15	0	4	12	12	2	7	0	4	113	254	4	36	54	3	0	2	10	1	186	3	44	66	65	7	166	1	81	1	4	0	10	9	12	4	2	42	0	2	46	2	76	242	38	0	0	78	2	30	87	0	160	9	0	12	9	0	28	72	1185	31	55	0	44	76	0	60	198	24	10	4	12	34	315	7	328	16	146	0	45	137	494	24	68	276	163	4	178	266	63	161	77	68	0	3	216	84	27	49	287	0	0	0	27	5	51	0	0	28	144	5	2	0	111	22	49	60	0	193	95	72	122	127	241	77	214	1128	73	7	1	280	77	0	10	13	10	147	75	1	0	15	0	45	127	2	12	0	26	92	29	31	56	0	12	38	25	3	143	229	74	133	55	202	0	50	119	0	52	95	45	239	96	28	47	165	41	119	0	67	4	132	93	60	10	21	29	3	230	63	23	0	5	12	20	0	0	0	0	10	0	141	255	1	22	0	0	25	45	95	133	54	41	8	5	0	7	42	13	0	201	46	107	29	72	4	168	72	0	4	135	102	34	44	1	2	15	0	9	0	17	0	1	13	2	0	0	0	80	13	50	75	3	1	85	12	101	40	48	24	18	5	0	0	85	60	0	7	80	22	25	5	1	0	0	29	4	39	16	4	120	60	57	54	48	1	0	2	29	9	29	1	26	237	23	44	20	10	33	6	41	0	30	5	10	2	25	82	26	19	0	4	0	17	0	15	2	24	26	18	39	192	50	70	46	0	434	0	5	1	6	54	74	81	1	2	16	0	3	1	1	13	8	42	0	10	43	30	41	2	6	26	45	6	0	174	2	68	0	52	9	145	54	18	3	29	1	0	537	12	107	0	2	72	5	138	25	0	3	22	1	0	9	6	37	0	163	82	16	476	0	0	0	34	204	122	0	70	10	33	6	3	51	0	0	2	60	3	31	0	15	9	0	0	79	195	44	0	174	3	39	0	48	39	0	1	12	7	180	4	5	0	34	84	149	226	159	164	9	1	3	0	15	25	0	88	28	2	0	1	0	80	4	0	213	4	0	58	0	0	0	98	39	0	17	39	229	0	8	219	2	2	6	22	73	17	6	264	308	6	75	0	19	19	28	6	96	42	59	85	74	40	148	51	29	155	61	23	45	7	0	18	14	1	143	1	137	95	482	188	38	144	251	110	66	50	161	126	0	25	399	44	445	73	89	78	6	99	142	0	25	228	6	243	324	4	15	114	150	146	33	20	0	14	0	0	1	296	41	148	40	138	115	117	103	52	396	17	8	47	152	8	63	51	148	5	13	313	36	0	17	0	90	74	0	251	0	22	11	62	0	29	0	0	48	35	1	4	0	26	0	1	49	15	0	32	89	5	47	8	12	24	22	0	74	0	10	1	23	14	43	34	15	0	1	129	2	34	112	114	18	101	0	38	3	2	0	463	9	11	23	147	78	0	9	29	48	24	9	0	0	0	2	0	0	35	2	27	0	0	53	29	5	40	33	2	21	5	57	1	22	1	81	107	4	125	22	0	25	0	46	40	10	0	0	1	39	5	109	0	5	145	332	4	37	0	4	0	0	11	1	3	5	32	2	33	21	1	12	2	12	0	2	53	3	4	2	1	0	4	54	36	3	2	10	3	2	14	5	105	27	13	0	7	19	33	5	78	1	1	0	34	238	17	1	5	9	1	20	1	71	411	3	43	0	6	0	10	2	27	37	0	108	11	2	65	18	0	5	0	0	0	0	2	6	7	1	42	0	92	83	337	31	57	3	87	0	2	2	36	28	3	276	10	0	0	0	0	19	11	10	1	0	1	0	5	0	1	0	2	0	0	0	2	12	1	35	29	2	5	0	123	15	12	5	28	0	0	5	40	21	0	52	5	9	21	1	2	96	22	10	26	0	0	28	62	0	101	0	1	16	23	8	7	13	36	0	0	42	6	0	6	2	13	41	23	21	125	5	0	1	5	4	326	0	3	21	10	0	0	290	13	50	35	5	0	0	87	19	2	2	0	0	3	0	1	3	8	7	0	2	149	5	78	0	0	2	45	47	11	4	12	0	1	0	2	0	1	56	0	84	33	53	15	34	6	0	6	35	151	5	3	0	30	30	16	32	9	2	2	252	26	5	1	12	2	0	6	4	0	0	1	1	0	0	0	1	0	83	0	0	26	327	83	0	0	3	0	1	403	42	0	9	0	0	18	0	5	0	15	135	25	84	66	157	56	31	18	5	15	14	19	11	0	39	13	18	7	152	18	12	174	51	2	4	41	11	0	2	90	0	44	67	56	0	11	1	9	0	2	32	85	34	10	10	3	65	7	4	35	38	61	73	33	20	2	4	0	0	4	4	10	0	201	37	39	1	1	21	104	49	3	31	21	41	20	1	76	84	5	1	4	2	8	103	40	9	5	18	186	4	29	2412	0	71	17	16	7	19	2	59	208	56	11	10	2	32	51	44	55	2	0	81	13	2	45	183	3	14	94	66	12	75	27	12	25	4	1	15	115	9	20	2	17	1	11	19	1	10	54	33	21	23	13	6	13	0	18	0	11	0	5	9	67	32	21	15	0	24	155	62	3	32	6	9	30	7	32	57	45	21	3	32	43	30	95	63	10	46	17	13	3	9	25	11	14	57	24	8	0	3	6	49	0	4	69	361	3	1	5	6	12	12	45	0	5	12	42	41	66	8	46	2	50	6	7	11	110	3	1	92	60	29	10	13	287	1	57	5	61	34	12	2	45	134	96	1	18	77	13	0	28	26	121	0	1	3	15	24	34	1	284	206	164	0	9	115	20	170	1	5	34	9	15	128	0	1	78	76	314	813	814	92	69	109	427	314	28	0	601	380	66	161	106	317	590	256	0	42	73	4	0	0	23	6	52	0	104	277	355	12	118	1	117	423	87	12	7	162	0	47	347	0	246	0	0	0	4	2	132	164	58	3	0	59	60	5	5	301	10	376	1	2	0	0	52	289	25	14	97	51	218	383	3	170	174	172	108	46	10	2	88	81	29	1	13	103	139	259	110	0	81	29	19	5	5	12	4	219	42	38	228	4	0	2	0	218	0	60	13	4	48	0	16	57	2	0	106	0	0	1	2	0	30	3	0	275	31	0	8	148	0	4	1	0	0	1	68	0	0	1	6	2	1	0	0	0	0	0	0	10	24	0	73	1	2	0	15	49	22	6	44	4	60	0	0	27	3	0	54	7	0	65	148	19	0	5	1	0	21	11	5	0	8	2	0	28	3	0	2	8	20	63	8	4	4	51	18	144	1	2	84	77	92	3	3	0	9	326	1	0	1	0	11	11	81	773	98	0	32	4	3	0	9	3	28	1	0	1	0	0	54	3	23	18	43	11	52	0	68	6	13	72	43	7	1	0	14	42	2	8	2	64	2	10	0	0	0	3	30	0	0	13	9	1	1	1	0	0	3	4	1	37	95	3	2	2	0	0	0	40	2	4	0	0	1	1	38	74	14	0	0	12	0	28	10	59	19	58	54	24	25	2	28	12	57	6	5	0	1	0	0	1	78	13	1	24	31	3	106	26	0	0	11	0	0	254	0	0	5	2	0	5	28	77	1	0	0	1	27	680	2	27	14	0	4	1	93	59	0	0	13	0	0	4	70	0	1	0	36	0	21	0	4	90	1	9	13	11	111	129	50	38	51	1	28	28	3	3	0	21	13	230	175	140	3	3	3	1116	0	238	5	21	2	16	168	2	160	7	105	99	112	56	0	0	0	0	0	0	1	0	13	0	2	220	0	0	1	0	1	3	14	36	51	30	7	21	2	30	0	4	13	0	2	5	135	73	26	7	1	23	1	31	0	2	14	0	30	16	3	1	0	3	73	15	16	1	1	4	4	0	3	16	9	0	13	0	10	29	5	3	0	2	13	41	2	84	34	29	0	33	1	3	1	80	1	4	1	30	3	1	16	7	0	5	0	0	14	2	5	42	1	1	15	0	0	0	0	24	0	0	20	21	41	8	6	112	28	67	79	63	81	13	3	0	0	207	1	33	123	107	0	0	18	157	127	9	6	4	4	26	6	83	33	18	90	33	172	10	0	0	29	11	5	7	0	26	1	198	0	3	6	53	3	9	4	0	0	2	90	18	19	0	7	61	20	134	43	1	9	2	1	0	4	12	69	6	29	12	9	7	34	7	27	2	5	38	0	5	1	0	5	8	2	0	6	7	6	1	0	3	7	6	0	1	1	12	3	0	24	3	28	1	0	15	6	11	9	7	1	0	2	0	2	3	79	12	8	51	0	0	4	0	8	0	4	0	14	18	2	33	11	1	0	0	0	0	1	6	0	28	2	1	1	39	3	43	1	16	1	0	6	20	4	1	5	9	0	0	2	0	19	53	16	145	78	129	79	3	5	184	0	25	0	2	22	12	0	0	63	78	60	25	0	23	59	4	81	0	2	1	2	0	0	0	3	249	0	20	31	2	1	0	13	1	0	0	2	0	0	0	23	18	3	1	0	2	0	2	15	26	0	0	0	1	12	1	0	2	72	23	1	2	2	1	3	2	3	29	7	6	835	4	1	2	35	1	0	1	1	1	3	2	75	0	18	67	4	2	17	5	0	18	0	209	8	1	31	2	6	3	0	21	83	1	2	4	1	3	49	2	0	1	48	0	1	1	1	4	0	1	74	1	2	6	2	1	0	0	1	35	5	7	0	4	4	1	7	3	2	6	11	1	2	0	1	3	2	4	0	0	0	2	51	5	34	8	13	0	65	1	4	0	2	0	1	0	3	100	0	60	0	16	5	1	2	5	0	6	1	17	16	0	17	7	23	0	25	0	0	2	7	0	0	0	4	0	0	5	5	3	5	42	2	18	35	29	2	6	12	0	39	0	11	43	24	1	1	6	2	6	3	2	2	0	16	65	5	56	5	5	4	1	1	0	11	2	0	21	14	0	0	0	13	39	1	5	0	41	17	2	63	3	14	27	20	2	6	5	6	3	4	32	0	254	7	12	1	3	0	31	157	1	81	0	3	13	20	1	4	5	9	26	9	10	0	2	12	5	0	2	14	41	18	11	5	1	12	13	6	131	2	17	9	3	0	9	8	4	17	10	4	18	17	34	7	0	11	2	1	11	1	1	131	8	4	13	2	1	53	1	18	26	5	2	1	152	0	0	3	41	0	2	0	3	0	2	0	0	4	0	2	3	4	29	0	0	5	6	23	20	10	4	0	2	23	60	0	0	0	2	0	25	6	6	2	8	18	19	5	0	6	19	26	1	5	0	0	6	0	1	3	0	1	0	1	5	15	3	25	148	353	199	87	6	76	91	0	0	255	249	252	3	246	12	17	2	3	0	7	0	2	0	3	1	1	243	16	2	2	61	0	240	0	0	0	0	60	0	6	0	0	0	0	6	1	0	1	1	0	0	1	0	31	3	3	0	125	1	4	0	0	2	1	0	0	77	0	489	0	5	3	6	0	0	7	5	5	0	0	0	4	1	1	8	8	21	0	0	4	147	5	0	2	0	0	24	2	0	3	7	1	0	0	2	1	9	9	9	0	1	35	5	2	2	0	15	74	7	0	0	0	1	1	1	551	3	5	27	0	10	2	2	2	0	198	1	2	1	0	0	0	9	1	0	0	0	272	3	0	73	2	0	0	0	7	0	0	0	1	0	1	2	0	4	8	0	0	15	29	0	2	5	26	16	10	0	12	0	25	1	11	90	14	47	1	9	5	1	48	20	1	4	2	0	2	32	325	15	4	17	1	1	2	0	2	2	1	23	329	324	3	316	2	6	1	0	2	0	27	1	0	13	0	0	0	6	6	0	0	8	0	5	0	2	1	7	25	0	1	19	2	0	0	6	4	15	0	0	0	15	0	19	1	3	5	32	3	0	0	2	18	13	5	0	2	0	9	1	0	2	5	27	0	0	7	8	4	0	6	3	9	6	1	0	24	33	9	51	10	0	5	0	2	0	3	6	0	149	0	0	4	3	14	0	6	3	5	62	10	43	84	1	0	1	0	0	8	1	75	105	3	103	33	111	267	12	65	24	263	47	0	3	0	0	0	82	50	9	0	13	0	125	35	6	12	24	18	14	32	2	28	1	37	1	2	0	6	11	0	1	0	0	23	1	19	6	8	1	1	4	0	15	2	53	0	0	2	0	1	2	0	0	4	23	25	1	0	1	0	16	8	166	0	49	0	55	0	2	2	1	3	2	9	11	4	0	30	20	1	0	25	1	27	6	0	2	0	0	1	0	0	5	0	67	1	57	9	3	71	0	0	0	44	2	5	0	4	134	27	1	2	8	0	0	5	27	6	6	0	110	6	23	2	0	4	0	0	0	0	21	30	321	55	5	53	4	3	3	31	0	0	0	1	0	7	0	0	28	0	3	0	0	4	84	3	0	10	5	0	10	29	15	2	4	31	2	0	1	82	79	3	2	9	0	0	26	3	8	21	0	74	61	3	21	5	0	5	8	0	1	6	2	34	0	61	21	2	17	1	1	2	13	2	13	176	4	2	34	2	1	0	4	14	2	0	1	77	0	0	0	11	1	1	0	3	8	0	2	9	3	0	1	16	0	1	1	65	2	3	1	0	0	78	2	1	3	4	0	0	12	0	2	3	4	0	1	0	1	1	5	11	1	1	0	6	0	46	0	0	57	2	65	1	0	6	69	71	6	40	1	12	20	4	83	1	0	7	0	0	14	18	2	1	1	30	5	1	0	7	0	0	4	2	15	7	4	7	0	7	11	2	0	8	4	3	1	0	60	13	3	0	2	2	6	8	0	5	0	2	16	1	0	0	1	36	3	50	8	10	7	0	0	5	12	1	5	1	1	0	7	21	0	6	2	0	0	1	33	4	14	6	0	14	3	0	10	31	12	2	0	6	0	2	0	5	0	0	0	0	102	7	10	0	0	0	3	0	25	0	1	0	1	27	4	0	0	1	1	0	3	0	2	4	2	19	102	102	1	12	6	1	0	0	34	0	1	1	0	0	1	2	6	0	6	4	0	45	1	0	2	0	2	5	7	0	0	3	0	13	102	0	10	0	17	0	1	0	0	4	1	0	0	1	0	4	0	10	35	0	0	0	47	0	1	0	0	0	0	0	0	1	2	0	7	8	0	0	2	0	7	6	0	0	4	36	4	115	2	0	103	52	2	4	9	0	1	113	0	1	73	1	25	2	14	20	0	0	8	37	2	0	0	32	3	1	0	0	0	60	59	0	0	0	3	92	43	0	0	0	1	0	4	4	0	4	0	0	22	0	0	0	1	0	2	11	4	0	3	0	0	2	1	1	0	0	1	7	4	0	0	0	0	1	26	1	92	0	4	1	2	0	1	11	0	3	0	0	1	0	172	12	0	0	6	1	2	10	1	0	2	0	19	1	2	3	0	2	70	0	2	1	1	0	2	2	1	0	27	65	1	13	0	0	2	1	60	9	1	16	0	0	3	69	17	0	2	8	9	1	1	81	2	0	0	17	18	2	2	2	10	9	1	0	0	1	3	7	1	3	2	25	0	6	12	3	0	1	224	0	10	0	15	0	17	14	143	44	24	3	9	12	7	1	0	0	1	42	3	0	0	3	0	1	2	2	8	0	1	0	8	5	0	7	4	2	0	0	0	0	0	0	0	3	0	4	0	0	0	24	3	0	0	0	6	1	0	0	4	1	7	0	9	0	0	0	0	26	5	0	1	1	64	11	8	0	55	83	0	2	1	17	6	1	6	21	64	5	1	3	5	1	41	0	7	0	0	7	0	11	0	2	0	0	0	7	1	2	10	0	2	2	0	3	1	0	0	0	5	0	9	15	8	6	0	0	4	1	5	0	19	0	14	18	12	0	0	43	0	5	2	13	1	0	1	0	9	7	0	0	4	2	2	1	0	0	0	0	6	2	9	2	2	0	6	0	0	40	23	0	0	0	9	0	0	0	39	64	0	0	0	8	1	1	0	8	0	57	0	0	0	49	0	167	4	0	6	0	0	1	0	0	2	3	8	0	0	7	0	0	14	21	7	7	0	0	0	0	0	6	4	2	1	0	4	0	0	1	3	0	0	0	0	13	8	0	4	8	0	1	7	0	3	6	3	0	23	5	0	1	0	0	3	2	1	1	1	0	2	47	0	4	0	2	0	0	4	2	0	5	0	0	0	0	4	3	0	0	0	12	0	0	7	0	1	0	19	0	0	21	1	24	40	53	0	0	23	0	2	24	0	3	32	28	109	84	30	1	1	1	23	1	2	1	31	0	30	1	3	3	201	203	20	6	51	5	4	3	13	0	40	0	3	0	27	0	0	3	1	0	4	0	152	0	0	0	0	0	4	0	0	36	0	0	0	0	11	28	4	4	0	1	1	0	32	10	15	1	10	1	4	15	0	1	19	0	0	9	2	0	0	0	0	0	0	0	0	4	10	0	2	14	0	2	7	0	108	1	6	3	8	194	0	25	0	86	1	1	6	113	0	0	108	0	1	0	12	58	22	0	418	1	2053	71	10	14	35	22	4	5	0	0	1	51	71	4	0	0	1	2399	0	132	2	118	4	23	528	62	14	93	176	97	85	87	391	1	1	8	0	7	1	15	3	22	2	1	0	2	0	2	21	0	0	1	0	2	0	0	1	0	36	0	3	20	0	0	2	1	45	43	1	1	2	1	1	0	2	1	54	0	1	0	0	15	0	4	1	1	3	1	1	0	7	0	0	0	0	0	0	91	7	0	2	0	2	1	0	4	14	0	1	114	20	14	0	0	7	2	25	1	0	34	4	4	0	7	0	5	1	0	0	0	2	4	3	71	60	0	2	0	0	0	1	1	0	0	5	0	111	1	138	2	309	1	3	27	55	12	181	6	0	1	2	88	878	45	23	165	0	0	2	5	5	9	0	22	2	5	1	3	0	55	0	15	31	59	23	27	26	43	9	0	1	3	0	5	4	0	3	0	0	0	2	13	13	13	3	1	1	1	57	3	2	3	0	8	3	22	2	0	0	4	3	0	3	1	1	6	4	1	0	2	0	0	0	127	45	1	3	6	2	6	2	0	0	39	0	0	10	2	0	0	0	0	0	0	2	2	0	47	22	623	105	61	0	25	450	668	2	29	25	0	2	42	8	8	85	0	17	64	0	158	96	13	1	0	4	0	0	2	25	125	4	4	24	0	0	8	4	3	3	3	0	2	1	2	2	0	1	53	1	2	10	27	44	1	21	0	1	15	142	0	33	26	55	0	34	7	5	8	253	2	15	6	6	9	1	7	15	0	71	26	1	0	0	2	9	50	20	19	11	15	13	1	0	23	0	0	0	1	154	1	13	0	0	22	0	1	1	1	4	2	0	2	0	4	5	46	2	2	23	89	33	7	53	392	466	2	99	0	4	1	117	2	16	37	21	22	6	11	7	0	19	1	1	16	1	1	2	10	2	0	0	90	6	10	69	1	42	100	0	6	1	10	0	2	6	2	2	0	1	4	31	1	0	4	1	80	38	21	15	9	46	10	0	1	9	100	6	55	62	95	45	1	2	1	1	0	1	2	0	0	0	1	1	0	0	0	0	0	0	0	0	0	3	1	1	1	0	0	2	6	0	1	0	3	3	8	0	2	0	1	1	2	0	5	1	0	1	3	0	0	2	2	0	0	0	2	2	0	3	4	0	3	2	0	2	1	5	0	0	0	0	5	12	1	4	0	0	1	1	88	1	2	0	22	64	2	65	79	0	2	2	47	0	0	0	0	7	0	5	1	2	0	10	9	4	27	0	4	7	5	0	1	3	9	9	4	0	0	1	0	0	3	10	2	0	1	0	0	30	0	5	3	0	0	0	8	0	0	16	5	2	0	1	14	0	5	8	0	0	1	0	9	2	0	0	3	2	0	6	1	1	0	15	37	0	0	0	0	7	0	0	1	0	0	0	3	2	0	0	23	0	0	0	0	0	1	0	8	0	1	1	1	3	0	0	0	0	2	0	0	0	1	3	0	0	2	37	1	2	14	0	1	3	0	0	9	2	1	0	5	0	2	2	13	34	2	3	1	0	5	6	7	1	0	3	18	4	0	0	0	17	0	0	2	2	0	0	0	0	1	0	0	0	3	0	5	0	3	7	0	2	0	0	0	0	3	1	2	0	0	1	14	0	172	18	3	3	0	0	1	1	1	1	2	1	1	6	6	0	7	0	0	5	0	3	0	0	0	1	5	0	3	0	0	29	23	2	2	0	0	0	2	0	0	0	25	38	0	1	9	67	0	0	0	0	2	3	0	1	3	0	0	0	0	2	0	0	0	2	0	1	0	1	20	2	0	0	1	9	0	0	1	0	26	1	0	1	0	3	46	7	2	3	0	0	3	13	26	31	0	0	0	0	0	36	8	4	23	1	3	0	6	4	10	44	2	43	2	321	57	2	1	136	0	0	7	0	9	9	38	2	37	8	0	0	0	4	8	3	3	1	12	11	14	14	7	0	0	26	1	87	1	7	14	0	3	1	0	0	0	82	55	2	2	0	0	127	3	0	0	4	6	0	1	0	2	0	1	1	41	11	1	0	0	1	0	0	1	1	2	0	2	0	2	0	1	1	4	12	0	1	1	4	0	0	0	0	1	1	2	0	0	5	2	0	2	0	0	0	9	0	4	0	4	2	4	1	0	0	0	0	1	3	1	0	10	1	0	0	0	2	5	0	0	8	2	2	0	0	0	0	3	0	0	16	18	24	18	0	1	3	0	3	0	0	0	2	0	8	0	0	0	1	0	1	0	0	1	0	0	1	0	0	0	0	4	0	0	12	0	3	0	0	0	0	47	0	1	35	0	1	0	6	0	4	0	7	9	2	2	1	0	0	0	4	0	0	1	0	2	0	0	1	11	1	4	2	1	0	3	0	1	1	2	0	0	0	1	1	0	0	0	0	1	2	0	0	3	0	5	9	22	0	1	0	2	2	4	0	9	2	5	19	0	0	0	0	0	11	1	2	28	9	1	0	2	0	1	1	0	2	8	2	0	0	10	0	1	3	2	12	0	2	2	2	0	1	1	2	26	0	0	18	17	4	0	6	0	0	0	37	0	5	1	2	1	8	0	3	0	0	2	2	0	0	1	0	4	1	0	0	1	40	1	2	4	1	0	3	6	0	0	0	0	0	6	20	29	2	8	0	0	3	4	0	2	27	1	8	11	3	17	3	0	3	9	8	0	3	6	1	1	2	1	0	1	7	0	0	0	0	9	0	0	4	1	0	1	0	1	0	0	0	6	0	10	1	0	0	2	17	0	1	2	0	0	1	2	0	114	0	3	3	1	0	1	9	0	25	2	2	1	0	136	2	10	1	0	5	0	1	0	0	63	12	0	0	0	32	1	13	0	3	16	45	2	0	5	0	0	0	2	4	22	150	0	0	0	1	1	0	0	1	2	0	4	0	0	0	0	3	0	2	0	0	0	0	0	0	2	0	1	2	4	0	2	0	8	0	0	2	2	4	0	1	33	0	2	0	2	5	3	0	1	1	4	0	1	0	0	5	1	1	1	2	0	0	0	0	1	0	0	2	11	0	2	2	0	0	5	0	0	5	3	2	1	5	1	3	1	1	5	0	0	0	2	0	33	4	5	2	2	0	0	3	0	0	0	221	0	2	0	7	1	0	36	34	9	1	6	6	6	0	2	77	32	24	18	90	51	3	0	31	0	2	506	0	8	3	2	18	3	6	1	1	0	0	1	0	0	155	44	0	22	0	0	3	2	2	3	1	3	0	1	0	0	49	0	33	3	0	0	1	19	4	0	122	4	0	3	5	14	1	0	1	0	6	0	0	78	10	0	1	85	2	17	1	18	1	3	5	1	112	76	31	10	16	13	13	13	0	17	8	1	49	4	0	2	3	0	0	3	4	4	0	0	17	0	0	2	1	1	0	1	2	3	6	0	0	0	0	6	0	8	4	66	0	0	6	0	2	0	0	2	0	0	0	1	1	5	1	0	2	0	4	0	0	0	0	2	4	1	0	0	3	18	0	0	0	2	3	0	0	1	0	0	0	1	3	2	0	1	0	0	0	0	0	0	1	0	0	1	0	1	0	0	2	0	1	0	0	0	0	0	2	0	1	0	0	0	0	0	0	0	0	12	0	3	1	0	0	0	0	0	0	0	0	2	0	1	2	2	0	0	0	0	0	0	0	9	0	0	24	0	2	0	2	0	1	0	0	9	0	1	1	14	0	14	0	0	0	0	0	4	0	0	0	7	0	0	1	4	35	0	1	2	1	0	3	0	0	28	2	0	0	1	0	1	0	0	4	3	0	35	0	0	0	1	34	0	1	0	8	0	1	1	3	0	0	0	0	0	6	0	0	0	1	1	5	3	4	0	0	1	1	1	0	0	1	0	0	2	0	3	1	0	0	1	5	3	1	2	0	0	0	2	3	0	0	1	0	0	3	0	4	5	1	3	0	0	0	1	0	1	1	0	2	0	0	0	0	1	2	1	0	10	0	0	0	0	2	1	1	1	0	1	4	1	0	15	12	0	2	0	0	0	0	0	2	4	1	4	5	2	6	0	0	0	0	0	0	0	2	0	0	0	0	0	8	0	0	0	11	0	1	0	0	0	6	0	21	50	0	13	0	0	2	0	3	0	0	2	1	0	5	3	11	0	0	0	0	1	1	0	0	0	0	0	0	1	0	0	0	2	7	1	0	1	1	1	1	0	0	7	0	2	0	0	1	0	1	103	13	0	0	2	1	5	1	1	0	1	0	0	1	3	1	8	0	0	0	1	0	18	4	0	1	4	0	1	0	2	1	0	0	2	3	0	2	0	3	5	0	0	0	18	0	6	0	0	28	6	6	3	35	10	2	95	0	1	17	10	3	15	6	0	16	15	32	3	3	0	4	6	8	0	0	0	29	3	3	3	3	2	69	2	3	4	80	153	0	2	0	5	0	14	0	0	20	18	1	7	0	4	49	0	8	1	0	2	0	1	36	0	65	4	0	1	17	1	12	0	6	0	8	1	0	13	1	5	12	3	13	79	0	6	21	0	4	0	0	1	0	74	0	0	3	6	2	10	11	13	1	1	35	15	109	5	1	2	0	3	5	8	1	4	5	1	5	12	3	0	2	3	3	0	6	66	62	4	0	3	1	2	1	45	10	31	0	0	2	0	3	4	12	0	1	0	0	2	72	21	1	0	2	5	0	1	0	0	146	0	0	24	0	33	0	1	0	84	0	2	0	0	50	1	2	4	0	0	0	8	1	0	0	0	16	5	12	11	3	0	1	2	0	0	4	0	0	37	1	4	1	18	18	2	2	0	0	2	2	0	1	3	1	1	0	1	0	1	5	1	1	2	10	0	4	0	13	39	21	0	0	4	0	3	21	1	0	128	0	1	8	3	54	4	4	0	0	2	0	0	2	1	17	0	12	1	5	1	0	7	0	1	9	9	0	5	47	2	0	2	2	0	5	4	15	6	0	0	1	8	0	1	0	1	0	6	0	0	0	0	0	0	0	47	5	0	1	0	73	1	0	0	2	19	1	1	138	3	1	0	0	0	0	19	5	0	0	0	0	1	0	3	4	28	2	3	8	1	8	4	2	5	3	0	5	189	0	3	1	0	0	0	5	29	1	73	1	12	4	1	4	0	2	4	0	11	8	1	1	2	1	0	1	0	0	0	3	5	4	0	6	0	1	6	0	5	0	0	7	2	2	0	0	1	0	0	1	0	0	2	0	2	7	5	12	4	3	0	1	10	6	0	2	0	2	0	13	0	0	0	1	0	0	36	4	10	0	0	2	8	1	10	42	35	0	9	0	0	26	1	0	0	0	0	2	2	0	0	0	0	0	0	52	101	5	2	0	6	155	0	210	0	0	0	2	2	8	6	2	0	290	0	1	2	2	2	17	6	1	1	4	11	6	1	13	2	1	1	3	7	2	1	23	0	22	17	6	16	6	17	15	102	10	2	16	6	74	61	199	0	8	7	1	7	12	2	5	1	2	2	4	1	10	590	2	2	0	96	6	9	61	69	1	0	16	7	0	3	16	2	38	2	0	2	0	11	0	3	0	3	0	0	1	3	3	2	1	16	7	0	2	9	2	1	100	2	2	0	0	3	0	0	0	0	0	0	0	34	0	0	0	5	18	0	2	1	1	0	31	2	2	3	5	0	0	0	0	0	4	0	42	1	0	0	0	2	2	13	5	11	12	12	1	0	5	54	2	3	13	0	0	1	16	0	0	0	68	102	107	174	0	0	2	0	67	2	23	9	4	15	39	0	8	15	19	0	0	0	3	78	0	65	14	195	77	0	205	80	214	19	45	259	0	40	981	10	39	6	0	0	5	1	1	12	0	0	0	2	3	7	0	0	0	20	1	18	1	30	9	1	25	76	63	13	0	3	1	1	0	4	29	0	12	0	0	189	0	52	55	0	1	1	0	50	18	46	80	135	44	5	1	97	1	98	15	0	112	9	3	1	1	1	0	0	0	1	3	7	0	2	1	68	60	56	9	15	4	116	66	21	6	0	19	0	19	9	80	3	417	8	8	2	6	57	9	1	7	54	10	4	28	7	0	17	36	3	6	4	54	13	42	173	26	30	51	106	19	184	180	6	5	780	0	6	56	0	0	77	75	4	145	10	0	3	1	51	5	0	332	3	34	9	17	24	0	10	3	9	11	30	2	109	123	43	17	0	12	3	5	64	0	51	5	196	2	21	106	77	68	0	3	3	18	25	5	4	14	51	27	50	1	4	58	0	0	135	12	13	29	22	7	1	33	16	6	5	4	4	213	6	1	4	4	149	0	10	1	14	0	101	2	7	1	42	19	39	26	4	8	0	0	1	31	4	107	4	1	44	84	9	21	47	6	21	13	16	2	0	3	12	5	0	0	1	14	0	0	7	0	537	2	8	37	67	78	4	4	23	0	33	72	0	1	81	0	85	168	2	2	1	2	0	0	0	0	0	19	9	0	1	0	0	3	13	0	3	64	0	0	54	4	3	0	5	0	11	0	1	0	61	1	0	0	0	2	0	4	0	90	14	0	86	9	25	11	17	15	0	0	5	0	2	1	0	2	2	1	0	4	0	8	14	6	0	3	1	0	6	98	0	1	29	1	0	0	1	0	0	0	11	0	6	84	0	84	71	0	9	0	0	0	0	10	2	0	0	0	0	1	2	0	2	0	0	3	0	1	3	0	0	0	0	2	0	0	0	0	0	0	4	0	0	0	0	0	2	1	1	0	13	1	1	5	0	5	7	0	1	0	0	0	15	41	3	4	4	7	11	0	7	11	1	14	1	5	2	0	1	1	1	1	5	2	2	1	0	6	3	0	0	21	0	5	1	0	0	1	2	21	2	3	7	3	2	0	4	1	0	3	9	0	0	0	0	0	0	0	0	0	2	3	3	4	2	0	1	1	1	21	1	0	1	1	0	1	0	3	3	3	43	3	1	0	0	0	12	0	3	3	0	0	6	0	0	0	0	0	4	0	0	0	10	1	15	0	0	2	0	0	1	0	0	1	1	1	0	1	2	1	0	1	2	1	4	15	14	0	2	7	19	0	0	1	0	0	6	0	1	5	2	0	200	0	1	0	0	1	0	7	0	0	1	1	4	1	7	0	0	75	1	1	5	0	0	6	11	1	21	3	0	3	9	7	0	0	79	0	16	5	15	0	0	13	15	1	2	1	2	8	2	12	1	0	0	0	0	0	0	8	0	3	0	0	2	1	4	3	0	0	7	0	3	9	3	0	1	0	3	23	19	29	0	0	0	4	11	0	0	9	0	0	49	11	208	27	0	0	2	8	28	85	85	39	23	0	13	67	0	46	17	0	3	16	47	1	16	0	14	8	0	66	0	0	0	384	7	2	0	6	1	5	0	0	3	27	1	0	0	0	4	0	3	24	0	5	5	5	43	5	0	0	6	19	5	17	8	88	30	77	8	2	16	0	82	39	18	2	3	0	0	0	2	0	6	38	9	11	9	1	0	6	11	8	10	0	0	9	25	2	0	28	19	45	65	1	1	5	20	0	0	76	43	5	4	2	77	73	0	0	0	25	26	2	7	0	0	1	1	0	0	7	1	1	0	2	0	0	0	3	0	1	0	3	0	2	0	1	5	0	0	0	0	0	6	1	9	3	0	0	1	1	0	0	2	0	0	0	0	0	21	3	3	0	4	3	0	0	0	1	0	1	0	0	13	1	0	0	0	0	26	0	2	11
PHYLLO24	47757	3	2	2	164	791	72	0	140	2	1	40	24	0	205	0	1	6	0	1	3	2	0	7	29	3	0	11	3	17	2	0	4	24	4	22	26	0	2	0	0	1	1	0	7	0	0	0	0	3	14	2	25	76	159	2	439	2	5	0	13	0	3	4	22	112	2	13	12	0	3	0	0	3	2	2	3	3	0	2	0	0	186	124	63	49	1	27	0	9	0	69	28	75	21	12	52	3	72	0	0	270	1	124	0	63	120	0	14	8	5	0	28	19	0	27	9	16	0	0	44	10	42	10	10	183	38	72	13	9	5	2	0	4	6	6	0	151	8	6	13	51	49	5	3	40	6	12	13	22	2	1	4	8	1	1	1	0	58	48	37	0	5	76	3	51	78	69	15	22	3	20	13	6	3	8	0	6	14	0	21	6	15	4	3	15	46	1	0	7	0	13	0	1	0	7	9	52	0	0	19	6	0	29	10	32	0	33	3	2	52	8	22	0	213	288	0	33	4	30	9	7	29	17	110	6	95	52	36	5	78	9	7	16	4	0	12	0	27	4	15	11	68	28	2	6	0	12	42	15	0	1	78	8	61	0	4	7	79	1	0	4	2	0	2	0	16	28	20	4	12	6	17	0	9	7	2	6	0	35	94	23	25	8	78	90	7	2	44	3	46	0	2	1	39	6	57	0	0	8	0	9	149	6	0	2	2	47	35	64	103	12	18	2	7	10	0	33	2	28	0	45	6	2	7	1	1	2	9	1	0	32	0	0	4	0	0	0	5	8	57	14	0	71	117	3	5	0	22	8	9	2	6	16	73	1	17	45	8	12	7	47	3	6	0	0	23	37	8	31	0	25	20	25	2	20	44	21	13	93	25	17	11	7	2	8	158	101	17	3	256	0	0	1	31	2	11	16	364	0	19	6	68	0	369	56	2	0	19	15	83	76	2	0	0	6	0	2	4	13	103	39	1	0	37	8	19	75	229	0	2	3	0	0	3	19	88	6	7	12	117	1	44	17	21	90	31	33	65	0	8	56	59	28	87	35	20	370	28	10	2	0	2	0	4	7	3	0	3	0	1	1	4	0	3	1	1	5	11	1	51	8	0	9	4	0	1	0	3	7	2	2	5	1	17	0	0	1	0	0	0	1	0	0	0	3	4	2	1	4	2	8	0	0	30	118	82	10	76	28	7	287	10	49	54	1	76	0	43	4	0	0	8	0	14	11	31	6	50	81	6	28	1	28	24	77	33	17	0	4	4	14	10	12	40	2	1	30	49	30	14	17	2	46	16	0	1	0	0	30	6	6	0	54	13	4	66	15	0	29	0	3	12	6	23	5	5	15	16	20	6	2	10	0	0	0	4	0	0	1	1	0	26	54	2	13	1	0	2	1	0	0	44	0	15	14	7	3	51	0	13	0	3	0	1	0	2	0	0	10	0	0	12	0	17	52	7	0	0	17	2	5	24	1	43	0	0	2	4	0	7	16	229	16	13	0	6	6	1	8	48	3	1	0	0	8	74	0	50	3	25	1	8	20	140	3	9	85	24	0	28	40	12	60	10	13	0	2	26	11	2	3	43	0	0	0	15	2	10	0	0	4	23	1	1	0	19	4	2	17	0	33	53	11	22	24	44	10	68	282	14	1	2	50	12	0	0	1	1	39	13	3	0	0	0	5	32	0	5	0	7	9	10	2	21	0	0	13	4	0	30	32	19	31	13	29	0	10	25	0	7	13	10	51	18	10	8	22	5	28	0	13	0	21	14	12	0	3	17	1	45	10	2	0	1	2	8	0	0	0	6	7	0	20	48	1	9	0	0	1	5	18	24	7	6	6	2	0	3	9	10	0	40	7	25	3	13	3	33	11	0	6	13	23	10	13	0	3	1	0	1	0	1	0	0	4	0	0	2	0	27	2	15	19	0	0	23	3	12	6	14	1	2	0	0	0	25	26	0	2	14	5	6	0	0	0	0	12	0	13	2	3	29	18	3	11	21	0	0	2	2	3	3	1	4	42	9	10	7	1	5	1	27	0	7	0	1	0	1	18	10	3	0	0	0	1	0	3	1	4	9	5	3	47	25	17	7	0	101	0	0	0	2	7	13	25	5	0	3	0	0	0	1	4	1	10	0	7	8	5	2	1	4	8	18	2	0	42	1	8	0	17	0	45	9	1	1	7	0	0	83	1	19	1	0	17	0	9	6	3	0	8	0	0	0	1	0	1	28	19	2	107	0	0	0	1	50	27	0	23	0	8	1	2	11	0	0	2	15	0	4	0	1	2	2	0	12	48	2	0	38	0	4	0	24	2	0	0	5	4	27	0	0	0	6	10	31	42	22	25	0	0	0	0	3	6	0	10	1	0	0	0	0	12	0	0	61	0	0	7	0	0	0	20	10	0	2	7	55	0	1	47	1	3	0	6	11	1	1	46	47	1	14	0	7	2	3	0	10	5	11	16	5	20	36	6	7	23	10	7	11	2	0	1	0	0	27	0	19	18	92	45	4	29	46	26	19	4	38	20	0	12	71	14	121	18	22	7	0	12	30	0	6	55	2	31	72	2	2	26	25	20	1	3	0	2	0	2	2	36	5	31	11	26	29	24	17	3	110	3	0	3	44	0	14	3	15	1	1	50	5	1	3	0	20	16	0	49	0	2	1	4	0	5	0	0	6	4	0	3	0	9	0	0	4	5	0	12	19	2	13	1	0	6	9	0	19	0	5	0	7	5	12	6	1	0	0	16	0	5	18	19	2	7	0	8	0	0	0	88	1	2	7	40	12	0	0	7	6	17	5	0	0	1	0	0	0	3	0	4	0	0	6	20	0	2	8	0	3	4	9	0	3	0	16	16	1	36	3	0	3	0	9	14	0	0	0	0	11	3	20	0	0	21	80	0	9	0	0	0	0	3	2	2	0	1	0	3	0	0	1	0	0	0	0	10	0	3	0	0	0	0	4	3	0	0	0	2	0	0	5	15	5	0	0	2	5	3	0	30	0	0	0	6	27	2	0	0	3	0	1	0	8	58	0	4	0	1	1	8	0	5	10	0	27	0	0	12	0	0	3	0	0	0	0	0	1	0	0	9	2	28	17	64	4	12	0	21	0	0	0	6	8	0	62	3	0	0	0	0	1	0	2	1	0	0	0	0	1	0	0	0	0	0	0	0	2	0	3	3	0	2	1	28	5	1	0	7	0	0	4	3	8	0	11	0	6	2	0	0	20	6	0	7	0	0	5	18	0	31	0	0	1	1	1	0	0	10	0	0	9	0	0	1	0	1	3	4	7	30	0	0	0	0	0	62	0	0	6	0	0	0	56	3	9	4	4	0	0	15	3	0	0	0	2	0	0	4	0	0	0	2	1	21	2	29	0	0	0	7	32	0	0	1	0	0	0	0	0	1	17	0	21	8	14	4	5	0	0	0	5	36	1	0	0	3	3	0	15	0	0	0	49	1	0	0	3	0	2	1	0	0	0	0	0	0	0	0	0	0	14	0	0	6	48	22	1	0	0	0	0	62	6	0	4	0	2	3	0	0	0	9	30	3	15	21	31	3	6	5	0	3	2	5	2	0	6	3	2	1	72	2	2	17	8	1	1	3	3	0	4	18	0	8	14	13	0	2	0	1	0	3	10	19	1	3	1	0	4	0	0	10	8	11	15	22	17	0	4	0	0	0	0	0	0	30	3	7	0	0	2	13	9	0	10	7	7	4	0	15	14	1	0	0	0	1	36	8	7	0	1	25	0	10	526	0	19	2	3	0	13	0	13	43	18	2	0	1	9	7	7	14	2	0	16	4	0	11	25	2	3	27	15	3	12	13	9	5	3	0	0	22	3	7	0	2	0	2	10	0	2	10	5	5	1	2	0	6	0	3	0	3	0	2	1	6	7	1	2	0	5	29	9	1	6	5	2	8	4	6	8	5	7	0	3	7	9	28	16	2	11	5	1	0	1	4	4	1	16	0	2	0	2	0	8	0	0	11	107	1	0	0	6	3	2	15	0	4	0	5	6	13	2	8	1	14	2	6	5	13	0	0	23	15	7	9	1	53	0	7	0	7	5	3	1	17	26	31	0	0	10	1	2	5	5	21	0	0	2	5	6	4	0	30	55	28	0	0	24	9	53	0	3	6	0	4	23	1	0	12	11	60	121	124	13	13	18	97	79	4	0	117	71	20	45	31	66	115	41	0	5	9	0	0	1	5	0	9	0	28	48	59	6	19	0	19	76	24	1	1	36	0	11	63	1	52	2	0	0	1	0	37	35	16	4	0	12	12	0	0	64	0	74	0	1	0	0	10	57	6	1	17	12	42	61	0	49	48	47	21	7	0	0	20	19	1	0	0	31	35	60	25	0	13	14	5	0	1	0	0	53	19	0	34	1	0	0	0	67	0	24	4	1	14	0	6	16	0	0	20	0	0	0	0	0	7	3	0	58	7	0	1	26	0	1	0	0	0	4	11	2	0	0	0	0	0	0	0	0	0	0	0	2	1	0	22	0	0	0	5	6	3	1	3	2	9	0	0	17	0	0	12	1	0	12	29	3	1	0	3	0	0	9	0	0	2	0	1	0	0	0	0	1	4	17	1	0	1	7	0	21	0	7	14	13	19	3	0	0	0	54	0	0	0	0	2	2	14	123	19	0	0	0	0	0	0	2	3	0	0	1	0	1	13	1	2	12	8	5	5	0	11	0	4	10	5	1	0	0	1	7	0	0	1	7	0	3	0	0	0	0	4	0	0	1	17	0	0	0	0	0	2	2	0	10	23	1	0	0	0	0	0	4	0	0	0	0	0	0	4	17	0	0	0	5	0	2	0	4	3	11	8	10	4	0	4	2	9	1	1	0	0	0	0	0	12	2	0	4	5	0	16	2	0	1	2	0	0	29	3	0	0	0	0	0	1	12	0	0	0	0	4	95	0	1	0	2	1	0	14	3	0	0	1	0	0	2	14	0	0	0	2	0	6	0	0	19	0	1	0	1	24	35	7	6	10	0	5	5	0	0	0	1	10	49	21	20	0	0	0	271	0	41	2	3	2	0	37	0	28	1	23	20	13	8	0	0	0	0	0	0	2	0	2	0	0	66	0	0	0	0	0	0	1	9	17	4	4	3	0	3	0	2	7	0	0	0	35	14	4	0	2	4	0	8	1	0	7	3	10	0	0	0	3	0	16	5	1	2	0	3	0	0	5	4	15	2	6	0	2	11	0	0	1	0	6	1	0	23	5	3	0	3	0	0	1	17	0	0	0	2	0	0	2	2	0	1	0	0	0	1	0	9	0	0	1	0	0	0	0	3	0	0	5	1	3	1	1	16	6	26	24	10	24	1	0	0	0	56	0	4	24	23	0	0	0	32	20	0	1	0	0	2	1	28	10	11	13	3	25	0	0	0	2	3	2	3	0	1	0	35	1	1	0	11	3	4	2	0	0	1	18	3	4	0	0	7	4	22	17	0	7	0	0	0	1	1	14	1	3	4	1	0	10	0	5	0	2	5	0	2	0	0	2	3	0	0	2	3	2	0	0	0	4	1	0	0	1	0	0	0	1	2	7	0	0	4	0	0	3	0	0	0	0	0	0	0	15	1	6	5	0	0	2	4	2	0	0	0	5	2	3	1	0	0	0	0	1	0	0	1	0	2	1	2	0	17	2	9	0	2	0	0	2	3	0	1	2	5	1	1	0	2	7	9	3	36	16	31	6	0	6	31	0	9	0	0	3	0	2	0	13	20	8	3	0	2	9	0	13	0	1	1	0	0	0	0	5	64	0	8	5	0	0	0	10	1	0	0	0	0	0	0	0	8	1	0	0	0	0	0	2	1	0	0	0	0	5	0	0	0	13	2	1	0	0	0	0	0	0	10	1	0	148	1	0	0	3	0	0	0	0	2	0	0	30	0	0	17	1	2	8	0	0	0	0	14	2	0	5	0	2	0	2	3	18	0	0	0	0	0	11	2	0	0	14	0	0	0	0	0	0	1	9	0	0	0	0	0	0	0	0	8	0	3	0	0	0	0	5	0	3	1	2	0	0	0	0	1	0	2	0	0	0	0	12	3	4	1	8	0	18	0	0	0	0	0	0	0	0	6	0	5	1	1	1	0	0	1	0	0	0	7	1	0	0	4	5	0	3	1	0	1	4	0	0	0	4	3	0	0	3	0	0	10	1	3	2	7	2	3	0	0	7	0	0	7	1	0	2	0	1	2	0	0	0	0	6	18	0	6	0	1	0	0	0	0	3	0	0	6	3	0	0	0	5	7	2	5	0	10	3	1	13	1	2	2	0	1	2	0	1	0	2	10	0	23	1	5	0	3	1	9	49	0	11	0	2	5	3	0	2	3	6	6	0	1	0	0	4	1	0	0	6	19	1	2	0	0	3	8	6	39	0	1	0	3	1	3	3	0	0	7	5	3	3	6	0	0	8	1	0	0	0	0	21	4	2	0	1	0	9	0	5	7	0	0	0	36	0	0	1	5	0	0	0	0	0	0	0	0	1	0	0	0	0	6	0	0	0	1	0	1	3	0	0	1	5	19	0	0	0	0	0	1	3	3	0	4	0	1	0	0	1	4	2	1	0	0	0	0	0	0	0	0	1	1	0	2	1	0	2	23	66	33	12	0	16	11	2	0	60	46	46	0	50	0	0	0	2	0	0	0	0	0	0	0	0	44	2	0	0	8	0	39	0	0	0	0	20	0	0	0	0	0	0	3	0	0	0	0	0	0	1	0	4	0	0	0	21	1	1	0	0	0	0	0	1	21	0	83	0	0	1	2	1	0	0	0	0	0	0	0	1	0	1	2	2	7	0	0	0	23	1	0	0	0	0	1	1	0	0	0	0	0	0	0	0	0	0	0	0	0	20	0	0	0	0	3	44	4	0	0	0	0	0	0	76	1	1	7	0	4	0	0	0	0	59	0	0	0	0	0	0	0	0	0	0	0	49	0	0	13	0	0	0	0	0	0	0	0	0	1	2	2	0	0	0	0	0	6	10	0	0	0	3	8	2	0	5	0	10	0	4	11	6	11	0	0	0	0	11	2	2	2	1	0	0	6	49	5	3	7	0	0	1	0	1	1	1	2	46	50	0	47	1	0	0	0	0	0	5	0	0	4	0	0	0	0	0	0	0	3	0	0	0	0	0	3	7	0	0	3	1	0	0	1	1	0	1	0	0	6	0	2	1	0	2	10	4	0	0	0	2	2	0	0	0	0	4	0	0	2	0	2	3	0	1	3	2	0	0	1	0	0	1	0	7	7	0	5	1	0	3	0	0	0	0	2	0	17	0	0	0	2	1	0	3	1	2	13	5	4	17	0	0	0	0	0	3	0	12	18	3	17	2	18	49	1	9	4	43	6	0	0	0	3	0	7	23	2	0	0	0	28	8	12	8	23	0	4	2	0	13	0	5	0	2	0	0	5	1	0	0	0	1	2	3	0	4	0	0	1	0	1	0	13	0	0	2	0	0	0	0	0	1	2	4	0	0	0	0	2	3	43	0	14	0	12	0	0	0	0	0	0	0	1	2	0	5	10	0	0	9	1	4	2	0	1	0	1	0	0	0	2	0	45	0	11	4	0	12	1	0	0	5	0	0	0	0	19	11	0	0	2	0	0	0	8	0	0	0	17	1	0	0	0	0	0	0	0	0	3	3	81	38	0	8	0	2	1	6	0	0	0	1	0	0	0	2	5	0	0	1	0	0	10	0	0	0	0	0	1	9	1	0	0	6	1	0	0	24	22	1	1	0	0	0	6	0	0	3	0	16	16	0	0	0	0	0	1	0	0	1	0	1	0	4	5	0	2	0	1	0	0	2	1	31	0	0	4	0	0	1	1	0	0	0	1	26	0	0	0	11	4	0	0	0	4	0	3	5	2	0	0	1	0	0	0	45	0	0	0	0	0	10	2	1	0	0	0	0	2	1	0	0	0	0	0	0	0	0	1	3	0	0	1	3	0	12	0	0	15	3	12	0	1	2	12	17	0	8	3	4	6	0	16	0	0	2	0	0	2	7	0	0	0	5	1	0	0	2	0	0	3	1	2	0	1	0	0	0	4	0	0	7	0	0	0	0	16	3	2	0	0	0	3	0	0	0	0	0	5	2	0	0	1	1	0	1	4	3	2	0	0	1	4	0	0	0	0	0	5	8	0	0	0	0	0	0	16	2	1	5	0	0	0	0	10	6	3	3	2	3	1	0	0	2	0	0	0	0	38	8	4	0	0	0	0	0	3	0	0	0	0	2	2	1	1	0	0	0	1	0	1	0	0	1	36	38	0	2	4	0	0	0	14	0	0	0	1	0	0	1	1	0	1	0	0	1	2	0	1	0	0	0	1	0	0	0	0	4	6	0	0	0	1	0	0	0	1	7	0	0	0	2	0	0	0	1	9	0	0	0	4	0	0	0	0	0	0	0	0	4	4	0	3	2	0	0	0	1	2	2	0	0	1	2	0	27	0	0	22	4	0	0	0	0	0	43	0	0	18	0	7	1	2	8	2	0	2	2	0	1	0	6	2	0	0	0	0	16	8	0	0	1	0	20	13	0	0	0	0	0	3	0	1	4	0	5	4	0	0	0	1	0	1	0	1	1	0	0	0	0	1	0	0	0	2	0	4	0	0	0	0	1	9	3	17	0	1	0	1	0	1	1	1	0	0	0	0	0	30	6	0	2	6	0	0	2	0	0	0	0	5	2	0	0	0	0	16	0	1	0	0	0	4	0	2	0	12	13	0	6	0	0	0	0	20	0	0	5	0	0	1	21	3	0	0	1	3	0	0	21	2	0	0	0	0	0	0	0	3	0	0	0	1	0	1	1	0	0	1	4	0	2	7	1	0	1	28	0	8	0	8	0	3	7	33	13	2	1	2	3	0	0	0	1	0	4	0	0	0	0	0	0	1	0	1	0	0	0	0	0	0	0	1	0	0	0	3	0	0	0	0	2	0	1	0	0	0	1	1	1	0	0	1	1	0	0	1	0	0	2	1	0	0	0	0	5	0	0	2	0	10	4	2	0	16	7	0	0	0	1	0	0	0	3	8	4	0	0	0	3	11	0	0	0	0	0	0	5	0	1	0	2	0	3	3	2	2	0	0	0	0	1	0	0	0	0	2	0	2	2	3	0	0	2	0	2	4	0	1	0	0	5	0	0	1	13	0	1	0	12	0	0	0	1	1	2	0	0	0	0	0	2	0	1	0	0	1	0	8	0	0	0	4	0	0	8	4	0	0	0	3	0	0	0	7	11	0	3	1	3	0	0	0	4	1	10	1	0	0	10	0	43	0	0	0	0	0	0	2	0	0	0	2	0	0	0	0	0	2	3	0	0	0	1	0	0	0	1	0	0	1	0	2	0	0	3	0	0	0	0	0	0	4	0	0	1	0	2	6	0	0	2	1	0	4	0	1	0	0	0	0	0	0	0	0	0	2	2	0	2	0	0	1	0	0	0	0	0	0	0	0	0	4	1	0	0	0	0	0	0	0	2	0	0	11	0	0	1	0	2	14	11	0	0	6	0	2	2	0	0	3	4	15	11	7	0	0	0	2	0	2	1	5	0	11	0	1	0	30	30	2	14	6	0	0	0	0	0	12	2	0	0	7	0	1	0	0	0	0	0	30	0	0	0	0	0	2	0	0	19	0	2	0	0	1	6	0	1	0	1	0	0	6	1	1	1	1	0	0	0	0	0	0	0	0	0	0	0	0	0	0	0	0	0	0	2	1	0	0	0	0	0	6	0	17	0	3	0	2	20	0	17	2	20	0	0	0	33	0	0	27	2	4	11	6	6	2	0	84	0	449	11	6	10	12	3	0	0	0	0	2	14	20	0	0	0	4	401	0	34	1	29	0	4	100	6	1	19	36	23	19	22	68	0	0	4	0	2	0	3	2	3	0	0	0	1	0	0	7	0	1	0	0	0	0	0	0	0	3	0	0	5	0	0	0	0	6	5	0	2	0	0	0	0	0	0	7	0	0	0	0	5	0	0	0	0	2	0	0	0	5	0	0	0	0	0	0	21	0	0	0	0	1	0	0	1	4	0	0	13	1	2	1	0	2	0	6	0	0	3	1	1	0	0	0	0	0	0	0	0	0	0	0	13	8	0	0	0	0	0	0	0	0	0	2	0	20	0	7	0	62	1	1	4	8	1	7	0	0	0	2	10	176	15	3	24	0	0	1	1	0	2	0	10	0	2	4	1	0	19	0	6	2	21	0	2	2	11	0	0	0	0	0	4	0	0	0	0	1	0	0	0	0	0	0	2	0	0	33	2	0	0	1	2	0	4	0	0	0	0	0	0	4	0	0	0	0	0	0	1	0	0	2	21	7	0	0	4	0	2	0	0	1	16	0	0	5	0	0	0	0	0	0	0	0	1	0	3	5	121	12	5	0	12	67	124	0	5	3	0	0	8	1	3	17	0	6	17	1	30	25	0	0	2	0	0	0	1	5	11	0	0	1	0	0	0	4	1	0	0	0	0	0	0	0	0	0	12	0	0	1	2	9	0	10	0	3	2	41	0	8	1	16	0	18	3	2	3	71	1	0	0	0	0	0	1	0	0	14	5	0	0	0	0	1	3	5	2	0	0	2	0	0	2	0	0	0	0	35	2	1	0	0	2	0	0	0	0	2	0	0	0	0	1	0	9	3	0	0	5	5	0	8	98	78	0	32	1	0	0	17	0	11	7	4	3	3	7	4	0	2	0	0	2	0	0	0	0	0	0	0	19	11	6	14	0	12	19	0	0	0	0	0	2	0	1	0	0	0	0	6	0	0	2	0	25	3	2	10	3	10	5	0	0	1	10	0	13	14	10	12	0	0	0	0	0	0	0	0	0	0	0	0	0	1	0	0	0	0	0	0	0	0	0	0	0	0	0	1	0	0	0	0	0	0	0	0	1	0	0	0	0	0	0	0	0	0	0	0	0	0	2	0	0	0	0	0	1	0	2	0	0	0	0	0	0	0	0	0	1	0	0	0	0	0	0	0	0	0	22	0	0	0	4	11	2	15	16	0	0	0	7	0	0	0	1	0	0	0	0	0	0	0	8	0	0	1	0	4	2	0	0	3	2	2	1	0	0	0	0	0	0	5	0	0	0	0	0	4	1	1	2	0	0	4	0	0	0	2	0	0	0	0	1	0	1	4	0	0	0	0	3	0	0	0	1	0	0	0	0	0	0	4	10	0	0	0	0	0	0	0	0	0	0	0	1	0	0	0	2	0	0	0	0	1	1	0	0	0	0	0	0	2	0	0	0	0	0	0	0	0	0	0	0	0	0	7	0	1	1	0	0	1	0	0	2	3	0	1	1	0	1	0	3	12	0	0	0	0	5	1	0	0	0	3	5	0	2	0	0	6	0	2	0	0	0	0	0	0	2	1	0	0	0	0	0	0	0	6	0	0	0	0	0	0	0	0	0	3	3	0	4	0	29	0	0	0	0	0	0	0	0	2	3	1	1	0	0	0	0	0	0	2	0	0	0	0	2	0	0	2	1	0	0	2	4	0	7	0	0	3	0	1	1	0	7	2	0	0	1	9	0	0	0	0	0	1	0	0	0	2	0	0	0	0	0	0	0	0	0	0	0	0	3	0	0	0	2	0	0	0	0	0	6	1	0	0	0	0	7	5	0	0	0	0	1	3	6	4	0	0	0	0	0	7	0	0	4	0	0	0	2	0	2	16	0	14	0	38	17	2	1	26	0	0	1	0	0	1	4	1	6	1	0	0	0	0	0	0	0	0	0	0	5	5	1	0	0	4	0	10	0	5	6	0	0	1	2	0	0	9	17	0	0	0	1	26	1	0	0	0	1	0	1	0	0	0	0	1	9	1	0	0	0	0	0	0	0	0	0	0	0	0	0	0	0	0	0	10	0	0	0	0	0	0	0	0	1	0	0	0	0	0	0	0	2	0	0	0	1	0	2	0	0	0	0	0	0	0	0	1	0	0	0	0	0	0	0	0	0	0	0	0	0	5	0	0	0	0	0	0	0	0	0	0	1	1	2	0	1	0	0	0	0	0	0	1	0	0	0	0	0	0	0	0	0	0	0	0	0	0	0	0	3	1	1	0	0	10	0	3	0	0	0	0	7	0	0	0	0	3	1	3	0	1	0	2	3	0	0	0	0	0	0	0	0	0	0	0	0	0	0	0	1	0	0	1	0	0	0	0	0	0	0	0	0	0	0	0	0	0	0	0	0	1	0	1	0	0	2	2	0	0	0	0	2	0	4	0	1	4	0	1	0	0	0	1	0	2	8	1	6	4	0	0	0	0	0	0	0	0	3	0	0	0	5	0	0	0	0	2	0	0	0	2	0	0	0	0	6	0	0	6	3	5	0	0	0	1	0	9	0	1	0	0	0	2	0	1	0	0	0	0	0	0	0	0	0	1	0	0	0	1	0	0	0	0	0	2	10	0	0	0	0	0	0	7	1	1	0	0	0	1	1	0	0	4	0	2	0	0	3	0	0	0	4	0	0	0	1	0	0	0	0	0	0	1	0	0	0	2	1	0	0	1	0	0	0	0	0	0	0	0	0	0	2	0	0	0	0	2	0	0	0	0	0	0	4	0	35	2	2	3	3	0	0	1	0	2	0	0	0	1	19	0	2	0	0	4	1	0	2	0	11	0	0	0	0	2	0	2	0	0	5	2	0	5	3	0	0	1	2	1	3	22	0	0	1	0	0	0	0	0	0	0	0	0	2	0	0	0	0	0	0	0	0	0	0	0	0	0	0	0	0	0	0	0	2	0	0	0	1	0	0	0	9	0	0	0	0	1	0	0	1	0	0	0	0	0	0	1	0	0	0	0	0	0	0	0	0	0	0	0	1	0	0	0	0	0	1	0	0	1	2	0	0	1	0	2	2	0	1	1	0	0	0	0	4	0	0	0	0	0	0	0	0	0	1	50	0	0	0	0	0	2	7	13	1	0	2	2	2	0	0	17	11	5	8	21	10	0	0	10	0	0	91	1	0	0	4	0	0	11	0	0	1	0	0	0	0	34	7	0	0	0	1	1	1	0	0	0	1	0	0	0	0	8	0	8	0	0	0	0	4	0	0	27	0	0	0	0	0	0	0	0	0	1	0	0	15	0	0	0	6	0	5	0	4	0	0	0	0	32	12	0	1	2	0	0	0	0	3	0	0	4	1	0	0	1	0	0	1	1	0	0	0	0	0	0	0	1	0	0	1	0	2	2	0	0	0	0	0	0	0	0	12	0	0	0	0	0	0	0	0	0	0	0	0	0	0	0	0	0	0	0	1	0	0	0	0	0	0	0	0	0	4	0	0	0	0	0	0	0	5	0	1	2	0	1	1	0	1	3	0	0	0	0	0	1	0	0	0	1	0	0	0	0	0	5	0	0	0	0	2	0	0	0	0	0	0	0	0	0	0	0	6	0	0	0	0	0	0	2	0	0	0	0	0	0	0	1	0	0	0	0	0	0	0	0	0	0	1	0	0	1	0	0	0	1	0	0	1	0	0	0	2	4	0	0	0	0	1	0	0	1	0	0	0	0	0	0	0	2	0	0	0	1	0	0	0	0	6	0	0	0	0	0	1	0	0	1	1	0	5	0	0	0	0	7	0	0	0	2	0	2	0	0	0	0	0	0	0	4	0	0	1	0	0	1	2	2	0	0	1	0	0	0	0	0	0	0	0	4	0	0	0	0	0	0	0	0	0	0	0	0	0	0	0	0	0	0	0	1	0	0	0	0	0	0	0	1	0	0	0	0	0	0	0	0	0	1	1	0	0	0	0	0	0	1	0	0	0	2	0	0	0	1	0	0	1	0	0	0	0	0	0	0	0	0	4	0	0	2	1	0	0	0	0	0	0	0	0	0	0	0	0	0	0	0	0	0	0	0	0	0	0	0	0	0	1	8	14	0	2	6	0	0	0	0	1	0	0	0	0	3	0	1	0	0	0	0	0	2	0	1	0	0	0	0	0	0	1	0	0	0	0	0	0	0	0	0	0	0	0	0	1	0	0	0	0	0	6	0	0	0	0	0	1	0	0	2	0	0	1	0	0	0	1	0	0	0	0	0	2	0	0	0	0	0	0	0	0	0	0	0	2	0	0	0	0	0	1	0	0	5	4	0	1	0	0	7	2	2	0	2	11	0	13	0	0	0	0	0	0	0	1	5	5	6	0	0	1	0	4	3	0	0	0	2	0	0	0	0	1	18	0	0	0	19	44	0	0	0	4	1	3	0	0	3	0	0	2	0	1	15	0	0	0	0	0	0	0	5	0	15	4	0	0	2	0	3	0	1	1	4	0	0	2	0	5	0	0	1	6	0	0	3	0	3	0	0	0	0	10	0	0	0	3	0	6	7	4	0	0	4	0	27	0	0	0	0	0	0	1	0	0	0	1	2	0	2	0	0	2	0	0	4	30	16	0	0	0	1	0	0	2	0	0	0	0	0	0	0	0	3	0	0	1	0	0	18	8	0	0	1	1	0	2	0	0	23	0	0	1	0	8	0	0	0	13	0	0	1	0	5	3	0	0	0	0	0	1	0	0	0	0	6	0	0	0	0	1	0	0	0	0	1	0	0	0	0	1	0	0	0	1	2	0	0	0	1	0	1	0	0	0	0	1	0	0	4	0	0	0	2	0	0	0	0	16	1	0	1	0	1	0	0	0	0	15	0	0	4	0	11	1	0	0	0	0	0	0	0	0	6	0	7	0	1	0	0	2	0	0	2	2	0	0	29	0	0	0	0	2	0	0	0	1	0	0	0	0	0	0	0	1	0	0	0	0	2	0	0	0	1	4	0	0	0	0	2	0	0	0	0	0	1	0	23	2	2	0	0	0	0	0	0	0	0	0	2	1	0	2	1	7	0	0	2	0	2	1	0	0	0	0	0	32	1	4	1	0	0	4	1	1	0	10	0	0	0	1	0	0	1	0	0	7	2	0	0	0	1	0	0	0	1	0	2	4	0	1	0	0	0	4	0	0	0	0	0	0	1	0	0	0	0	0	0	0	0	0	0	2	4	0	0	5	0	0	1	3	0	3	0	0	0	0	6	0	0	0	0	0	0	7	3	2	0	0	2	0	0	2	4	5	0	6	0	0	4	0	0	0	0	0	0	0	1	0	0	0	0	0	8	11	0	2	0	0	32	0	36	2	0	0	1	0	1	0	0	0	65	0	1	0	2	0	2	0	0	2	0	4	0	0	1	3	0	0	0	14	0	0	3	0	2	0	4	11	11	15	15	22	1	0	7	4	6	14	32	1	1	0	1	0	3	0	0	0	0	0	0	1	2	114	0	0	0	19	0	0	10	20	0	0	5	1	0	0	1	0	9	0	0	0	0	2	0	0	1	1	0	0	0	0	0	0	0	2	1	2	0	3	0	2	22	0	0	0	0	0	0	0	1	0	0	0	0	5	0	0	0	0	2	0	0	0	0	0	4	2	2	0	0	0	0	0	0	0	0	0	0	0	0	0	0	0	0	9	0	9	0	4	0	0	0	29	2	0	0	0	0	1	0	0	0	0	12	32	40	34	0	0	0	0	15	0	2	0	1	2	20	0	1	16	0	0	2	0	7	8	0	5	6	59	9	0	35	25	42	4	2	46	1	11	206	2	8	1	0	0	0	1	1	3	0	0	0	0	1	4	0	0	0	4	0	4	0	14	1	0	9	13	17	3	0	2	0	0	0	0	2	1	3	0	0	34	3	18	6	0	0	0	0	12	0	9	20	19	9	0	0	20	0	30	0	0	39	0	2	0	1	0	0	0	0	0	0	0	0	0	0	43	10	14	2	1	0	14	7	5	2	0	2	0	3	0	19	0	91	0	0	0	0	14	5	0	3	16	0	0	5	1	2	0	9	0	0	2	8	0	12	50	2	15	19	25	4	41	54	0	1	153	0	1	11	0	0	32	11	1	17	1	0	0	0	1	0	0	50	0	1	2	4	4	0	2	2	6	3	10	0	21	37	21	1	0	1	1	0	8	0	8	6	37	0	2	18	11	8	0	0	0	2	4	1	0	10	8	0	7	0	0	1	0	0	20	4	1	2	0	0	0	6	0	0	4	0	0	45	0	0	1	0	27	0	3	0	1	0	14	0	2	1	4	1	8	5	0	0	0	0	0	2	0	26	0	1	6	22	3	6	12	1	6	3	1	1	0	3	1	0	0	0	0	6	0	0	0	0	37	0	4	2	23	16	4	0	2	0	7	6	0	0	3	0	38	58	1	1	0	1	0	0	0	0	0	3	0	0	1	0	0	4	3	0	0	12	1	0	12	2	0	0	0	0	0	0	0	0	9	0	0	0	0	0	1	0	0	30	1	0	9	1	12	0	1	1	0	0	0	0	0	0	0	0	0	0	0	0	0	2	0	2	0	0	0	0	0	16	0	0	5	0	0	0	0	0	0	0	3	0	1	17	0	30	23	0	0	0	0	0	0	4	1	0	0	0	0	0	0	1	0	0	1	0	0	0	0	0	0	0	0	2	0	0	0	0	0	0	1	0	0	0	0	0	3	1	0	0	0	1	0	0	0	0	4	0	0	0	0	0	1	12	0	0	0	0	0	0	0	0	0	0	1	0	0	0	0	0	0	0	0	0	0	0	0	0	0	0	0	2	0	0	0	0	1	0	0	0	0	1	0	0	0	0	0	0	0	0	2	0	0	0	0	0	0	0	0	0	1	1	0	1	1	0	0	0	0	4	0	0	0	0	0	0	0	2	0	2	8	2	0	0	0	0	2	1	0	0	0	0	1	0	0	0	0	0	1	0	0	0	0	0	0	0	0	0	0	0	0	0	0	1	0	0	0	0	0	0	0	0	0	0	0	4	2	0	1	2	2	0	0	0	0	0	0	0	0	5	0	0	26	0	0	0	0	1	0	5	0	0	0	2	0	0	1	0	0	18	0	0	0	0	0	1	0	0	1	0	0	0	1	1	0	0	2	0	3	0	0	0	0	2	4	0	0	0	0	0	1	3	0	0	0	0	0	0	0	0	0	1	0	0	0	0	0	0	0	0	0	0	1	2	0	0	0	0	0	0	0	4	0	0	0	0	1	0	0	9	0	0	7	0	38	5	0	0	1	0	2	6	6	2	5	0	0	7	0	11	2	0	0	2	4	0	3	0	2	0	0	12	0	0	0	65	3	2	0	2	3	0	0	0	0	2	0	2	2	0	2	2	0	3	0	0	0	0	2	0	0	0	0	1	1	0	2	22	8	20	0	2	0	2	10	6	5	0	1	0	0	0	0	0	0	9	1	5	1	0	0	0	0	0	7	0	0	1	5	1	0	15	4	7	8	0	1	0	4	0	0	11	5	0	0	0	27	19	0	0	0	6	6	0	0	0	2	0	1	0	0	1	0	0	0	0	0	1	0	0	0	0	0	0	0	0	0	0	0	0	0	0	0	0	2	0	0	1	0	0	1	0	0	0	0	0	0	2	0	0	0	0	0	0	0	0	0	0	0	0	0	1	2	1	0	0	0	6	0	0	1	0	9	0
PHYLLO25	164516	0	0	0	631	2593	265	0	651	5	13	149	134	0	578	4	0	19	0	12	31	2	5	7	122	12	1	58	24	74	17	0	16	45	11	80	97	0	2	0	0	0	0	0	28	0	0	0	0	24	2	0	115	281	474	8	1559	23	22	2	136	1	11	25	73	363	0	39	10	0	36	26	0	0	14	10	18	0	0	2	0	0	659	389	165	196	0	128	3	48	2	292	124	295	86	56	163	24	242	2	2	892	7	475	6	229	395	5	56	49	13	1	76	62	2	122	42	45	0	2	250	70	171	27	53	554	126	256	45	38	25	17	3	16	25	15	3	726	143	33	51	184	198	20	9	138	35	4	60	103	9	4	4	36	4	1	3	11	156	139	114	0	18	262	13	176	227	197	64	78	6	57	50	26	19	25	1	17	54	8	65	23	78	26	23	26	104	0	0	12	13	50	3	0	0	12	51	271	4	5	41	20	7	95	19	75	1	113	7	8	206	34	74	0	820	1178	2	112	2	79	63	30	112	50	385	23	284	175	125	28	229	25	16	70	3	3	47	0	146	8	59	37	231	72	6	22	1	27	140	33	0	5	224	10	216	2	22	27	230	13	2	21	8	0	14	6	75	82	75	29	65	30	76	3	40	11	1	53	0	137	223	32	75	43	312	278	26	7	79	11	138	0	1	6	151	16	274	0	17	44	2	48	413	37	1	6	7	135	102	213	358	31	44	19	5	36	0	163	6	82	1	128	29	9	5	12	3	14	34	4	0	80	0	0	23	2	2	6	0	32	248	38	15	223	402	36	5	6	99	16	29	16	40	46	243	4	59	101	20	48	68	63	25	31	0	2	86	164	34	126	1	75	58	60	16	70	171	53	30	277	90	91	31	52	18	20	384	256	55	12	911	0	4	9	7	11	0	58	1348	1	69	15	219	0	1104	155	0	0	43	77	264	317	5	0	2	9	7	3	10	73	330	84	1	0	166	5	111	186	658	4	9	15	3	1	2	103	360	17	20	52	464	7	93	73	100	315	126	86	205	4	35	188	235	79	223	85	43	1174	80	52	4	0	2	0	0	0	2	1	6	7	9	6	8	3	9	8	8	15	9	4	233	32	7	28	19	3	1	1	15	37	1	0	15	2	62	0	1	5	0	1	0	6	2	0	0	2	7	11	0	32	4	27	0	2	121	438	231	34	229	56	48	826	61	171	226	15	342	0	149	32	1	17	32	0	70	66	111	28	151	222	12	105	8	53	123	242	97	29	2	18	9	49	29	37	76	22	15	81	170	174	48	72	16	154	51	11	1	0	0	68	28	44	0	127	68	9	291	60	0	74	0	9	37	32	41	4	23	90	33	80	28	5	43	13	0	1	9	6	2	2	0	2	82	169	6	25	40	3	3	8	3	2	161	0	24	42	59	3	110	4	52	0	3	1	6	8	2	3	0	24	0	3	42	1	62	183	41	0	0	47	1	26	89	0	126	13	0	18	9	0	29	47	715	42	30	0	30	51	0	45	222	13	9	3	9	24	208	13	204	9	41	0	41	118	362	21	32	208	97	3	93	195	66	145	51	48	0	3	109	70	19	23	173	0	0	0	41	2	37	2	0	29	55	3	2	2	57	6	36	49	1	117	118	57	71	125	143	61	233	769	56	4	2	195	42	1	3	11	6	100	46	5	2	6	0	25	75	0	21	0	14	45	18	12	50	0	9	45	18	6	74	184	67	87	45	153	0	65	108	0	24	26	31	145	86	27	16	104	40	58	0	55	0	81	41	48	2	18	30	7	114	35	17	0	8	3	16	0	0	0	0	9	0	83	193	2	14	1	0	19	26	63	76	51	33	12	11	1	2	21	9	1	142	32	80	17	40	4	126	23	0	10	73	96	18	37	1	3	6	0	3	1	18	1	1	11	7	3	0	0	85	6	52	33	1	4	63	7	58	34	34	19	6	4	0	0	82	54	1	5	46	19	18	10	0	0	0	33	0	47	6	7	66	45	23	28	43	0	2	3	15	5	17	3	15	154	18	23	70	8	23	3	67	2	40	4	11	2	11	35	25	7	0	0	0	11	0	10	5	31	24	11	22	165	41	36	40	0	301	1	14	0	6	30	31	45	1	1	7	0	2	0	0	12	5	41	1	25	27	38	22	8	8	16	29	2	2	124	4	52	0	39	15	116	23	10	2	17	2	0	370	3	60	2	1	32	6	11	21	0	5	15	0	0	1	7	6	0	121	61	21	418	1	0	0	22	180	71	0	49	20	13	5	2	0	0	1	1	77	5	12	1	6	7	0	0	61	188	27	0	136	4	29	0	50	17	0	0	14	3	137	3	2	2	16	45	113	158	90	101	10	1	5	3	6	24	0	47	9	0	0	0	0	57	1	0	154	2	1	43	0	0	6	68	38	1	26	29	119	0	8	180	1	2	3	13	68	12	4	167	210	7	73	1	8	22	20	7	53	28	40	73	32	26	114	56	23	108	65	13	17	5	0	15	7	0	92	0	72	49	274	144	44	85	158	69	47	40	126	53	0	25	239	39	327	52	73	86	2	48	106	1	18	179	2	124	257	1	7	89	79	91	5	18	0	22	1	0	3	39	21	127	49	83	79	77	62	20	261	17	2	22	134	11	41	14	86	0	12	185	33	2	12	3	71	56	0	152	0	24	8	51	0	20	0	2	53	17	0	9	0	21	1	1	27	24	0	33	58	4	32	1	11	20	29	0	47	1	9	1	18	24	32	23	7	1	3	118	3	28	77	66	10	68	0	21	6	0	0	295	4	0	10	121	50	0	8	23	29	24	4	0	0	0	1	0	0	18	4	16	1	0	21	43	2	27	15	1	9	5	44	2	46	1	53	65	9	100	16	0	16	0	39	43	4	1	0	1	39	39	79	0	8	63	246	6	38	0	1	0	0	10	2	8	2	24	0	12	11	3	6	0	9	1	0	55	1	7	0	2	1	5	31	24	2	2	3	5	5	4	12	30	36	7	0	2	4	18	3	70	1	0	1	17	147	14	0	1	6	1	6	2	48	276	2	13	0	1	2	9	0	15	27	2	86	9	2	47	1	0	3	0	0	0	0	0	5	3	0	22	7	56	84	234	10	41	0	62	0	2	2	19	42	4	181	4	1	0	0	0	5	14	2	13	0	1	0	3	0	0	0	0	0	0	0	0	10	1	24	16	1	8	0	90	6	4	3	18	0	0	6	15	9	0	44	12	8	8	0	1	69	18	1	7	2	0	32	29	0	68	0	0	5	12	3	12	2	27	1	3	13	9	0	4	8	6	29	9	28	87	4	0	0	13	9	206	0	4	18	8	0	0	204	14	29	25	3	0	0	47	10	5	6	0	0	1	1	5	2	1	2	0	2	118	4	68	2	0	3	15	39	5	1	12	0	0	1	3	1	0	29	1	51	23	49	14	28	4	0	8	8	114	1	6	2	22	20	5	50	5	1	1	178	12	5	0	5	1	0	8	1	0	0	0	0	1	1	0	0	0	47	0	0	7	215	81	0	0	0	0	0	196	34	2	2	0	4	0	1	5	0	16	89	20	34	39	113	31	30	14	4	6	15	12	20	0	44	11	7	4	137	10	7	69	31	2	5	20	11	0	8	70	0	47	36	45	1	16	0	4	1	7	21	45	21	13	3	1	33	0	1	37	36	37	60	38	32	1	4	0	0	17	6	27	0	125	30	26	2	4	8	67	22	3	17	17	5	2	0	41	63	10	1	3	4	5	68	25	19	4	16	98	0	10	1855	0	47	13	6	9	16	9	33	115	53	9	20	0	23	40	22	29	3	0	55	14	6	24	124	1	6	71	44	12	62	17	15	20	4	1	5	132	2	13	1	13	0	9	14	4	4	35	24	9	32	6	8	7	1	14	0	1	0	8	5	20	29	6	4	0	9	139	26	1	26	3	2	12	16	13	29	32	14	8	15	44	19	69	29	6	42	8	10	2	5	18	10	12	59	18	2	0	1	6	29	1	2	41	278	0	0	5	9	6	7	21	0	1	4	26	22	37	6	35	5	33	8	11	8	62	5	0	69	22	11	8	15	165	1	12	1	50	20	11	0	47	61	89	0	23	73	8	3	27	27	103	2	0	6	21	20	20	1	172	144	121	1	16	75	16	159	2	3	23	9	10	74	0	3	38	38	204	412	409	37	37	63	284	237	24	0	395	247	59	144	77	211	392	164	0	41	69	2	0	0	13	12	32	2	97	190	162	15	79	0	123	262	72	4	5	107	0	16	234	0	153	0	0	0	2	1	104	124	43	9	1	47	45	4	2	184	7	241	6	4	0	0	28	198	24	9	74	36	134	202	0	134	131	127	86	32	6	1	50	62	15	0	4	108	116	210	60	3	54	36	71	2	6	7	2	140	40	21	128	3	0	2	1	194	0	59	13	4	31	0	14	58	1	0	61	0	0	0	0	0	33	11	0	189	34	0	1	121	0	3	0	0	0	2	51	3	2	1	1	2	0	0	2	0	1	0	0	14	4	1	48	0	0	0	19	35	19	3	24	6	28	1	0	17	5	0	31	10	0	55	75	16	7	3	3	0	22	18	0	0	8	0	2	14	0	2	0	7	21	43	2	3	9	48	15	80	0	3	47	54	71	18	7	0	2	241	0	0	0	1	7	7	83	574	56	0	10	5	1	0	1	5	41	0	1	6	1	1	49	1	17	16	18	15	24	0	84	5	5	44	47	10	1	0	5	16	1	7	0	21	2	7	0	1	0	3	22	0	2	22	14	0	1	0	1	0	0	10	0	37	36	8	5	0	0	0	0	30	0	2	3	0	0	0	38	58	2	0	0	8	3	6	5	31	17	42	35	17	36	2	35	15	36	7	3	0	0	0	1	1	63	4	0	15	29	4	81	27	1	1	0	0	0	133	3	0	3	0	0	2	4	4	5	0	2	1	7	207	3	25	4	0	0	1	44	17	1	1	5	1	0	0	50	0	0	0	25	0	20	1	6	46	3	8	11	14	85	73	32	24	34	4	30	30	8	8	0	13	22	115	113	83	10	10	11	898	1	144	6	19	1	10	100	1	90	6	59	56	65	38	0	0	0	0	1	0	2	0	10	0	0	141	3	0	8	1	0	4	3	20	37	12	2	19	2	17	0	5	18	0	0	4	98	116	13	4	0	15	2	8	3	7	11	0	16	17	0	0	1	0	57	6	10	1	0	5	7	1	0	8	14	1	8	0	5	13	2	0	0	0	8	13	0	67	21	16	2	21	0	3	1	46	0	0	0	16	4	1	3	9	0	1	0	0	18	3	1	22	0	1	1	0	0	0	1	17	2	0	13	21	19	9	5	72	31	50	40	82	43	4	7	0	0	142	0	21	122	118	0	0	3	122	102	4	1	2	2	25	2	79	19	36	49	15	108	4	0	0	17	15	8	13	0	7	2	138	2	9	0	28	3	15	4	0	1	7	64	12	14	0	0	39	14	78	60	2	7	2	1	1	2	2	27	6	15	1	5	2	27	0	31	0	7	25	1	11	1	0	4	6	1	2	1	4	3	0	0	2	10	1	1	7	0	0	1	0	17	1	23	0	2	25	0	3	24	4	1	1	6	5	1	0	55	7	6	17	3	0	15	3	9	1	6	1	22	5	1	23	6	0	0	0	1	0	0	3	2	12	0	5	2	30	1	26	2	5	0	1	10	7	3	2	13	16	0	7	1	0	16	39	7	105	53	72	42	1	4	97	0	19	1	0	8	6	1	0	52	34	36	21	0	5	54	1	32	1	2	3	1	1	0	0	2	184	2	24	11	2	1	0	10	7	2	0	0	0	0	0	19	18	3	1	0	3	1	3	16	11	4	0	2	2	9	0	0	1	33	25	1	0	1	4	1	4	0	29	8	5	529	1	3	2	11	0	3	0	0	0	3	0	84	0	7	65	1	2	7	2	2	12	1	158	2	3	17	2	0	2	6	10	60	7	4	1	1	0	19	0	0	0	30	1	0	1	1	2	0	1	68	1	3	4	1	0	0	1	4	27	0	7	3	4	0	0	12	0	2	0	10	1	0	1	0	2	2	2	5	1	0	4	35	2	40	2	16	0	53	0	0	0	1	0	0	2	6	48	0	29	0	1	4	1	1	8	1	6	0	16	10	0	8	4	28	0	16	4	0	2	5	0	0	1	7	5	2	0	8	0	1	34	2	17	15	9	0	6	1	1	12	1	4	20	20	4	2	3	0	1	1	0	1	0	30	37	2	29	1	2	0	1	0	1	8	0	0	16	8	0	2	1	14	32	0	6	1	21	25	4	50	0	2	13	26	7	5	1	12	2	0	26	0	103	2	5	1	4	4	38	103	0	8	1	1	12	4	3	2	1	21	15	3	4	5	10	5	6	1	6	14	39	6	3	4	11	8	15	5	53	3	5	4	9	1	3	1	1	8	8	8	14	14	21	7	2	22	6	4	9	0	0	69	5	0	9	5	0	33	3	16	26	4	2	0	122	1	0	13	26	2	1	1	3	0	0	2	0	1	0	2	3	5	22	0	0	2	2	4	16	8	0	0	1	20	47	0	3	1	0	4	14	17	16	2	14	2	3	2	2	11	16	14	1	10	0	2	1	0	0	1	0	2	0	9	2	10	1	16	84	231	126	30	2	56	40	0	1	156	167	175	7	182	11	13	3	2	0	4	0	1	0	4	0	3	155	12	2	3	36	0	156	0	1	0	0	46	1	2	0	0	0	0	19	1	0	0	0	0	2	0	0	36	2	2	0	79	0	1	0	0	0	0	0	0	50	0	165	1	0	2	1	0	1	7	1	1	0	0	0	7	2	1	3	11	18	0	1	3	77	1	0	3	0	0	8	0	0	1	3	0	0	0	1	0	6	6	6	0	0	23	3	0	2	0	23	81	8	0	5	0	0	0	0	289	2	1	18	0	13	2	1	1	0	165	0	0	1	2	0	0	4	1	0	0	0	174	3	1	35	2	0	0	1	9	0	0	2	0	0	0	0	0	1	1	0	0	25	7	0	4	5	19	8	4	0	33	1	15	0	17	40	12	30	0	1	0	1	23	11	5	3	1	0	2	9	229	30	5	7	4	0	5	1	5	5	5	18	227	220	4	218	3	0	0	2	0	0	9	4	1	8	0	0	0	0	0	0	5	1	2	3	0	1	0	4	20	0	0	15	3	0	0	4	11	5	0	2	0	16	0	19	1	3	9	41	1	0	0	0	3	5	0	1	2	0	3	0	3	3	2	13	2	0	4	5	3	2	4	1	3	6	1	1	9	31	3	22	5	1	14	4	1	0	0	7	1	70	0	3	2	2	3	0	1	4	1	41	1	26	61	0	0	2	0	1	6	2	35	62	4	66	24	76	179	4	32	18	158	44	1	4	1	10	0	48	40	2	2	21	16	76	32	19	14	32	7	4	5	0	18	5	25	1	0	0	2	4	1	0	0	1	8	7	3	1	1	0	0	5	1	5	1	38	0	0	2	2	2	0	0	0	5	25	11	2	1	0	0	17	2	158	0	50	1	41	0	0	0	1	1	0	2	5	2	0	13	47	0	0	14	7	18	3	1	1	5	1	0	0	1	1	0	57	1	39	9	0	57	0	0	0	16	2	0	3	0	102	25	6	1	20	1	0	4	13	1	0	0	60	5	5	0	0	2	0	3	0	0	8	49	157	65	5	21	1	3	0	1	1	0	1	0	2	4	3	7	19	0	2	0	1	1	45	4	1	6	7	0	4	22	7	2	7	20	4	0	0	49	37	0	4	10	0	0	17	2	3	6	0	44	40	4	11	0	0	1	4	1	0	4	0	24	5	30	9	4	3	2	3	0	5	6	5	95	2	1	18	0	3	2	3	11	0	2	3	45	0	1	0	4	2	0	2	7	8	0	7	7	2	2	0	9	0	0	0	92	2	2	0	1	0	32	0	0	8	1	0	0	7	0	3	8	2	1	0	0	0	0	3	15	0	8	2	2	0	35	0	0	36	4	28	0	2	5	81	47	2	22	7	7	12	0	41	1	1	7	0	0	5	7	2	3	3	29	2	0	0	3	0	2	2	0	7	7	2	7	0	7	21	0	0	14	0	3	0	0	39	8	1	0	0	4	3	9	0	1	0	0	6	0	0	0	1	8	0	39	4	1	3	0	0	1	10	2	7	0	3	0	6	12	1	2	2	0	1	0	24	3	6	4	0	6	0	1	8	26	5	1	2	1	1	0	2	1	0	1	6	1	95	8	6	0	0	0	0	0	11	3	0	5	0	9	4	4	2	0	0	0	1	1	0	0	1	15	93	93	0	4	5	0	1	0	27	5	0	0	0	0	3	4	1	0	8	7	0	11	3	0	1	0	3	0	5	1	1	8	0	9	49	0	8	0	29	4	0	0	0	19	3	0	0	4	0	1	0	10	27	2	0	1	31	0	0	1	7	1	0	0	5	5	7	0	4	8	0	0	2	0	3	2	0	0	2	37	1	97	1	0	116	38	0	4	7	3	1	96	0	3	59	1	17	1	12	11	0	3	13	29	0	0	0	16	2	0	0	0	0	42	34	0	0	3	2	55	29	0	0	0	0	0	6	3	1	3	0	47	19	0	0	0	0	0	3	0	3	1	2	0	0	0	2	0	0	0	1	1	2	0	0	1	0	2	21	3	50	0	1	0	9	1	0	3	0	0	0	1	0	0	84	11	1	0	2	0	1	10	0	2	3	1	4	3	1	1	0	6	45	0	3	0	2	1	1	0	6	1	29	40	1	18	0	0	1	3	39	1	3	9	1	1	3	55	34	1	0	8	13	2	2	61	2	0	1	5	11	2	1	3	10	4	1	2	2	2	5	9	1	1	0	34	2	6	17	4	1	1	89	0	17	2	10	1	6	10	106	37	15	7	7	11	1	1	5	0	0	20	2	0	0	2	2	0	2	4	5	1	0	2	3	6	0	4	4	0	0	0	8	0	0	0	0	7	1	8	1	0	1	7	7	0	2	3	3	1	2	0	5	2	1	0	4	0	0	0	0	7	3	6	1	2	42	17	4	0	31	47	0	3	0	4	14	3	8	10	59	2	0	1	1	2	22	2	0	0	0	10	0	9	0	4	0	1	0	7	3	0	5	3	0	2	0	0	0	1	0	6	2	0	5	11	15	1	0	0	2	9	11	1	10	0	4	5	6	0	0	46	0	1	2	12	0	0	0	0	3	3	0	0	0	2	0	0	0	5	4	0	8	0	10	0	1	2	6	0	0	25	1	0	0	2	5	0	1	0	26	32	2	2	0	1	0	0	2	8	0	35	1	1	0	56	0	140	1	1	4	0	1	4	0	2	1	3	5	0	1	19	0	1	4	27	2	3	0	1	0	0	0	0	8	3	2	0	4	0	0	2	4	1	0	0	0	13	6	0	2	9	1	3	10	0	0	3	2	0	1	9	1	0	1	0	1	0	0	0	4	0	4	16	2	7	1	0	0	1	2	3	0	2	0	1	1	1	2	4	0	1	0	0	0	0	0	2	0	1	33	0	0	7	0	10	45	28	0	0	5	0	5	10	0	3	28	31	65	56	15	2	2	3	9	0	1	0	27	1	30	2	7	7	150	154	14	33	57	3	1	1	13	0	29	0	0	1	20	0	0	5	2	4	3	0	106	0	0	0	1	0	2	1	1	21	1	0	2	0	13	26	0	3	0	1	0	1	22	11	5	0	11	4	4	26	0	0	5	0	0	4	2	2	0	1	0	2	2	2	2	3	8	2	0	2	0	3	4	0	69	4	5	8	2	116	2	24	1	45	0	0	11	84	0	0	127	0	4	1	9	45	24	0	248	0	1600	46	2	16	30	21	4	6	0	0	2	31	67	5	0	0	4	1286	0	101	5	90	4	6	354	45	22	53	140	58	55	63	247	0	0	6	1	5	2	16	5	18	2	0	1	3	1	1	8	0	1	0	1	1	1	0	3	1	33	0	0	10	0	0	0	2	22	22	0	0	0	2	0	0	0	2	28	1	0	0	0	10	0	10	0	0	2	0	0	1	8	0	1	0	0	0	0	79	0	0	3	0	2	0	0	0	4	2	3	76	2	25	0	0	5	0	10	0	0	24	1	0	1	2	0	1	2	0	0	0	0	5	2	54	33	0	3	2	0	0	1	2	3	1	7	1	89	2	67	3	239	0	1	16	24	10	79	3	0	2	5	48	575	39	24	116	0	0	0	9	0	14	0	12	2	3	4	5	0	50	1	8	22	52	7	22	26	31	6	1	0	0	0	5	5	0	3	0	0	0	0	11	11	11	2	2	0	1	72	6	3	5	0	5	1	16	1	0	0	1	6	2	2	1	3	5	1	3	0	0	0	0	0	56	30	1	0	13	0	1	0	0	0	52	1	0	8	0	0	0	0	2	2	0	4	2	0	23	22	441	77	26	0	27	254	412	1	17	16	0	1	45	2	4	57	0	18	43	2	119	46	20	2	4	5	0	0	5	38	46	3	3	5	0	0	2	41	3	5	0	2	4	2	0	0	1	0	31	4	0	11	20	32	2	26	3	2	11	156	0	18	7	55	0	25	9	14	5	190	2	12	2	2	3	2	8	11	0	34	17	1	0	1	0	23	8	12	6	8	12	10	1	0	20	0	1	0	3	119	1	11	0	0	20	10	0	0	3	7	0	0	0	0	4	0	36	1	2	6	45	53	3	43	369	306	3	68	0	0	0	68	0	18	19	8	23	4	7	29	0	17	1	5	1	2	5	0	8	2	2	0	54	12	3	51	0	32	75	1	3	0	6	0	1	3	6	0	0	0	6	22	0	0	1	2	67	28	39	28	19	26	13	1	4	3	58	1	33	43	60	24	0	12	3	1	0	1	0	0	0	0	0	0	0	1	1	0	0	0	0	0	0	3	0	1	0	1	0	0	3	1	0	1	0	0	0	0	0	1	0	0	4	2	0	0	0	1	5	0	1	0	5	1	1	0	2	2	2	2	3	1	0	0	1	1	2	0	0	0	0	2	0	2	3	0	0	0	0	5	46	3	5	0	13	60	0	51	64	4	1	0	51	0	0	0	0	4	0	1	0	5	0	0	2	1	13	0	5	3	7	0	0	3	2	2	0	1	1	3	3	0	2	2	0	0	0	0	0	16	1	4	5	0	3	2	2	0	0	12	1	1	2	2	6	0	12	8	0	3	0	0	5	2	0	0	6	3	1	5	0	1	0	6	17	0	1	0	0	6	1	0	0	0	0	0	4	0	0	0	8	0	3	0	0	0	0	0	4	2	1	0	1	1	2	0	0	0	0	0	1	0	3	9	1	1	1	5	0	2	4	0	2	4	0	0	0	3	0	0	2	0	0	0	3	18	2	0	1	0	3	3	1	1	0	10	10	0	0	0	0	6	0	0	1	1	0	1	2	0	0	2	3	1	0	1	2	0	1	3	1	2	0	0	0	0	5	0	1	0	0	3	16	1	95	13	0	0	0	0	0	0	0	6	6	0	1	4	4	5	6	0	0	5	2	0	0	1	7	2	5	0	2	0	0	6	19	0	4	0	0	0	1	1	0	0	11	12	0	0	1	47	0	0	0	0	2	2	3	0	0	5	1	0	2	0	1	1	0	3	0	0	0	1	18	0	0	0	0	5	1	1	0	0	14	0	1	0	0	0	32	6	0	0	0	4	13	19	15	11	1	0	0	0	1	20	1	1	19	0	0	1	5	4	9	54	1	22	5	181	68	3	3	89	0	0	4	1	2	7	20	0	14	1	2	0	1	4	1	4	4	1	4	7	22	21	2	0	0	15	7	56	0	7	17	0	1	1	0	0	1	67	30	3	2	2	1	80	2	2	0	4	4	0	1	0	1	0	1	0	34	8	1	0	1	0	0	0	0	0	0	0	0	0	0	0	1	0	0	8	0	0	0	3	0	0	0	0	3	0	0	0	0	1	0	3	0	2	1	1	3	1	7	0	2	1	3	0	0	3	2	0	0	0	0	0	4	0	0	1	0	0	0	0	0	6	0	0	2	0	0	0	0	0	1	9	14	2	11	0	2	2	4	1	0	0	0	4	0	2	0	0	0	0	0	0	2	1	1	0	0	1	0	0	7	0	0	0	0	12	0	9	2	0	2	0	19	1	0	5	0	6	0	10	0	9	0	4	6	1	2	0	2	0	0	3	0	0	0	0	3	1	0	0	11	1	3	0	0	1	0	2	0	2	3	0	0	0	1	1	0	1	0	0	1	2	2	0	1	0	2	2	4	0	0	0	2	2	2	4	9	4	1	10	2	0	1	0	0	7	9	3	21	9	0	0	9	0	0	1	0	10	13	2	0	0	11	0	0	5	0	0	1	5	1	1	0	3	0	0	7	1	0	27	5	0	0	5	0	0	2	7	0	4	2	0	0	6	3	0	0	0	0	0	0	0	0	3	1	0	0	0	1	17	0	1	0	1	0	0	15	0	1	9	0	1	1	16	29	7	5	5	0	2	2	0	0	12	0	17	9	6	8	2	0	6	4	10	0	6	5	0	0	0	0	1	0	5	0	0	0	2	1	0	0	4	0	0	0	0	0	0	0	0	1	0	7	0	0	0	5	5	0	2	2	1	1	0	1	0	100	0	2	3	5	0	0	2	0	12	0	8	0	0	70	2	7	3	0	2	2	0	2	2	37	1	0	0	0	6	1	3	0	4	26	17	3	2	7	0	1	4	1	5	26	93	1	0	4	0	0	1	0	1	0	0	3	0	2	0	1	1	2	1	0	0	1	1	2	1	0	2	2	0	1	0	2	1	7	0	0	0	1	2	0	0	36	0	0	0	1	12	4	1	1	0	2	0	0	0	2	12	0	1	0	1	0	0	1	1	1	1	1	1	12	0	1	0	1	2	12	0	0	12	1	0	4	11	0	1	1	0	11	0	2	1	1	0	24	3	10	1	0	1	1	1	0	1	4	162	1	5	0	3	0	2	40	22	6	3	1	1	1	0	6	46	23	12	25	65	29	0	2	34	0	4	338	3	12	1	2	13	3	12	2	1	2	1	0	1	0	88	19	0	0	0	0	3	0	0	8	0	4	0	4	1	0	24	1	16	0	0	2	0	16	0	0	103	2	0	2	0	9	0	2	0	0	1	1	0	16	8	1	2	31	0	29	0	22	0	1	4	0	97	69	13	2	3	11	11	11	2	48	2	4	38	2	0	1	1	0	1	2	1	1	1	0	0	3	0	5	0	2	0	0	1	8	9	0	0	1	0	2	0	8	4	65	2	0	4	0	0	0	3	2	0	0	0	0	1	1	1	2	0	0	2	3	4	0	0	1	8	1	1	1	2	6	0	0	0	0	1	0	2	2	0	3	1	0	0	0	0	0	1	0	2	1	0	0	0	1	1	0	0	0	0	0	1	0	3	0	0	0	0	0	0	0	0	1	0	0	0	0	0	0	0	4	0	8	0	0	1	2	0	0	0	0	1	4	0	0	0	2	1	0	1	0	0	0	0	9	3	0	17	2	10	0	0	2	0	0	2	2	0	0	0	7	4	16	1	4	1	1	0	11	0	0	0	2	0	0	0	2	18	0	1	3	0	0	0	0	0	9	0	0	1	0	0	2	1	0	4	3	0	16	0	1	0	4	21	0	0	0	7	0	4	3	0	0	0	1	0	0	1	0	1	0	4	0	4	2	2	0	0	1	0	0	1	2	0	0	1	0	1	1	0	0	0	3	12	5	0	3	3	1	0	0	0	0	0	1	2	0	5	0	1	1	0	4	0	0	1	2	2	0	0	1	2	0	0	0	0	3	0	0	0	4	0	0	5	0	0	0	4	0	2	3	3	4	1	6	4	0	2	0	0	1	0	0	1	7	2	1	1	1	2	0	0	0	1	0	0	0	0	0	4	1	1	1	2	0	1	0	0	1	0	5	0	0	0	4	6	16	0	0	2	0	4	0	0	0	0	1	0	0	13	0	9	1	0	2	0	3	3	0	0	0	0	0	0	0	0	0	0	1	4	0	0	0	0	0	2	5	0	4	0	1	0	0	1	0	1	31	5	2	0	1	0	6	2	2	0	0	0	1	1	0	0	3	0	0	2	1	1	9	1	0	0	2	7	1	1	0	1	2	0	3	1	2	1	1	6	5	0	1	5	3	1	1	1	0	9	4	8	5	18	13	0	75	0	0	2	0	0	12	4	0	11	8	24	3	3	2	1	5	5	0	0	0	11	1	1	1	0	6	60	5	0	0	50	99	0	0	0	5	3	21	0	0	6	6	3	23	1	1	43	0	3	1	0	4	0	0	27	0	54	4	1	1	5	2	9	0	3	0	6	3	1	5	3	14	7	4	6	43	0	17	16	1	13	0	1	2	0	24	1	0	2	4	2	10	19	6	3	0	27	10	93	2	0	1	0	2	9	9	1	4	3	2	2	13	2	0	0	5	3	0	2	81	63	6	1	1	1	0	2	28	7	14	0	0	4	0	2	1	12	0	0	0	1	3	58	8	0	0	2	7	0	3	1	0	78	0	0	10	0	13	0	0	0	44	0	0	7	1	21	4	0	0	0	0	0	11	3	0	0	0	11	2	3	4	1	2	0	2	0	1	0	1	2	21	0	1	1	3	3	0	1	2	0	0	0	0	5	2	1	3	0	4	0	7	1	0	0	1	5	0	4	0	11	48	7	0	0	4	2	1	5	0	0	47	0	0	7	4	48	4	2	1	0	0	0	0	2	0	19	2	4	1	5	0	0	7	1	0	5	5	0	1	95	1	1	1	1	0	2	1	2	1	0	0	1	1	0	1	0	3	0	5	1	0	0	0	0	3	0	22	11	0	1	0	35	1	1	1	1	9	1	2	87	1	0	0	0	0	0	9	4	0	0	4	0	0	1	7	8	18	0	1	5	0	5	2	1	3	16	0	0	71	2	5	6	2	1	1	6	27	3	22	6	3	3	3	3	0	10	1	0	6	6	0	0	2	9	3	0	0	1	0	4	6	1	0	1	0	1	15	1	4	0	0	1	2	0	1	1	0	0	0	3	3	0	0	0	2	5	0	3	5	0	2	1	7	11	0	4	1	2	1	5	0	1	0	0	2	0	14	0	3	0	0	2	15	0	10	27	36	2	20	0	0	28	2	2	0	0	0	0	0	0	0	0	1	0	1	36	73	0	3	0	6	93	0	127	2	0	0	0	0	11	4	2	0	180	0	0	2	5	2	4	8	0	0	0	4	2	1	7	5	0	0	1	6	8	4	19	2	20	10	1	31	11	31	30	78	16	2	14	3	15	50	87	1	8	1	6	1	7	3	2	0	4	4	0	3	11	474	0	0	2	68	5	1	52	75	0	0	23	4	0	2	0	1	32	1	0	0	0	10	1	5	3	5	0	0	1	2	2	4	1	3	3	0	0	6	0	4	61	0	7	0	0	5	0	1	0	0	0	0	0	27	0	0	2	8	12	2	1	0	0	0	19	1	1	0	0	0	0	1	0	0	0	2	14	1	0	1	5	5	0	12	1	11	0	9	1	0	2	60	0	0	14	0	0	3	8	1	2	1	45	65	74	121	0	1	0	0	29	0	7	1	4	4	28	1	6	5	1	0	1	1	9	36	0	56	8	130	34	1	132	67	185	18	23	155	0	24	676	0	40	0	2	0	1	2	0	7	0	0	0	0	0	4	0	0	0	17	0	13	3	23	3	0	26	38	49	4	0	14	0	0	1	0	7	0	14	1	0	82	2	63	36	2	0	0	1	31	12	36	59	64	32	3	0	86	4	45	9	1	59	5	4	4	1	2	0	0	0	0	0	2	0	1	1	89	33	38	5	6	1	34	19	18	4	0	5	0	6	1	61	0	299	9	9	1	5	44	21	0	5	42	10	4	6	6	4	7	24	0	4	2	29	9	43	137	15	42	52	65	12	124	142	0	3	532	4	4	31	1	0	53	51	0	69	7	0	4	0	24	0	0	107	0	14	6	12	17	1	6	1	11	9	19	2	69	81	31	13	0	10	3	2	45	0	38	14	162	3	17	56	70	46	1	2	1	16	26	10	10	17	23	11	9	1	1	16	0	0	79	19	14	7	10	3	1	18	2	1	10	0	1	135	0	0	4	0	107	1	10	3	9	0	82	7	3	7	27	11	32	8	1	1	2	2	2	16	2	94	1	3	9	51	1	25	20	7	21	13	5	3	6	6	5	4	1	2	1	9	0	2	0	0	325	6	8	41	39	58	6	0	10	0	17	11	0	1	14	0	115	188	0	0	0	0	0	0	1	0	1	3	0	2	3	1	0	2	2	1	0	50	0	0	39	2	1	1	1	1	5	0	0	1	56	1	0	0	0	1	1	4	0	60	2	0	57	5	18	0	8	7	0	1	10	0	1	1	2	0	0	0	0	1	0	9	7	1	0	3	0	0	2	67	0	1	9	0	0	0	0	2	0	1	14	0	5	67	2	80	63	0	4	2	4	1	0	4	8	0	0	0	0	3	0	0	2	1	0	3	1	0	3	0	1	1	0	1	1	0	0	0	0	0	3	0	1	1	0	0	0	2	1	0	0	0	5	1	0	1	15	0	1	0	0	1	1	4	3	4	0	0	1	0	0	1	1	3	4	0	2	0	1	1	4	0	2	0	1	3	0	0	4	0	1	5	1	2	0	0	0	0	0	1	3	0	3	0	1	0	0	0	1	1	2	1	0	0	0	0	0	0	0	2	2	1	1	0	0	0	0	0	1	11	0	1	0	0	0	1	0	3	3	3	16	3	0	0	0	0	8	0	2	3	0	0	3	0	0	0	1	0	3	2	1	0	6	0	5	0	1	4	0	0	4	1	0	1	0	0	0	1	1	0	1	0	0	0	4	6	9	0	0	1	2	0	0	1	1	0	1	0	0	10	6	2	117	0	0	0	1	5	0	6	0	1	0	2	1	0	4	0	0	51	2	4	2	0	0	0	0	0	5	0	0	1	1	6	0	5	37	0	1	1	1	1	1	9	8	0	2	0	1	7	2	1	0	0	0	1	0	0	0	1	2	12	2	0	0	4	0	7	0	0	0	0	7	5	6	1	0	0	2	0	0	9	1	0	0	0	9	0	0	22	0	2	16	14	154	14	0	1	0	6	25	31	31	27	13	1	1	23	0	18	9	0	2	12	30	10	5	0	18	2	0	56	1	0	1	240	6	5	0	0	3	0	0	0	9	18	2	7	7	0	9	7	2	10	0	0	0	0	27	0	4	0	2	20	7	4	8	54	12	53	4	2	21	0	32	17	18	4	3	0	0	0	0	1	0	16	2	18	4	0	0	8	5	3	20	3	0	5	14	5	0	48	16	15	37	3	0	0	28	0	0	55	17	13	5	3	49	58	0	0	0	7	7	2	3	0	7	2	0	0	1	0	0	3	0	0	3	0	0	2	0	2	0	2	0	1	0	0	0	0	0	0	1	0	6	1	2	6	0	1	3	0	0	2	0	1	0	0	0	2	1	5	1	1	2	1	0	3	1	1	2	2	6	0	1	0	0	8	0	9	3	0	17	0
PHYLLO26	135133	0	0	0	581	2252	226	0	597	1	16	130	95	0	292	6	0	9	0	4	10	1	3	1	127	2	0	30	18	78	16	0	22	100	9	41	69	0	2	0	0	0	0	0	36	0	0	0	0	8	7	0	85	242	450	4	1300	19	13	3	90	0	16	25	120	194	0	58	9	0	57	3	0	0	11	5	10	0	0	1	0	0	566	336	210	198	0	136	5	60	0	212	47	252	102	41	128	26	209	1	0	458	8	601	2	205	364	0	23	19	6	0	75	63	0	158	28	59	0	6	189	35	150	8	37	415	157	210	44	40	26	14	1	6	2	6	3	544	50	12	50	119	119	15	3	89	23	5	39	60	16	4	6	40	7	0	2	6	225	139	88	3	12	234	10	201	204	196	56	74	9	57	75	20	32	10	4	21	46	1	58	11	58	23	12	45	56	0	0	11	17	67	2	0	0	28	39	229	2	0	42	15	8	80	14	24	0	60	2	20	234	2	34	0	766	1041	9	90	6	63	24	22	93	42	312	15	270	137	84	7	261	20	26	58	1	0	26	0	145	4	45	29	175	65	4	15	0	13	96	35	0	4	96	4	274	2	14	12	281	18	0	18	8	0	5	0	51	71	66	8	67	26	67	2	23	18	0	21	0	103	147	13	40	33	241	229	34	10	26	15	114	0	0	17	103	9	249	0	12	20	18	43	357	11	0	0	0	121	107	153	242	32	37	4	9	44	0	60	0	70	0	105	14	13	2	12	0	18	6	6	0	57	0	1	9	0	2	2	0	23	160	56	2	160	416	7	3	0	66	32	17	14	13	26	180	3	56	56	12	38	75	47	13	8	0	1	81	91	26	126	0	109	69	56	16	59	140	28	15	255	77	90	23	47	10	15	278	123	47	7	894	0	0	3	2	4	7	43	1067	0	35	7	207	1	923	70	0	0	8	74	271	374	3	0	1	10	4	1	6	77	222	70	9	0	141	3	130	227	413	2	4	6	0	0	4	59	356	26	21	44	310	2	28	53	103	228	128	81	157	4	28	176	231	65	129	92	31	1111	43	41	0	0	0	0	4	3	8	0	3	4	4	1	11	0	5	6	6	4	3	2	192	23	0	31	2	0	0	0	5	32	0	3	4	0	28	0	0	5	1	2	0	3	1	1	1	2	9	13	0	25	2	12	0	0	100	371	157	11	125	44	60	612	24	150	230	12	347	0	152	28	7	25	28	0	41	39	97	28	189	189	11	104	4	41	86	209	101	44	0	15	3	60	22	37	52	21	14	113	87	169	20	56	11	90	73	4	2	0	0	71	5	19	7	110	92	1	207	78	1	65	0	14	32	30	88	0	23	46	53	56	23	3	24	4	0	0	6	3	0	1	0	0	47	198	2	20	41	0	0	13	6	0	145	0	29	41	34	0	53	0	39	0	2	3	8	5	2	0	0	22	0	7	30	0	42	113	23	0	0	38	0	4	47	0	68	6	0	16	1	0	13	77	618	20	43	0	23	56	1	26	162	11	4	2	5	31	179	6	103	10	45	0	29	92	268	29	27	153	42	0	124	126	45	63	41	37	0	1	126	75	11	13	225	0	0	2	20	1	34	1	2	13	77	0	0	1	69	21	14	29	0	95	28	37	38	91	182	42	103	544	59	4	0	149	32	0	5	9	2	51	52	2	0	3	0	26	78	0	11	0	10	30	22	22	16	0	4	36	24	1	60	176	74	59	18	140	0	41	78	0	23	4	12	138	78	35	21	95	30	95	0	44	1	107	40	49	4	24	15	1	121	29	17	0	1	1	12	5	0	2	2	3	0	63	135	1	9	0	0	15	19	46	59	43	30	7	2	0	7	13	5	0	94	23	51	17	35	13	87	25	0	2	70	81	29	38	0	0	10	0	8	0	17	0	0	9	5	0	0	0	64	5	16	21	0	6	33	1	40	25	30	19	13	0	0	0	81	23	0	0	32	10	12	3	0	1	0	18	0	23	5	3	45	33	25	26	41	4	2	1	17	3	13	3	12	116	13	41	16	7	10	1	26	0	9	1	3	0	7	39	17	12	0	0	0	6	0	6	1	42	15	11	26	158	40	43	24	0	230	0	15	0	1	26	43	31	0	4	10	0	0	0	0	2	6	25	0	3	18	31	21	0	1	14	9	1	1	154	1	48	1	26	14	97	22	3	4	7	0	0	326	3	55	0	3	39	1	42	11	0	0	8	0	0	0	1	34	0	118	51	6	298	0	0	0	25	135	42	0	36	6	23	4	1	3	0	0	2	26	8	1	2	11	6	0	0	53	149	35	0	97	3	17	0	8	21	0	0	6	5	96	1	1	1	19	67	103	131	75	70	6	0	0	4	3	12	0	61	20	1	0	2	0	106	1	0	81	0	0	60	2	0	2	51	24	1	13	38	80	0	4	121	0	2	4	8	27	3	5	145	168	3	41	0	1	16	12	1	55	29	21	72	36	19	98	25	20	97	30	18	28	2	0	5	0	1	106	0	61	37	326	176	71	80	131	36	46	41	133	81	0	16	227	40	302	41	87	86	2	68	95	0	14	100	0	105	212	1	12	99	64	99	11	6	1	3	0	0	3	63	29	88	41	72	54	67	74	31	207	16	1	16	84	11	35	18	132	3	5	161	18	1	0	0	70	45	0	135	0	34	12	51	1	15	0	2	22	19	0	18	9	13	0	0	13	12	0	31	46	5	26	3	4	13	19	0	39	1	1	0	7	13	18	26	4	0	0	78	0	13	67	33	2	39	0	31	8	0	0	287	4	0	25	57	18	0	4	26	52	4	7	0	2	0	0	0	0	9	0	17	1	0	21	17	1	14	18	0	18	1	57	0	12	0	45	76	2	42	9	0	15	0	26	45	1	0	0	2	13	0	57	0	5	92	176	1	42	0	5	0	2	10	1	0	0	26	2	17	13	5	8	2	5	0	0	51	0	2	1	0	0	7	32	36	1	3	3	5	1	9	4	34	42	7	0	3	8	19	1	34	3	0	0	13	201	8	0	2	19	0	10	4	30	244	1	7	1	5	0	18	0	21	26	0	61	8	0	28	15	0	3	1	4	0	0	2	3	0	3	26	5	37	20	236	9	56	4	69	2	1	0	24	14	3	173	1	0	1	3	0	4	12	7	3	0	0	1	5	3	0	0	5	0	0	0	1	17	0	18	16	0	0	0	44	18	1	2	16	0	0	4	46	10	0	40	7	12	14	0	0	41	20	18	5	0	0	15	29	0	54	0	1	9	4	10	1	6	23	0	0	20	0	0	5	2	17	34	11	14	73	2	0	0	0	1	215	0	1	11	6	0	1	208	11	24	5	4	0	0	55	8	2	3	0	0	1	0	0	0	0	1	0	0	102	2	38	0	0	0	3	9	1	0	0	0	0	0	2	0	0	41	0	34	15	48	8	19	10	0	8	12	88	0	2	1	5	5	6	17	7	1	0	140	20	0	2	7	1	0	3	0	0	0	0	0	3	0	0	0	0	34	0	0	8	249	26	0	0	0	0	0	197	15	0	1	0	4	0	3	2	0	3	106	9	18	34	84	6	8	15	5	0	14	2	9	3	74	2	20	1	60	9	2	81	33	1	8	20	8	0	0	51	0	28	39	30	0	11	0	7	0	3	11	45	14	0	2	0	35	0	2	41	17	54	61	23	15	0	4	0	4	18	4	1	0	109	16	14	0	6	15	49	27	0	18	10	18	2	0	37	44	4	2	7	5	12	89	15	2	12	24	124	3	20	1531	2	37	8	4	18	12	1	57	121	40	7	6	1	6	12	31	24	1	0	44	6	8	15	121	0	1	67	29	6	41	17	5	20	1	2	15	94	4	5	5	2	0	5	15	1	6	46	17	8	18	6	4	12	0	2	0	0	0	3	1	26	39	4	1	0	12	137	37	0	30	0	3	10	16	15	18	32	7	0	4	8	20	15	41	11	43	10	2	1	8	18	1	8	56	14	1	1	1	2	22	0	7	19	257	1	0	2	2	0	2	17	1	5	7	25	10	25	6	27	0	28	8	0	1	57	3	0	12	30	20	15	2	156	0	9	0	27	22	5	0	35	75	47	0	7	31	19	0	23	23	62	1	0	1	16	14	15	0	169	184	117	0	15	50	12	114	0	3	28	2	6	84	0	1	37	36	178	423	415	59	62	41	294	234	25	0	380	251	69	113	60	169	319	145	5	13	23	0	0	0	17	6	26	0	72	197	206	15	111	0	77	291	73	1	3	92	0	18	156	0	138	0	0	3	6	0	107	119	24	6	1	47	46	0	3	168	4	209	2	1	0	0	36	166	12	13	62	25	153	185	1	117	115	112	61	30	0	1	33	52	9	1	1	71	79	123	102	0	29	23	14	0	2	2	8	133	28	31	121	1	0	0	0	206	0	15	14	1	21	0	16	55	0	0	62	0	3	0	0	0	7	3	0	146	7	1	0	121	1	0	2	1	0	0	41	0	0	1	0	2	0	0	0	0	0	0	6	17	10	0	44	0	5	0	6	30	9	8	36	0	37	0	0	33	20	9	29	6	0	45	65	22	3	5	1	0	25	12	5	1	3	1	0	5	0	2	0	0	15	47	6	2	8	18	7	102	2	0	31	60	70	9	0	0	1	225	0	2	0	1	15	15	66	541	61	0	25	1	0	0	0	2	26	3	1	0	0	0	42	2	10	5	23	2	43	0	89	3	4	40	11	5	0	0	23	34	0	2	1	41	1	0	0	0	0	0	4	0	0	2	2	3	1	0	1	0	0	0	0	23	18	7	4	0	0	0	0	23	0	0	2	1	0	0	46	15	3	0	0	1	1	10	6	62	19	40	40	16	15	10	22	8	19	4	1	0	0	0	0	2	36	4	0	9	21	0	58	15	0	0	0	0	1	127	0	1	0	2	0	7	19	4	4	0	1	0	1	312	0	27	12	1	0	0	21	33	0	0	11	0	0	0	61	0	0	1	12	0	20	1	1	62	0	5	10	12	69	74	54	18	31	0	24	25	1	1	1	5	30	121	114	81	2	2	2	457	0	109	3	13	1	6	71	2	106	5	65	63	83	13	0	0	0	0	1	1	0	0	3	0	1	76	0	0	3	1	0	1	1	9	20	13	4	24	1	14	0	0	5	0	0	4	75	15	12	8	1	6	0	8	1	0	17	5	3	3	1	0	1	0	42	6	17	1	0	0	3	0	1	3	4	0	2	0	2	14	0	1	0	0	7	20	3	47	34	28	1	33	0	2	1	47	0	0	0	19	0	0	11	7	0	0	1	0	11	0	0	22	0	0	4	4	0	1	0	13	0	0	4	30	6	7	6	65	23	28	23	54	28	7	1	1	0	100	0	18	90	90	0	0	7	84	67	2	8	1	1	8	3	65	17	15	27	8	77	2	0	1	7	15	1	2	0	11	0	167	2	2	2	25	6	0	0	0	4	6	54	3	10	0	0	58	17	60	17	1	9	2	1	0	0	5	31	2	14	1	1	2	16	0	52	0	2	8	1	2	1	0	1	3	6	1	2	3	3	0	0	1	8	0	2	0	2	0	0	0	9	1	13	0	1	12	0	1	1	3	0	0	2	0	0	0	63	4	0	9	0	0	5	1	1	0	0	0	24	2	2	23	5	0	1	0	0	1	0	1	2	19	1	1	0	7	3	24	0	6	0	0	1	8	0	1	4	3	0	1	0	0	26	23	10	107	37	81	60	2	1	51	0	28	0	0	5	3	0	0	18	29	40	13	0	2	42	3	26	0	0	0	1	0	1	1	0	186	1	14	9	0	0	0	13	1	0	0	1	0	0	0	22	14	9	1	0	3	0	6	15	14	0	0	1	0	18	0	2	0	28	22	2	1	0	1	0	1	0	16	2	0	555	0	0	0	5	0	0	0	0	0	1	2	41	0	15	59	1	4	1	0	0	9	0	48	0	0	16	0	3	1	0	6	38	0	0	0	0	0	31	0	2	0	50	1	0	0	1	0	3	2	29	0	1	2	0	0	1	1	0	16	0	1	6	3	0	0	27	0	6	0	7	0	0	0	0	4	0	0	3	0	2	0	25	4	16	1	0	0	51	0	2	0	0	0	0	0	1	30	0	33	0	8	2	0	0	1	0	0	0	16	26	0	17	5	1	2	22	0	2	5	0	0	0	0	2	0	1	1	5	0	6	38	2	4	22	6	2	6	3	0	14	0	4	30	6	0	3	6	0	1	0	2	0	0	27	15	4	24	4	2	1	1	0	0	4	0	0	1	5	0	0	0	5	26	0	0	0	14	6	8	33	0	6	11	2	2	5	4	3	4	0	1	0	78	6	0	0	4	0	42	106	0	10	0	1	4	9	2	1	3	6	20	3	4	1	7	4	0	0	1	1	12	6	4	3	1	5	5	1	68	0	10	0	3	0	1	0	1	8	5	3	12	12	3	8	0	14	3	0	3	0	0	79	2	0	5	0	0	41	0	10	1	0	3	5	65	1	0	4	9	2	4	0	3	0	4	0	0	1	0	1	3	1	15	0	0	2	8	9	6	3	0	0	0	11	31	0	6	0	1	1	6	1	10	1	2	15	7	4	2	4	11	8	0	3	1	0	0	0	0	2	3	1	2	0	0	1	6	13	89	226	117	21	3	33	29	0	0	216	205	206	1	208	10	10	0	6	1	2	1	0	0	2	0	0	126	0	3	2	26	2	146	1	0	0	0	12	0	0	0	4	1	0	2	0	1	0	0	0	0	4	0	33	2	2	1	106	0	5	1	0	0	1	0	0	29	0	146	0	0	0	0	0	0	0	3	3	0	3	3	0	0	0	2	4	3	0	0	1	71	0	0	0	0	0	6	0	1	1	6	3	0	0	1	0	1	1	1	0	0	35	0	0	0	0	24	1	0	0	0	0	0	0	0	249	0	1	4	0	4	0	0	0	0	140	0	0	3	2	0	1	6	0	0	0	1	144	1	0	61	0	0	0	0	0	0	0	0	0	0	1	1	0	0	4	0	0	4	7	0	0	2	8	10	3	0	3	0	14	0	7	29	7	20	0	0	1	0	16	5	1	2	4	0	6	7	179	5	1	19	1	0	0	0	0	0	0	6	195	176	0	171	0	0	1	0	0	0	18	1	1	0	0	0	3	5	5	0	1	0	0	0	0	0	0	5	11	1	0	2	2	0	0	1	5	1	0	1	0	9	0	14	0	0	1	32	2	3	1	0	8	1	0	0	6	0	3	1	0	5	0	7	1	2	0	2	8	1	0	0	3	1	0	3	7	41	2	58	2	0	1	0	0	0	4	3	0	58	0	1	12	3	8	1	0	0	2	31	0	16	38	0	0	0	1	0	3	1	32	72	9	70	9	76	151	1	14	14	91	19	0	1	0	0	1	60	38	11	0	3	0	84	10	6	7	11	2	4	7	0	27	0	22	2	0	0	3	8	0	0	0	0	10	0	2	5	7	0	0	2	0	13	0	39	0	0	2	1	2	0	0	1	2	22	12	1	0	0	0	10	5	102	0	33	0	56	0	4	0	1	0	1	3	6	2	0	18	2	0	0	8	1	9	1	0	3	2	0	0	0	0	0	0	20	0	32	4	1	36	0	0	7	24	0	0	1	4	44	4	0	0	6	2	1	11	12	0	7	0	27	12	25	0	0	0	1	0	0	0	7	31	123	6	0	47	0	3	0	3	2	0	1	0	0	13	2	1	0	0	0	0	0	0	66	1	0	3	1	0	5	20	5	0	7	26	5	0	0	39	37	0	4	1	0	3	13	0	1	26	0	45	35	0	6	0	0	5	9	0	1	4	0	23	2	31	1	1	15	0	1	0	4	1	7	120	5	0	22	0	0	1	0	3	0	0	0	46	0	2	0	18	0	0	0	6	5	0	2	0	0	0	0	17	0	0	0	8	0	1	2	2	0	52	0	0	5	0	0	0	9	0	0	3	1	0	0	0	1	0	0	12	0	0	1	4	0	17	0	0	25	0	22	3	2	3	25	61	5	41	1	1	14	1	39	0	0	3	0	0	0	5	8	2	2	2	4	1	0	2	0	0	0	0	1	3	0	3	0	3	1	1	5	9	0	1	2	0	32	4	0	0	0	0	5	1	0	1	0	1	8	2	0	0	0	5	0	35	3	0	2	0	0	6	0	0	6	0	8	1	3	2	0	1	0	0	1	1	40	2	3	4	0	3	0	1	5	16	0	1	0	4	1	0	1	3	0	1	0	0	41	0	7	0	0	2	1	0	7	0	0	0	0	8	5	0	1	0	3	0	5	0	1	0	1	13	41	40	0	13	4	0	0	0	18	2	0	0	2	0	3	3	1	0	8	1	1	20	2	2	3	1	0	11	2	0	0	2	0	3	33	1	4	0	21	0	0	0	0	7	0	0	0	0	0	0	0	7	17	0	0	0	8	1	1	0	0	0	3	0	0	0	0	0	2	0	5	0	1	0	0	3	0	0	1	9	0	77	0	0	100	19	0	0	3	0	1	66	0	0	23	0	12	0	28	10	0	0	7	26	0	0	0	20	0	0	0	0	0	32	25	0	0	0	0	38	6	0	0	0	0	0	1	7	0	0	3	3	10	0	0	2	2	0	0	1	0	0	2	0	0	0	5	5	0	0	2	0	0	0	0	0	0	1	14	2	59	0	4	0	3	2	0	1	0	0	0	0	0	0	65	2	1	0	5	0	0	3	0	0	0	0	2	0	2	0	0	1	47	0	0	0	0	1	0	0	0	0	5	28	1	8	0	0	0	0	18	0	2	10	0	0	11	30	19	0	1	4	3	0	0	30	2	0	0	0	10	0	1	0	8	5	0	0	0	0	1	14	3	1	0	7	0	2	4	0	0	0	101	0	7	0	17	0	10	3	61	38	11	4	2	4	2	0	1	2	1	20	1	0	0	0	1	0	7	0	1	0	1	2	0	3	0	1	2	0	0	0	0	0	0	0	1	2	0	5	0	0	0	5	1	0	0	0	0	0	0	0	1	0	0	0	1	0	0	0	0	16	1	2	1	0	43	21	1	0	36	42	0	4	1	7	3	0	0	19	12	3	0	0	8	0	12	0	1	1	0	11	0	4	1	0	0	0	0	12	0	0	2	0	0	0	0	1	0	4	0	0	2	0	0	4	2	3	0	0	3	0	5	0	14	0	1	7	8	0	0	22	0	2	1	1	1	0	0	0	6	0	0	0	5	0	0	0	2	0	6	0	2	1	6	0	0	1	1	2	0	43	7	0	0	0	7	0	0	6	14	27	0	0	0	5	1	0	1	4	0	40	0	0	4	17	0	75	0	0	1	0	0	0	0	0	0	0	4	0	0	3	0	0	6	16	1	0	0	0	0	0	0	5	0	0	1	2	0	0	2	0	1	0	0	0	0	10	3	0	3	3	0	0	1	0	0	2	0	0	7	13	0	2	0	0	0	0	2	0	0	0	1	55	0	6	0	0	0	0	0	0	0	2	2	0	0	3	0	5	2	1	0	1	1	0	0	0	0	0	16	0	0	4	0	17	49	26	1	1	9	0	5	17	0	0	22	13	48	35	7	0	2	1	19	0	2	0	24	0	18	0	4	2	137	140	14	1	42	2	4	0	3	0	53	0	0	0	46	2	1	2	0	1	2	0	79	1	0	0	0	3	4	0	0	18	0	0	0	3	4	32	0	0	1	0	5	0	21	16	9	1	16	5	2	9	0	1	14	0	0	0	4	1	2	1	0	3	3	3	3	0	11	3	0	12	0	0	3	0	70	3	2	0	3	47	0	4	0	44	0	2	29	67	0	0	94	2	5	0	17	34	14	0	284	0	839	68	4	4	15	7	4	4	0	0	0	40	40	2	0	0	0	1256	2	55	0	71	0	5	309	67	16	58	82	76	68	75	266	0	0	1	1	1	0	5	0	24	0	1	0	2	0	0	4	0	0	0	0	1	0	2	0	0	20	3	1	15	0	0	0	0	10	12	0	7	0	0	0	0	0	0	8	0	0	0	0	14	0	2	1	2	0	0	0	1	4	1	0	0	0	0	0	66	2	0	1	0	0	0	1	2	4	1	2	79	23	13	0	0	3	2	19	0	1	4	0	9	2	4	0	0	5	0	1	1	1	8	0	27	61	0	0	0	0	0	0	0	0	0	6	0	59	2	85	1	160	0	0	6	19	6	119	0	0	4	0	61	535	30	33	96	0	0	2	4	8	1	3	7	0	0	0	2	0	25	0	9	6	37	12	6	14	26	1	0	0	0	0	1	1	0	5	0	0	0	0	1	1	1	0	0	5	1	28	3	0	0	2	3	0	40	0	0	0	0	1	1	0	0	1	0	0	0	0	1	0	0	0	36	23	0	0	6	1	0	0	0	1	27	0	0	4	0	0	0	0	2	2	0	1	0	0	22	6	368	70	24	0	33	220	405	0	17	13	0	12	1	1	1	46	0	6	27	0	118	42	1	0	0	0	0	0	0	8	45	0	0	15	0	0	2	6	7	0	0	0	0	1	0	2	0	1	19	0	0	8	30	25	3	25	0	31	2	90	0	9	11	25	0	17	0	1	2	168	2	15	0	0	1	2	5	6	0	19	0	2	0	0	0	9	3	11	8	1	11	5	1	0	9	0	0	0	1	115	0	5	0	0	7	2	0	0	8	1	0	0	1	0	1	0	27	0	3	11	50	20	3	33	283	303	0	77	0	1	0	83	0	3	17	0	40	2	10	4	0	10	0	8	0	8	5	0	3	0	0	0	81	6	1	19	0	15	73	1	0	0	3	0	1	0	2	2	0	0	0	36	0	0	1	0	39	33	28	10	7	23	10	0	0	8	46	2	30	34	42	13	0	7	1	0	0	2	0	0	0	0	0	0	0	0	0	0	0	0	2	0	0	2	0	0	0	0	0	2	3	0	0	1	0	0	3	0	1	0	0	4	7	0	6	0	0	0	3	0	0	0	1	0	0	0	4	1	4	0	2	0	0	0	0	0	0	0	0	0	2	0	0	1	0	1	0	0	0	0	47	0	4	1	20	37	0	33	81	0	0	1	34	0	0	0	0	0	2	0	0	1	0	8	4	0	4	0	0	7	9	4	0	1	0	0	0	0	0	0	1	0	0	4	0	1	0	1	0	16	2	2	2	0	0	2	3	0	0	2	2	1	0	2	1	0	1	0	0	0	0	0	4	2	2	0	1	1	0	3	0	0	0	4	30	0	1	0	3	1	0	0	1	0	1	0	1	1	0	1	3	0	0	0	0	1	0	0	4	0	2	0	2	3	2	0	0	0	0	0	0	4	0	0	0	0	6	10	0	2	3	0	1	4	0	0	2	0	0	0	3	0	0	0	1	11	3	0	0	0	3	2	8	5	0	0	0	0	0	0	0	0	0	0	0	0	0	0	0	0	0	0	0	0	0	2	0	0	0	1	0	0	0	0	1	0	1	0	1	0	0	0	0	6	97	11	0	0	0	0	0	0	0	5	11	0	0	22	22	0	3	0	0	9	0	2	1	0	1	1	11	0	8	0	0	18	9	0	1	0	0	0	2	0	0	0	5	22	2	0	3	34	1	1	0	0	1	1	2	0	0	0	0	0	1	1	1	0	0	0	2	2	0	1	24	0	0	1	1	5	0	0	0	0	4	0	0	0	0	0	22	1	0	3	0	0	2	2	13	7	0	0	0	0	0	11	0	4	4	0	0	0	1	2	12	18	0	12	2	141	35	2	2	79	0	1	5	6	4	8	6	1	19	3	0	0	0	1	0	1	1	2	1	2	24	24	5	0	0	18	3	51	0	2	12	7	0	0	0	0	0	38	25	1	1	0	0	72	0	0	2	2	0	4	1	0	1	0	0	2	32	7	0	1	0	0	0	0	5	0	0	0	0	0	0	0	0	0	0	0	0	0	0	1	0	0	1	0	4	0	1	0	0	0	0	0	4	0	0	1	0	0	1	0	0	0	0	0	0	0	0	0	0	0	0	0	5	0	0	0	0	0	0	0	0	5	0	0	0	1	0	1	0	0	0	27	7	5	22	0	0	1	1	3	0	1	0	0	0	4	0	0	0	0	0	0	0	2	1	0	0	2	0	0	0	1	4	0	1	13	0	0	0	0	0	0	19	0	0	53	0	0	1	8	2	5	0	4	8	0	0	1	0	0	0	0	0	0	1	1	0	0	0	0	15	1	0	0	0	0	0	0	0	1	0	0	0	0	0	0	0	0	0	1	0	0	0	0	1	1	0	3	8	0	3	0	0	1	0	0	0	5	1	15	0	0	1	0	2	3	13	1	7	16	0	0	2	0	1	3	1	10	6	0	0	0	3	0	0	3	0	6	0	0	0	0	1	1	0	1	10	1	1	30	1	1	0	1	0	0	0	8	0	6	0	0	1	3	0	0	0	0	0	0	0	0	1	0	2	0	0	0	3	28	0	2	4	0	0	0	4	0	1	1	0	4	2	12	16	1	1	0	0	3	2	0	0	8	0	16	5	1	7	0	0	0	5	5	0	2	3	0	0	0	0	0	0	4	1	1	1	0	0	0	0	0	0	3	0	0	1	0	0	0	1	1	10	0	2	1	0	5	0	1	1	2	1	0	0	0	57	0	1	4	0	4	2	2	1	6	0	6	0	1	35	2	5	0	0	2	0	1	0	1	8	2	0	0	0	20	6	8	0	4	4	14	1	0	1	2	2	1	4	0	8	55	0	0	0	0	0	0	0	0	0	0	0	0	1	0	0	0	0	0	0	0	0	1	0	0	0	0	1	0	0	0	0	0	5	0	0	0	1	0	0	0	26	0	0	0	2	5	0	0	1	0	6	0	0	0	0	5	0	0	0	0	0	0	0	0	0	0	0	1	12	0	2	1	0	1	3	2	0	5	1	0	0	5	0	1	0	0	5	2	0	1	1	0	26	11	9	1	0	0	0	0	1	0	0	194	0	4	0	0	0	0	20	27	4	2	1	1	1	0	1	43	11	9	2	74	10	0	0	25	1	0	300	0	4	2	1	11	0	6	0	0	0	0	0	0	1	79	44	0	2	0	0	0	0	0	0	0	0	0	0	0	0	19	0	18	0	4	0	1	18	0	0	85	0	1	0	1	4	0	2	0	0	5	0	0	30	5	0	5	40	0	6	1	13	0	1	2	0	76	64	11	8	2	1	1	1	0	21	7	0	31	6	0	0	0	0	0	2	0	0	0	1	5	4	0	14	0	0	0	1	0	11	7	2	0	0	0	2	0	2	0	22	0	5	5	0	1	0	0	0	0	1	0	0	0	0	2	0	1	1	0	0	0	0	2	0	4	0	0	0	4	9	0	0	0	0	1	0	0	0	1	0	1	1	0	0	0	0	0	0	0	0	0	0	0	1	0	0	0	0	0	0	0	1	0	0	0	0	0	0	0	0	1	0	0	0	1	0	0	0	0	6	0	0	4	0	0	0	0	0	0	0	0	0	0	0	0	0	0	0	0	0	0	0	1	2	0	0	6	1	0	0	0	0	0	3	0	10	0	1	0	4	0	14	0	0	0	1	0	0	0	2	0	3	0	0	0	0	23	0	3	0	0	0	0	0	0	10	0	0	0	0	0	0	0	1	0	0	0	10	0	0	1	1	5	0	0	0	7	0	9	1	1	1	0	0	0	0	8	1	0	0	4	0	1	1	0	1	0	0	0	0	0	4	0	0	7	5	0	2	0	0	0	0	4	0	0	0	2	0	0	2	0	0	0	4	1	0	2	0	2	1	0	2	0	0	1	0	0	1	0	1	0	1	0	0	2	0	1	0	0	8	1	0	2	4	2	0	6	1	2	2	5	3	0	5	7	0	0	0	0	2	0	0	0	11	0	5	0	0	6	0	0	0	1	4	0	0	0	0	0	0	2	0	1	0	0	0	3	0	1	0	0	0	1	0	7	27	0	0	0	0	0	0	0	6	1	1	0	0	4	0	0	1	0	0	0	2	6	1	0	0	0	0	14	0	0	0	1	3	3	0	1	1	0	1	5	3	2	2	0	0	0	2	0	0	0	33	1	0	0	0	3	2	0	1	0	0	0	0	0	0	0	2	3	1	0	1	1	18	0	0	0	4	1	2	0	0	1	0	0	0	7	0	1	0	0	2	3	0	0	0	2	1	0	1	3	3	1	5	4	3	0	27	0	0	2	0	1	5	1	1	7	7	28	2	2	0	2	4	3	2	0	1	37	0	0	0	0	7	23	4	0	0	32	49	1	0	0	2	2	3	0	0	4	5	0	0	1	0	12	0	2	2	0	0	0	0	40	0	20	7	0	1	3	5	7	0	4	0	3	7	1	10	0	0	2	1	2	16	0	7	10	0	1	0	0	0	0	28	2	0	0	4	0	1	1	0	0	0	50	14	47	0	0	0	0	0	1	1	1	2	0	0	1	0	1	1	0	9	1	0	4	31	63	0	0	0	1	0	0	9	2	22	0	1	1	0	0	2	6	0	0	0	0	0	36	9	0	1	0	0	0	1	0	0	69	0	0	6	1	11	0	1	1	35	0	0	2	0	14	0	0	2	1	0	0	4	0	0	0	0	14	2	11	17	0	0	2	1	2	0	0	0	0	30	0	1	4	15	15	9	0	5	1	2	0	0	0	8	0	0	3	0	0	0	2	0	0	0	0	0	2	2	1	4	7	0	0	9	0	0	10	7	0	58	0	0	12	0	45	0	0	0	1	2	0	0	1	0	6	1	0	0	9	0	0	2	1	0	0	0	0	1	17	0	0	0	0	0	0	6	16	0	0	0	0	0	0	4	0	3	0	11	0	1	2	0	2	0	0	9	1	0	0	0	54	0	0	0	0	5	0	0	87	0	0	0	0	0	0	5	4	0	0	0	0	0	0	5	5	28	0	0	3	0	3	1	0	1	3	2	0	79	6	0	5	0	0	1	0	26	1	28	2	11	0	0	2	0	3	2	2	0	6	0	0	2	5	1	0	0	0	0	0	11	1	3	0	0	1	4	0	0	2	0	7	7	2	0	1	0	0	0	5	1	0	1	0	4	6	2	0	0	0	0	0	1	2	0	1	0	2	0	0	0	0	0	1	1	0	14	2	4	0	0	0	6	1	3	6	19	0	3	1	0	48	2	0	0	0	0	0	0	0	0	1	0	0	0	23	81	0	0	0	1	70	0	118	0	1	0	0	0	1	5	2	1	111	0	14	0	1	0	16	0	0	0	1	0	8	0	11	1	0	0	1	5	18	6	9	0	9	3	3	7	2	2	1	32	10	2	12	3	38	50	80	0	4	2	0	3	11	0	4	0	1	1	0	1	0	288	0	0	2	94	0	1	58	62	0	0	11	1	0	2	1	0	23	0	0	3	0	13	0	1	0	6	1	1	0	0	0	3	0	6	11	0	1	3	0	1	46	0	0	0	0	0	0	3	2	0	0	0	0	10	0	0	0	29	10	0	0	0	0	0	36	0	0	1	0	5	0	1	0	0	0	0	2	0	0	0	2	1	1	15	2	15	0	3	3	0	7	12	0	5	3	3	0	2	0	0	0	0	47	85	92	80	0	0	0	0	29	0	5	2	3	2	26	0	5	6	9	0	1	0	13	48	0	49	9	153	34	1	112	41	196	5	37	185	5	9	669	0	37	11	0	0	0	1	0	4	0	0	0	0	0	2	0	0	1	13	0	32	1	5	13	1	8	30	39	0	0	8	0	0	0	0	0	0	0	0	0	75	5	34	40	0	5	0	0	50	6	27	52	34	36	1	0	63	0	42	5	0	45	10	0	0	2	1	0	1	0	0	0	0	0	2	0	6	24	26	2	10	0	48	17	14	4	0	11	0	11	1	21	0	237	3	4	0	9	51	11	0	8	38	8	1	4	5	0	10	18	3	4	9	39	0	25	100	15	31	34	42	3	84	87	0	4	411	0	4	31	1	0	8	44	0	76	9	0	2	1	15	3	0	167	1	27	13	4	11	0	3	2	15	3	20	3	49	81	33	9	0	1	0	1	23	3	26	4	156	6	10	88	52	18	2	1	0	21	12	2	1	12	20	19	40	0	0	48	0	0	114	11	22	8	30	0	8	6	0	2	5	4	1	115	0	0	5	0	101	0	6	0	5	1	57	0	3	0	34	10	14	2	3	2	1	0	4	7	12	67	3	0	14	32	6	11	15	12	9	5	5	2	3	2	10	2	0	0	3	16	2	0	2	0	277	2	2	13	13	42	2	0	10	0	22	34	0	0	3	0	26	42	4	4	3	1	2	0	0	1	1	8	7	2	3	0	0	4	18	0	1	33	4	0	50	2	1	2	2	0	0	0	1	0	44	3	0	0	3	1	2	3	0	57	3	0	53	2	11	2	7	5	0	0	0	0	0	0	1	0	0	0	0	0	0	6	15	0	0	0	1	0	1	42	0	0	13	0	0	0	1	1	0	0	2	0	0	36	0	23	17	0	2	0	4	0	1	2	14	0	0	0	0	0	0	0	0	0	2	0	0	0	5	0	0	0	0	0	0	2	0	0	0	0	10	0	0	0	0	0	2	0	5	0	5	0	0	3	0	3	8	0	0	0	0	0	3	3	1	0	0	5	10	0	2	7	2	6	2	0	0	0	2	0	0	1	2	0	4	0	0	3	1	0	0	14	0	0	0	2	0	0	2	22	0	0	2	2	1	0	2	0	0	0	0	0	2	1	0	1	0	0	0	0	0	0	1	0	0	0	0	0	0	36	0	0	0	0	0	0	0	2	1	2	23	2	0	0	0	1	4	2	2	1	0	0	3	0	0	1	0	0	0	2	0	0	8	1	8	0	0	1	0	0	5	0	0	1	0	0	0	0	1	0	0	0	0	0	0	0	4	0	0	1	3	0	0	0	1	0	1	0	0	0	8	0	155	0	1	0	1	0	2	13	0	0	1	1	0	0	3	0	0	23	0	5	0	0	0	2	5	0	5	4	0	0	0	4	0	0	59	1	1	1	1	0	0	2	7	0	0	7	2	3	0	0	0	0	0	0	0	0	6	8	0	2	0	1	0	0	0	1	1	0	3	0	1	5	3	0	4	3	1	0	0	3	0	1	0	0	0	0	2	1	0	0	14	12	193	21	2	0	4	6	22	39	40	16	22	0	19	20	0	22	11	0	0	14	38	0	4	2	10	0	0	35	1	0	3	253	0	2	0	2	2	0	0	0	0	13	1	0	0	1	3	0	0	17	1	0	0	0	23	0	0	1	0	15	10	12	14	54	23	64	1	1	7	0	36	16	0	6	5	0	0	0	0	0	0	17	3	19	4	1	0	0	4	0	1	0	0	4	7	0	0	6	17	12	32	0	1	0	22	0	0	35	16	0	0	0	39	29	0	0	0	9	10	0	3	0	0	0	1	0	0	0	0	1	0	0	0	0	0	1	0	1	0	0	0	0	0	0	2	0	0	3	1	0	7	0	20	0	0	0	1	0	0	1	0	0	0	0	0	1	7	0	3	0	0	0	0	0	1	0	0	0	0	0	8	0	0	0	3	0	5	3	0	4
PHYLLO27	96070	0	0	0	427	1656	176	1	404	3	20	99	70	0	189	2	0	6	0	2	11	0	0	5	54	3	0	19	12	42	5	0	14	24	9	40	48	0	0	0	0	0	0	0	25	0	0	0	0	10	10	0	70	152	287	5	725	9	10	0	64	0	7	15	66	170	0	29	15	0	35	2	0	0	5	4	5	0	0	0	0	0	402	269	123	100	0	75	1	31	3	175	45	197	109	26	120	9	193	0	2	391	4	411	1	145	246	4	13	30	1	0	58	42	1	98	27	44	0	2	133	17	100	11	38	331	80	112	24	28	31	17	0	8	4	4	0	403	57	16	45	79	88	15	3	71	19	12	24	49	10	0	4	18	1	0	0	3	172	116	55	1	2	158	6	105	185	110	25	38	5	44	51	8	30	14	0	19	29	0	43	7	44	22	14	10	90	0	0	5	13	60	1	0	0	3	37	232	3	0	36	17	3	38	4	26	1	65	1	13	144	29	33	0	461	672	9	58	8	46	23	26	79	27	208	16	192	76	101	10	208	16	19	45	5	2	13	0	114	1	44	18	130	33	2	15	0	17	87	32	0	0	99	9	161	1	21	21	148	11	6	10	15	0	8	4	27	54	40	42	65	29	50	3	23	9	2	8	0	75	216	25	74	9	161	143	19	8	78	4	86	0	0	19	84	15	143	0	8	16	9	25	282	9	0	1	1	62	60	114	161	40	14	1	2	20	0	59	1	63	0	85	21	7	1	5	1	10	66	2	0	70	1	0	3	0	0	2	0	14	118	42	3	117	280	11	5	0	59	14	22	6	9	52	152	0	36	42	15	35	48	45	5	8	0	0	49	75	15	82	2	39	47	59	12	42	122	26	19	175	48	42	38	38	10	10	232	116	25	4	447	1	3	2	5	7	6	22	581	0	14	12	144	0	852	93	0	0	60	51	170	177	2	0	2	16	0	0	3	59	107	62	8	0	110	0	62	149	284	0	1	4	1	0	1	28	238	17	16	45	216	7	83	45	90	154	98	54	120	2	7	104	179	43	128	71	29	547	43	61	0	0	0	0	0	0	4	0	3	1	4	2	10	2	3	5	5	5	2	0	164	14	0	19	4	2	0	0	1	23	0	2	8	0	25	0	1	1	0	1	0	0	0	1	0	2	7	4	0	9	2	1	1	0	73	262	219	11	70	17	50	424	25	84	180	8	254	0	102	23	5	2	12	0	64	66	42	12	107	142	14	64	5	13	48	194	75	37	1	17	8	43	15	23	40	16	7	65	65	90	30	35	13	66	45	2	2	0	0	33	8	13	4	72	61	4	181	48	0	44	0	6	27	13	47	1	9	46	17	60	13	3	17	3	0	1	7	3	0	3	0	1	48	91	0	11	29	1	0	3	0	0	100	0	6	19	17	1	59	0	19	0	3	1	1	2	5	1	0	15	0	0	22	0	27	72	15	0	0	30	0	5	48	0	52	8	0	1	5	0	24	37	328	34	28	0	28	32	0	40	147	5	8	0	4	25	124	20	92	9	34	1	18	58	185	12	18	108	34	1	69	107	33	86	35	38	0	3	52	35	6	13	92	0	0	1	17	0	16	0	4	23	46	1	0	1	60	4	15	17	0	62	22	30	35	66	86	31	116	326	35	4	0	89	39	0	1	12	1	40	24	4	1	3	0	23	55	0	11	0	5	20	18	14	24	0	0	14	6	1	25	99	40	49	17	102	0	43	48	0	9	10	8	97	72	25	17	83	16	44	0	31	0	41	26	17	5	47	35	4	85	31	8	1	2	2	9	1	0	0	1	8	0	41	56	0	12	0	1	15	18	40	40	22	26	6	3	0	1	7	8	1	83	12	31	8	31	3	76	18	0	6	40	75	16	31	2	0	3	0	2	0	12	0	0	5	2	1	0	0	41	1	15	19	1	2	27	2	21	20	27	17	1	0	1	0	52	32	0	1	42	3	7	4	0	0	1	16	0	32	2	1	23	19	14	13	40	0	0	3	7	0	9	4	3	65	10	23	31	9	15	3	29	1	15	0	9	0	2	24	17	10	0	1	0	8	0	3	0	22	5	10	27	203	34	25	15	0	175	0	6	0	9	16	31	31	0	0	4	0	0	0	0	3	3	23	0	9	22	19	11	2	32	12	16	3	3	95	3	42	0	11	16	80	15	4	2	8	0	0	228	2	29	0	2	15	2	2	8	0	4	11	0	2	1	1	0	0	82	24	1	291	3	0	1	12	106	63	0	48	5	7	1	0	3	0	0	0	47	3	3	2	12	4	0	0	42	169	21	0	78	2	16	3	44	6	0	0	5	3	59	1	3	2	7	31	60	82	68	29	8	0	0	1	1	15	0	25	11	0	0	0	0	71	3	0	53	2	0	33	5	0	1	35	23	2	19	14	52	0	4	94	0	5	4	3	32	8	2	98	108	0	44	2	2	11	10	2	48	13	17	36	18	18	62	26	16	58	39	70	19	2	0	5	1	0	66	0	69	30	187	124	47	52	106	27	51	27	86	62	0	6	127	31	235	31	62	65	2	26	77	0	18	59	4	45	111	0	12	68	46	48	26	3	0	7	1	0	1	59	13	70	13	38	30	44	37	18	97	16	1	21	77	2	18	13	104	2	1	115	14	4	0	0	67	45	0	77	0	24	3	23	0	9	0	1	42	17	0	10	5	15	0	0	16	22	0	25	24	3	36	4	1	11	12	0	61	2	6	0	6	20	24	24	4	0	0	29	2	21	26	27	7	22	0	3	6	0	9	172	0	0	7	58	6	0	2	17	40	19	6	0	0	0	2	0	0	6	0	5	0	1	19	41	2	11	11	3	2	4	25	0	17	0	33	31	0	30	3	0	15	0	14	15	1	0	0	0	14	1	33	0	11	23	113	4	22	0	1	1	0	7	2	0	2	51	0	3	3	1	0	1	2	0	0	49	2	14	4	0	0	2	18	19	0	0	2	5	5	0	6	23	20	2	0	1	6	13	2	26	0	0	0	14	74	11	2	1	19	1	4	11	18	175	1	5	0	2	0	11	2	16	14	0	34	3	1	29	7	0	1	1	5	0	0	0	4	2	1	13	8	27	16	118	7	30	5	32	1	0	2	15	34	7	115	3	0	0	0	1	4	6	1	1	3	2	2	3	2	0	1	0	0	0	1	0	20	0	10	4	0	1	0	34	6	10	0	20	0	0	2	2	41	0	28	9	17	5	0	0	65	16	2	8	0	0	15	19	0	40	0	0	10	3	2	2	0	10	1	1	12	5	0	2	1	5	29	5	10	43	1	0	0	3	2	120	1	1	11	4	0	0	196	11	12	10	4	1	0	33	5	0	1	0	0	1	0	1	0	0	1	0	0	57	2	32	0	0	1	0	78	2	0	9	0	0	1	0	0	0	12	0	20	7	42	5	19	7	0	4	7	67	1	0	0	3	2	3	20	3	3	0	85	15	1	0	4	0	0	0	0	0	0	0	0	0	0	0	0	0	54	0	0	7	141	47	2	0	0	0	0	73	18	0	8	0	2	2	0	0	0	2	52	5	13	39	62	8	12	22	6	3	25	2	43	58	41	3	15	2	170	8	4	45	15	1	3	19	2	0	1	37	0	35	29	29	0	7	0	1	0	2	13	25	8	16	0	1	6	1	0	23	27	37	14	21	13	0	2	0	5	14	3	1	0	64	7	6	0	0	11	41	10	1	9	9	0	0	0	21	34	0	0	1	3	6	49	15	3	12	17	40	3	8	899	0	17	13	3	8	8	4	34	100	23	8	10	1	10	7	24	12	5	0	37	3	6	17	93	0	0	39	14	15	20	17	9	15	5	2	6	80	2	7	3	2	0	7	1	3	4	19	10	9	13	8	1	22	2	6	0	11	2	0	3	9	19	0	2	0	6	81	19	3	20	0	10	10	9	13	9	24	3	1	22	18	13	14	26	3	40	5	1	2	4	7	6	1	28	5	4	1	2	8	23	1	6	22	168	1	0	3	8	4	3	21	0	8	15	16	2	12	1	22	0	15	7	3	7	33	2	0	8	26	11	9	3	67	0	12	1	8	22	5	1	15	49	40	4	2	27	7	2	20	19	49	3	0	2	19	16	15	1	93	104	83	0	14	27	9	76	1	1	25	5	28	61	0	0	24	23	113	275	263	43	40	40	255	195	15	1	315	184	47	87	43	107	215	101	1	24	15	0	0	0	10	3	9	1	44	100	126	5	45	0	79	183	37	2	5	67	0	6	121	0	78	0	0	0	6	2	77	89	31	49	0	17	16	0	0	111	1	157	1	3	0	0	24	129	15	2	52	20	106	114	0	100	99	96	56	14	2	0	36	36	1	0	1	124	42	112	64	1	29	30	42	0	11	1	2	80	36	16	73	1	0	1	0	143	0	16	8	1	25	0	22	28	2	0	41	0	2	0	0	0	22	3	0	73	22	0	0	80	2	1	1	0	0	4	37	2	0	0	2	0	0	0	0	1	3	0	1	8	5	0	31	0	3	0	3	21	3	3	23	1	15	0	0	15	7	5	32	4	1	25	32	11	10	1	12	2	16	5	2	0	5	0	0	4	0	1	0	1	16	23	0	0	9	31	7	33	1	11	40	47	61	6	4	1	3	167	0	0	0	0	7	10	54	397	36	0	4	0	1	0	0	2	5	2	0	0	0	0	38	0	7	20	6	10	22	0	50	2	0	18	12	4	1	0	10	17	0	0	0	16	1	5	0	0	0	0	1	0	0	3	35	0	0	1	0	1	0	2	0	12	11	8	18	0	2	0	4	8	0	2	1	0	0	1	23	19	2	0	0	2	0	5	6	22	7	38	25	20	8	1	28	6	9	0	1	0	0	0	0	0	10	7	1	15	16	1	26	15	0	0	1	1	0	70	0	0	1	1	0	0	0	12	2	0	1	2	2	57	1	19	2	0	0	0	8	2	1	0	2	0	0	0	17	0	2	2	9	0	13	0	0	39	1	1	5	1	71	44	43	10	14	0	18	18	2	2	0	10	15	88	77	43	7	7	7	406	0	85	7	11	3	3	54	0	36	2	46	36	56	19	0	0	0	0	0	0	0	0	7	2	1	42	0	0	4	0	0	1	0	10	14	10	5	10	6	3	0	2	9	0	0	1	49	21	8	6	6	0	0	9	7	2	2	6	3	5	0	0	1	0	52	10	7	1	0	3	16	1	4	5	18	0	9	0	2	8	0	0	0	2	4	16	0	58	34	28	1	33	3	2	1	16	0	0	0	13	5	0	7	3	1	0	0	0	3	0	0	11	0	0	1	0	0	0	0	3	1	0	10	17	5	3	6	24	16	32	25	30	25	8	2	0	0	72	0	10	66	63	0	0	1	73	57	3	2	0	1	1	4	59	9	21	18	8	69	1	0	1	3	12	5	1	0	12	7	131	2	18	0	16	12	2	3	1	0	4	19	6	29	1	2	34	10	64	47	1	7	0	0	2	2	11	10	12	6	2	7	0	12	0	28	0	0	13	0	12	1	1	5	3	2	0	0	2	4	1	0	0	11	1	0	0	0	0	0	0	6	2	4	0	0	13	1	4	1	0	0	0	6	6	1	0	32	3	8	9	0	0	0	7	0	3	0	0	21	7	0	10	2	0	0	1	0	2	0	1	0	12	0	0	0	1	0	5	1	2	1	0	6	0	0	1	0	7	0	4	0	0	19	19	4	52	16	75	29	2	3	50	2	3	0	0	8	3	2	0	23	12	21	17	0	0	16	2	24	0	3	0	4	0	0	0	0	142	3	9	4	2	0	2	12	6	0	0	0	4	0	2	9	25	5	3	0	1	0	1	16	4	1	0	0	0	12	0	0	0	23	8	3	0	0	2	0	1	1	13	1	1	375	0	1	0	3	1	0	1	1	0	1	1	35	0	3	38	7	5	2	3	0	7	0	48	0	1	9	0	1	0	2	4	15	0	1	1	0	1	18	0	0	0	36	0	0	1	2	0	0	2	14	0	2	0	3	0	3	0	0	13	0	1	1	1	0	3	11	0	2	0	3	0	0	0	0	2	2	0	0	0	0	0	12	1	9	5	10	0	21	1	0	0	0	0	0	0	0	22	0	9	0	2	4	0	0	4	3	2	0	10	24	1	14	4	23	0	9	0	0	0	3	2	0	0	0	1	6	0	9	0	1	15	2	4	3	0	6	15	9	0	7	0	0	16	6	5	0	3	1	5	3	0	0	0	15	13	4	14	0	1	0	0	4	0	2	0	0	2	1	0	0	0	8	15	5	3	0	16	14	3	27	2	4	1	5	1	0	0	7	0	0	29	1	37	1	4	0	10	2	12	71	0	5	0	1	2	11	0	4	1	8	6	3	2	1	2	1	1	0	0	11	18	1	1	3	3	2	4	1	38	1	1	8	1	2	1	2	2	1	5	14	4	4	11	11	0	5	0	0	6	0	0	48	5	9	5	7	0	12	1	7	14	0	4	0	51	0	0	1	7	0	2	2	3	0	0	0	0	3	1	0	3	0	8	2	0	0	2	2	2	4	1	1	0	7	21	0	1	0	0	0	4	9	6	1	2	3	3	6	4	3	5	2	1	6	3	0	0	0	0	1	4	1	0	0	0	7	0	6	81	152	86	17	0	39	20	0	0	120	140	145	0	141	9	9	0	1	1	0	0	1	0	2	0	0	101	0	2	2	11	0	95	0	0	0	0	29	0	0	0	5	1	3	7	0	0	0	0	0	0	2	0	20	0	0	0	39	0	6	0	0	1	0	0	1	39	0	87	0	0	5	0	1	0	7	0	0	0	0	2	5	2	0	8	4	6	0	1	0	44	3	1	0	0	0	1	0	0	1	5	1	0	0	0	0	0	0	0	0	1	31	1	0	0	0	11	3	0	0	0	0	1	1	0	234	0	0	5	0	0	0	0	2	0	116	0	0	0	0	0	0	1	1	0	0	0	110	0	0	50	3	2	2	0	0	2	1	0	0	0	0	0	0	1	1	0	1	7	13	0	2	0	8	9	3	0	11	0	9	1	7	20	12	15	0	0	0	0	16	7	7	6	3	0	0	2	164	9	0	2	0	0	0	1	0	1	1	5	160	171	0	166	0	0	0	0	0	0	7	2	1	3	0	0	1	2	2	0	0	1	0	1	2	1	0	4	17	0	0	17	6	0	1	2	1	0	0	0	0	10	0	28	2	0	3	27	1	0	0	0	1	6	2	0	4	0	1	2	1	3	0	3	0	0	0	7	6	3	5	0	3	8	0	1	1	31	12	5	1	0	2	1	1	0	0	1	0	39	0	4	10	1	5	1	1	1	3	27	7	13	37	0	1	0	0	0	0	0	17	35	3	34	13	39	89	2	22	16	64	13	0	5	0	2	0	50	32	5	1	2	7	24	7	15	11	53	3	6	3	0	24	0	14	1	0	0	9	2	0	0	0	0	5	0	5	0	7	0	0	0	0	2	0	17	0	0	2	0	1	0	1	0	5	16	3	0	0	0	0	1	2	68	1	33	1	30	0	2	0	1	1	0	1	4	4	0	2	22	0	1	14	2	11	0	0	7	4	0	0	1	1	8	0	36	0	21	7	0	27	0	0	0	4	0	0	0	1	35	3	0	0	3	0	0	7	6	1	1	0	7	1	6	0	0	2	1	0	0	0	3	23	55	9	0	27	1	3	0	1	2	0	1	0	0	2	2	1	27	0	1	0	0	0	31	2	0	5	4	0	4	6	4	0	5	4	2	0	0	30	26	3	0	3	0	0	9	0	1	14	0	21	19	0	1	0	0	0	1	0	0	5	0	8	1	18	4	1	0	0	0	1	8	0	3	71	0	0	18	0	0	1	3	2	0	0	0	19	2	0	0	10	0	0	0	2	6	0	5	0	0	1	0	9	0	0	0	11	3	3	0	4	0	22	0	0	0	0	1	0	2	0	3	1	0	0	0	0	0	5	0	10	0	0	0	0	1	11	1	0	29	1	21	2	1	2	27	49	4	9	3	12	5	1	28	0	0	10	0	0	0	0	7	1	2	8	2	1	0	1	0	0	5	0	2	0	4	1	1	0	8	0	0	2	5	2	0	0	35	2	0	0	0	0	0	0	0	0	2	3	1	0	1	0	3	2	2	14	0	0	0	0	0	7	8	0	2	0	2	0	5	1	0	5	1	0	1	1	20	1	2	8	0	2	0	1	14	14	0	1	1	3	0	0	0	0	0	0	2	0	23	7	3	1	0	0	5	4	7	0	1	10	0	7	3	3	0	0	1	0	0	0	1	0	1	15	21	23	0	11	11	0	0	0	22	5	0	0	0	3	2	1	1	0	5	1	1	2	9	0	6	1	0	1	3	0	0	2	0	1	24	1	3	0	26	1	0	0	0	9	3	1	0	0	0	1	0	0	18	3	0	0	7	0	0	1	0	0	1	0	3	1	1	0	4	0	0	0	0	1	0	0	1	0	1	27	0	67	0	0	64	10	0	0	2	2	0	46	0	1	29	0	13	0	27	10	0	2	7	9	0	0	0	23	0	0	0	0	0	26	8	0	2	1	2	35	14	0	0	0	0	1	0	0	1	9	0	0	16	0	0	2	1	0	1	0	0	0	1	0	0	1	7	0	0	2	2	1	4	0	0	0	0	2	13	2	34	0	0	0	1	0	1	4	4	0	0	0	0	1	42	24	17	0	1	0	1	2	1	0	0	0	2	0	2	0	1	3	49	0	8	0	0	0	1	0	1	1	6	33	0	9	0	0	3	0	29	5	2	4	0	1	3	51	10	0	3	2	4	3	0	52	3	0	0	2	8	0	1	2	7	0	0	3	1	5	2	10	1	1	3	18	0	1	8	4	0	0	41	0	9	0	3	0	7	11	47	32	9	4	3	2	0	0	1	1	8	7	1	0	0	3	0	0	3	0	2	0	2	0	0	1	0	0	0	0	1	0	0	0	0	0	0	5	1	1	0	0	0	4	2	0	0	2	5	0	0	1	2	0	0	0	2	0	0	0	0	3	0	1	1	0	27	12	11	0	18	20	0	3	8	1	2	1	0	14	10	1	0	2	0	0	6	0	5	2	0	3	0	2	0	4	0	3	0	1	0	3	6	0	0	0	0	3	0	2	0	1	0	0	0	2	8	0	0	0	1	0	0	0	9	0	4	3	11	0	0	22	1	5	0	11	0	1	0	0	0	0	0	0	0	1	0	1	0	1	0	0	1	0	5	0	0	0	6	0	0	27	2	0	0	0	4	0	0	2	6	5	0	0	1	1	1	0	0	4	0	29	1	0	2	23	1	53	4	0	1	0	2	0	0	2	2	0	8	0	0	2	0	0	0	6	0	3	0	0	2	0	1	0	1	0	1	0	2	1	0	1	2	1	0	0	0	3	0	0	1	17	1	3	6	0	1	1	1	1	2	5	2	0	0	2	0	0	0	0	4	0	3	21	0	4	3	0	0	0	2	1	0	7	2	1	0	0	1	0	2	1	0	0	0	0	0	0	0	0	13	0	0	0	0	12	21	13	1	1	0	1	3	12	0	2	6	4	31	29	8	1	6	7	6	1	1	0	33	1	9	0	0	0	96	103	5	12	64	0	2	3	1	0	33	0	2	0	27	0	0	2	0	1	2	0	40	0	0	0	0	5	2	0	0	12	0	0	0	5	1	20	0	1	0	0	0	0	27	18	3	6	18	2	5	6	0	2	0	0	0	0	1	0	0	0	0	1	1	1	1	0	13	1	1	0	0	1	3	0	36	1	2	1	0	31	0	21	0	24	0	0	0	33	0	0	78	0	13	0	5	24	11	0	175	0	784	22	13	14	10	6	1	2	0	0	0	37	30	2	0	0	1	593	0	38	0	32	2	5	247	43	7	41	66	46	54	54	173	3	1	14	2	1	1	5	0	42	1	0	0	3	0	0	9	0	2	1	1	0	1	0	2	0	9	0	1	2	0	1	2	0	20	20	0	0	0	13	0	0	0	0	4	0	0	0	0	11	0	7	2	1	5	0	0	1	4	1	0	1	0	0	0	31	0	0	0	0	0	0	0	0	6	0	1	76	1	18	3	1	4	2	15	1	0	17	0	0	0	1	2	2	0	0	0	0	3	8	0	23	28	0	2	0	0	0	2	0	1	0	5	0	60	0	23	3	134	0	0	7	14	2	26	0	0	2	1	23	332	18	25	65	0	0	0	0	0	4	0	21	1	1	5	9	0	21	0	7	5	10	15	5	12	20	0	0	0	0	0	4	0	0	1	0	1	0	0	2	2	2	1	0	0	0	32	0	2	2	2	1	0	22	0	0	0	0	1	0	4	0	1	0	0	1	0	0	0	0	0	23	12	1	1	3	0	0	0	0	2	55	0	1	4	0	0	0	0	0	0	0	0	0	0	9	10	291	75	14	0	19	130	262	0	19	5	0	3	10	0	2	37	0	23	42	0	70	36	0	0	0	0	0	0	0	18	39	0	0	7	0	0	1	8	2	2	0	0	1	1	2	1	1	0	13	0	0	2	19	10	9	19	0	14	10	43	0	16	12	29	0	22	5	6	7	160	3	13	2	2	0	1	6	6	0	16	3	4	0	0	0	7	7	6	3	1	6	5	1	0	3	0	0	0	2	58	1	1	0	0	16	4	0	0	1	2	0	2	0	0	1	0	22	1	0	16	24	21	0	9	168	108	0	38	0	0	3	56	0	3	11	7	41	2	8	2	0	13	0	1	2	0	3	1	2	0	1	2	47	5	4	15	0	20	73	0	2	0	1	0	0	0	3	0	0	2	0	9	0	0	5	0	32	28	21	11	6	16	9	0	0	2	34	2	34	22	34	17	0	1	0	0	0	0	1	0	1	0	0	0	0	0	0	0	0	1	1	0	1	0	0	0	0	0	0	0	3	0	3	0	1	0	0	0	1	0	0	0	0	0	4	0	0	0	0	0	0	1	0	1	0	0	3	1	0	3	2	0	0	0	0	0	0	0	1	0	0	0	0	1	1	0	0	0	0	1	22	0	0	0	6	29	0	10	57	1	1	2	19	0	0	0	0	0	0	1	0	0	0	6	5	0	5	0	0	6	5	0	0	0	0	0	0	0	0	1	6	0	0	0	0	0	0	0	0	15	2	1	4	0	0	0	2	0	0	4	2	4	0	0	3	0	1	0	0	0	0	1	16	1	0	0	2	1	0	2	0	0	0	1	10	0	13	0	0	12	5	0	0	0	0	0	3	0	0	1	1	0	6	0	0	0	0	0	0	0	0	0	0	0	0	0	1	0	0	0	0	0	0	1	0	0	0	3	0	0	0	0	1	0	0	0	0	0	0	0	1	1	0	0	0	6	0	0	0	6	6	1	3	2	0	0	0	0	0	0	0	16	0	0	0	0	0	0	0	0	0	0	2	0	0	0	0	1	1	0	0	0	0	1	0	0	2	0	1	0	0	0	18	1	25	2	0	0	0	0	0	0	0	4	6	0	0	0	0	1	1	0	0	11	3	2	0	0	5	0	3	0	2	0	0	0	5	1	6	0	0	0	0	0	0	0	7	15	0	0	2	32	0	0	0	0	1	0	1	3	0	4	1	2	1	0	0	0	0	1	0	0	0	0	46	0	0	0	0	5	0	0	0	0	8	0	0	0	0	0	11	4	0	0	0	2	9	15	5	1	1	0	0	0	0	20	0	2	8	0	0	0	1	3	6	16	0	7	2	82	27	1	0	41	0	0	1	1	1	6	4	3	4	2	0	0	0	0	0	0	1	0	5	1	16	21	0	0	0	27	0	20	0	5	14	0	1	1	0	0	2	12	4	0	1	0	0	64	1	0	1	0	0	0	0	0	2	3	0	0	16	3	0	0	0	0	0	1	2	0	1	0	0	0	0	1	0	0	0	9	1	0	0	2	0	0	1	2	0	0	0	0	0	2	3	0	1	0	0	0	3	0	5	1	0	0	0	0	0	0	0	0	0	0	0	0	0	1	1	0	0	0	0	1	0	5	1	0	0	0	0	0	0	0	1	6	8	3	7	0	1	0	0	0	0	0	0	4	0	0	0	0	0	0	0	0	0	0	1	1	0	0	0	0	1	0	0	1	0	12	0	0	4	0	0	0	3	5	0	0	0	0	0	0	1	12	0	0	2	0	0	0	1	1	0	0	0	0	2	0	2	0	0	1	6	0	3	4	1	0	1	2	0	0	0	0	0	0	0	0	0	0	0	0	0	0	0	0	2	0	1	4	1	0	1	1	0	1	4	0	3	1	0	0	0	0	0	0	1	0	1	0	8	5	0	0	6	2	0	0	0	13	10	2	0	1	4	0	0	2	0	0	0	1	0	0	0	0	0	0	2	0	1	12	1	0	0	0	0	0	0	1	3	4	0	1	1	1	0	0	0	0	0	1	0	0	0	0	0	0	0	0	4	1	0	1	0	0	0	1	8	0	0	0	0	0	0	3	9	2	0	0	0	0	0	0	0	4	0	10	3	2	4	0	0	0	8	1	0	0	0	0	0	0	1	0	0	2	0	0	2	0	0	0	0	1	0	0	0	0	0	0	0	0	0	0	1	0	0	0	0	4	0	2	0	0	0	0	0	3	21	3	0	0	1	0	2	1	0	10	2	11	1	1	53	0	2	0	0	2	0	2	0	2	1	2	0	0	0	0	0	1	0	4	6	1	2	0	4	0	1	0	7	4	2	43	0	0	0	0	1	0	0	1	0	0	1	0	1	0	0	0	1	0	0	6	0	0	0	0	0	0	0	0	0	0	0	2	6	0	0	0	1	0	2	0	17	1	0	1	0	1	0	0	0	0	5	1	0	0	0	1	0	0	0	0	0	1	0	0	0	0	0	1	0	1	1	0	0	0	1	0	0	1	0	0	1	1	0	0	0	0	1	2	0	2	1	0	16	7	20	1	0	0	1	0	0	0	0	134	0	0	0	1	0	0	15	18	0	0	0	0	0	0	0	33	8	2	11	32	9	0	1	8	0	1	224	9	3	0	3	2	2	5	1	1	1	0	0	0	0	54	9	2	0	0	0	2	0	0	3	0	1	0	0	0	0	6	0	6	1	0	1	0	16	1	1	43	0	0	1	1	2	0	0	0	1	0	0	1	17	3	0	1	11	0	16	0	13	0	1	1	0	32	23	8	5	2	2	2	2	1	9	1	0	14	0	0	0	1	0	0	3	2	0	4	0	0	2	0	7	2	0	0	0	0	2	3	0	0	0	0	0	0	0	0	27	0	0	1	3	0	1	0	2	0	0	3	1	0	0	0	0	0	1	0	5	1	0	0	2	2	0	0	0	3	3	0	1	0	2	0	2	0	1	0	1	0	0	0	0	0	1	0	0	0	0	0	1	0	0	0	0	0	0	0	0	1	0	6	3	0	0	0	0	0	0	0	0	0	1	0	4	1	0	0	2	0	4	0	0	2	0	1	0	0	0	0	2	0	0	0	0	0	4	0	0	0	0	3	0	0	0	0	0	0	0	0	0	0	0	0	0	0	0	0	0	4	23	0	2	0	0	0	0	0	1	0	1	0	0	0	1	5	1	0	2	2	1	0	0	1	9	0	0	0	0	0	1	1	0	5	0	0	2	0	0	0	1	10	0	1	0	0	0	0	1	0	0	0	1	0	0	0	0	3	0	0	0	0	0	1	0	0	3	0	1	0	2	0	0	0	4	0	0	0	0	0	0	6	0	0	0	1	0	0	0	0	0	1	0	1	21	0	1	0	1	0	1	0	0	0	0	2	0	0	0	0	0	0	0	1	0	0	0	0	0	0	0	7	0	1	0	8	0	0	0	3	0	0	1	0	2	0	1	0	0	0	0	0	5	2	2	0	0	0	0	0	0	0	0	0	0	0	0	0	0	0	0	2	0	0	0	0	0	0	0	0	0	0	0	7	21	0	0	0	0	1	0	0	4	1	0	1	0	7	2	5	5	0	0	0	3	3	0	0	1	0	2	2	0	1	0	0	1	1	0	0	6	0	0	2	0	1	3	1	5	0	0	0	0	0	20	0	0	0	0	1	9	3	0	0	0	15	1	0	0	0	4	0	0	1	0	0	7	0	0	0	1	3	0	0	3	0	0	0	1	7	0	2	0	2	3	0	0	0	0	2	1	0	0	7	0	0	2	1	10	2	19	0	1	0	0	0	0	0	3	5	5	17	0	0	3	1	11	5	0	0	0	22	0	0	0	0	10	30	17	1	3	30	59	2	0	0	12	1	8	0	0	4	0	0	2	1	0	18	0	2	0	0	0	0	1	28	0	15	2	0	1	0	0	1	0	3	1	6	1	0	0	2	17	0	1	2	7	1	9	7	0	5	0	1	0	0	8	0	0	2	6	0	7	2	17	1	0	19	9	32	1	1	0	0	4	0	5	1	0	0	0	0	2	1	8	0	62	1	0	0	28	66	0	0	1	3	0	0	15	0	5	2	0	1	1	1	5	12	0	0	0	0	3	28	39	0	0	0	2	0	0	0	0	50	0	0	1	0	6	0	0	1	24	0	0	5	0	3	1	0	1	0	0	0	13	0	0	0	1	15	2	5	0	0	1	0	1	0	0	1	0	0	9	0	1	1	0	0	0	0	1	0	0	0	0	2	0	1	1	1	3	0	0	2	0	0	1	4	0	0	0	2	15	1	0	0	0	0	0	1	2	0	32	0	0	6	0	33	3	1	3	0	0	0	0	3	0	7	0	0	2	3	0	0	2	0	0	0	1	0	0	62	1	1	1	1	0	0	9	9	1	0	0	1	2	0	1	0	0	0	6	0	0	0	0	0	0	0	4	5	0	0	0	34	0	0	0	0	5	0	4	70	2	1	0	0	0	0	5	9	0	0	0	0	0	0	10	6	8	0	0	1	0	1	6	4	2	5	0	1	24	5	1	1	0	0	6	1	10	3	7	0	5	1	0	0	0	1	0	0	8	2	0	0	0	1	0	1	0	4	1	0	5	1	1	1	0	1	2	2	0	5	0	2	1	4	0	2	0	0	0	1	3	0	1	0	8	7	1	0	9	0	0	1	0	4	0	0	1	0	1	6	0	0	0	0	0	0	1	0	2	0	0	0	2	0	2	2	11	0	8	0	1	45	2	0	0	0	0	0	0	0	0	0	0	1	0	17	52	2	3	0	8	40	0	53	2	0	0	0	5	2	0	0	2	27	0	11	0	0	0	1	0	0	0	0	0	3	1	5	4	0	0	1	10	4	6	3	0	3	0	4	42	14	35	34	28	9	4	6	8	4	35	29	0	1	0	2	0	5	0	3	0	0	0	0	2	0	173	5	6	1	55	1	1	30	50	0	0	4	0	0	2	1	0	7	0	0	0	0	8	0	10	5	2	0	0	1	0	0	1	0	0	6	0	2	0	0	3	65	0	2	0	0	0	1	0	0	2	0	0	1	10	0	0	0	1	7	0	0	0	0	0	3	0	0	0	0	5	0	2	0	1	0	0	0	0	0	1	1	3	2	10	6	7	0	6	2	0	1	10	0	4	7	0	0	1	1	0	0	0	25	45	49	65	1	0	0	0	13	0	3	1	0	2	17	0	4	23	0	1	0	8	2	41	0	19	8	66	12	0	91	33	97	3	10	72	3	7	329	0	20	5	0	1	1	0	0	2	0	0	0	0	0	7	0	0	1	13	1	13	0	9	1	4	13	26	52	0	0	0	0	0	0	0	8	0	0	0	0	62	2	24	12	0	0	0	0	12	4	22	38	53	14	2	0	71	1	18	0	0	38	0	0	0	1	0	0	0	0	0	0	1	0	2	0	9	26	13	3	0	0	47	8	18	2	0	4	0	4	1	20	0	153	3	3	2	4	35	2	0	14	38	12	1	4	6	0	1	19	1	2	9	20	2	18	115	15	26	46	18	9	62	82	0	2	175	2	1	7	0	0	26	29	0	21	7	0	1	0	12	0	0	86	2	14	7	9	5	0	2	0	16	3	11	2	47	73	15	7	0	4	1	1	8	0	25	0	122	2	7	48	31	19	3	1	1	15	4	1	1	9	4	3	5	0	0	1	0	0	61	17	19	0	2	0	3	11	0	1	6	1	3	68	3	1	1	0	54	0	2	0	5	1	43	0	0	4	17	3	9	7	0	0	0	0	4	12	10	51	0	0	1	21	2	14	14	12	4	1	4	0	1	1	1	0	0	0	1	16	0	0	3	0	88	3	7	7	16	38	2	4	8	0	7	4	0	0	3	0	104	109	2	2	0	0	1	0	0	2	1	1	0	0	1	0	0	3	3	0	0	45	0	0	40	1	0	3	1	3	1	0	0	1	44	2	0	0	4	1	2	1	0	30	0	1	42	2	4	0	7	6	1	1	1	0	0	0	0	0	0	0	0	0	0	1	3	1	0	0	0	1	1	17	0	1	12	0	0	0	0	5	0	1	1	1	1	27	0	78	65	0	1	0	1	0	0	1	3	0	0	1	3	3	1	2	18	0	2	1	3	2	0	0	1	0	0	4	0	0	0	0	0	0	1	0	0	0	0	0	0	2	1	0	1	1	0	0	0	0	3	0	2	0	0	0	0	0	1	0	0	0	0	0	1	0	0	1	0	16	0	1	0	2	0	0	3	0	0	0	0	0	2	0	0	1	0	2	0	0	1	0	1	0	0	0	0	0	0	0	0	0	0	0	0	0	0	1	0	0	0	0	0	0	1	4	3	0	0	4	1	0	0	18	2	0	0	2	0	0	0	4	2	4	6	4	0	1	1	2	0	0	3	0	0	1	0	0	0	0	1	0	1	0	0	0	0	0	1	0	0	0	0	3	1	0	0	3	1	0	0	0	0	0	1	0	0	0	4	2	2	0	0	0	4	0	0	0	0	0	0	0	0	6	6	0	58	1	0	1	0	0	4	2	0	0	0	1	0	0	4	0	0	32	5	4	0	0	0	2	0	0	4	0	2	2	0	0	2	0	2	1	0	3	0	0	0	0	3	0	1	0	0	0	0	0	0	0	0	1	0	0	0	0	0	3	0	2	2	0	1	0	0	0	0	0	2	0	0	1	0	0	0	0	0	11	0	0	0	2	5	1	0	11	2	0	9	7	137	0	0	0	0	1	2	11	11	9	6	0	3	12	0	12	13	0	1	6	15	1	1	0	9	0	0	39	2	0	4	163	1	1	0	0	1	0	2	0	1	5	2	1	1	0	2	1	1	17	0	0	0	0	3	0	1	0	0	14	11	1	10	27	7	36	0	0	2	0	18	16	9	2	2	0	0	0	1	0	1	6	1	9	2	1	0	4	5	1	3	0	0	0	17	0	3	8	6	5	15	0	0	0	28	0	0	32	13	3	1	0	18	17	0	0	1	7	6	0	5	0	1	0	0	0	0	0	0	0	0	4	0	0	0	1	0	1	0	0	0	0	0	0	0	1	1	0	1	0	0	1	3	0	0	4	0	2	0	0	0	1	0	0	0	0	0	0	0	0	0	0	0	0	0	0	0	0	3	0	1	0	0	0	0	0	1	0	2	0
PHYLLO28	167541	0	0	0	734	2776	335	0	682	0	12	158	108	0	520	10	0	6	0	3	17	3	6	5	161	5	0	67	22	90	24	0	37	49	5	57	62	0	0	0	0	1	0	0	49	0	0	1	0	14	2	0	74	264	569	4	1596	13	21	1	151	3	7	37	105	227	0	54	13	0	43	14	0	0	4	1	19	0	0	3	1	1	728	409	182	195	0	154	0	81	4	351	115	309	159	64	177	19	237	4	0	622	13	702	1	224	464	2	30	17	11	0	102	93	2	124	44	59	0	3	246	30	157	6	57	514	186	211	42	42	25	15	1	8	6	6	2	634	47	13	53	125	147	36	1	162	43	6	52	112	4	3	5	41	3	0	1	9	241	173	112	1	15	278	7	195	249	210	59	70	12	66	86	27	15	16	1	37	47	2	73	3	71	34	7	76	60	0	0	10	19	69	8	2	0	15	89	257	0	0	35	14	4	70	23	23	0	105	6	8	255	3	81	2	901	1253	8	97	12	86	31	27	110	44	396	12	334	144	106	15	307	30	31	61	0	0	29	1	213	3	74	45	232	76	10	17	0	30	146	51	0	6	71	7	313	0	10	31	247	18	2	18	23	0	16	1	70	69	82	19	85	25	74	3	30	22	0	44	1	135	182	12	41	46	358	264	34	8	24	22	123	1	0	22	111	9	255	0	17	27	12	56	442	15	0	3	3	146	145	200	270	38	25	3	1	45	0	65	4	74	2	136	25	16	2	4	11	16	42	10	0	76	0	0	16	0	2	2	0	32	258	54	3	246	549	5	0	0	100	41	24	14	11	31	221	0	38	75	20	36	67	52	30	29	0	0	101	108	37	128	0	97	73	57	12	70	205	55	20	287	70	76	40	51	8	28	392	181	64	12	972	0	1	3	0	8	2	56	1379	3	42	5	235	0	1140	107	0	0	15	70	307	390	4	0	3	14	5	4	9	103	289	101	8	0	138	11	130	235	635	7	5	3	0	0	0	91	354	17	25	51	501	4	47	79	101	283	202	93	168	5	28	203	264	76	197	102	59	1554	46	49	0	0	0	0	1	0	0	1	0	0	3	2	9	4	3	0	0	5	6	1	264	26	2	21	2	0	0	0	7	64	0	1	3	0	52	0	0	3	0	0	0	3	0	0	0	4	4	5	0	32	8	25	0	0	169	443	371	16	175	46	107	825	30	188	282	31	340	0	203	31	3	4	33	0	52	52	91	57	177	200	11	110	5	46	127	233	152	33	0	22	5	53	22	41	61	22	23	134	114	194	33	90	11	150	52	2	1	0	0	60	12	30	1	134	108	4	290	99	0	76	0	22	32	27	66	1	43	61	60	97	34	0	40	4	0	2	8	0	0	1	0	0	45	178	3	28	30	0	3	10	0	0	148	0	32	24	51	7	91	0	36	1	2	0	25	8	7	1	0	34	0	0	52	10	66	135	36	0	0	33	0	13	66	0	65	7	0	11	4	0	15	59	742	15	38	0	27	56	0	37	148	6	9	1	5	19	201	2	138	5	48	0	33	102	364	45	36	237	74	0	136	193	63	147	73	57	0	0	111	75	14	15	200	0	0	2	14	1	48	0	0	13	74	0	0	1	72	6	43	39	0	100	46	58	72	85	183	70	181	810	65	1	1	166	45	0	2	15	7	65	92	6	3	3	0	18	134	0	22	0	6	46	14	26	43	0	1	27	7	6	96	182	89	100	27	164	0	38	94	0	30	20	26	210	75	36	37	106	23	94	0	60	0	157	57	37	3	33	21	5	166	34	20	0	1	5	13	0	0	0	0	8	0	70	149	0	12	12	0	18	18	40	82	38	61	6	2	0	8	33	20	2	152	31	95	14	43	4	120	22	0	3	91	116	26	45	0	0	14	0	6	0	14	0	0	10	3	0	0	0	83	5	22	24	2	5	53	9	68	28	25	28	9	0	0	0	81	49	0	3	45	28	17	14	0	0	0	14	0	35	10	1	49	44	33	29	53	1	0	1	15	2	20	1	7	149	6	24	16	16	28	0	32	1	10	0	7	0	10	43	30	22	0	1	0	15	0	14	3	21	18	11	30	174	76	55	30	0	277	0	19	4	7	42	49	29	1	1	9	0	0	0	0	7	5	57	0	1	17	25	27	0	1	24	37	7	4	180	5	44	0	25	9	111	36	2	10	10	0	1	404	6	114	0	2	36	2	35	1	0	3	12	0	0	5	3	19	1	124	52	2	401	2	2	0	21	134	79	0	56	10	9	1	0	2	0	0	0	50	2	0	0	22	9	0	0	61	216	49	0	134	1	16	0	34	32	0	0	13	2	111	0	0	0	14	76	136	203	111	95	7	0	1	3	7	20	0	30	17	0	0	0	0	133	1	0	123	0	0	55	0	0	0	75	21	2	29	39	116	0	15	143	1	3	2	1	42	2	1	203	205	2	55	2	12	14	11	2	51	16	32	53	36	44	116	29	20	107	56	20	42	0	0	6	4	2	109	0	72	40	374	203	63	78	159	59	78	53	183	101	0	25	288	49	371	49	102	78	2	60	139	0	32	185	2	156	289	1	18	137	67	95	6	16	0	3	0	0	0	81	50	107	27	91	54	77	62	32	266	21	1	29	112	4	42	20	163	2	0	213	25	7	5	0	62	61	0	222	0	26	6	46	0	27	0	0	32	18	0	9	2	25	0	0	10	21	0	19	49	2	17	7	11	12	17	0	53	11	7	1	8	20	46	16	6	0	0	78	0	38	116	73	11	45	1	24	11	3	1	341	6	2	14	43	25	1	11	18	29	10	6	0	0	0	0	0	0	13	1	17	0	0	29	46	3	18	21	1	8	5	72	0	27	0	66	52	3	47	17	0	19	0	32	43	3	0	0	0	29	0	67	0	8	101	280	4	46	0	0	0	1	12	1	0	0	41	3	16	20	2	13	0	2	0	0	72	2	0	0	0	3	6	32	40	4	4	3	12	4	8	16	71	54	7	0	0	21	26	1	65	4	1	0	19	168	29	2	0	15	0	9	4	39	264	3	5	0	4	0	8	0	30	26	0	76	9	0	35	12	0	1	0	13	0	0	5	1	2	3	22	8	71	47	248	16	67	8	93	0	3	1	14	19	6	214	1	0	1	1	0	2	12	6	5	0	5	0	16	0	0	1	3	1	0	3	0	17	0	15	5	1	3	1	61	16	5	1	22	1	0	1	15	26	2	76	9	4	14	0	0	48	15	7	8	0	0	36	28	0	88	0	0	13	16	9	3	6	16	0	0	36	4	0	0	6	11	47	7	22	57	1	0	3	1	0	222	0	2	17	5	1	0	288	12	22	23	6	0	4	50	14	1	4	0	0	1	0	0	1	0	1	0	0	105	3	51	0	0	0	43	31	2	2	5	0	0	2	1	0	0	30	0	39	34	73	16	25	6	0	12	9	105	7	2	1	7	5	12	7	5	0	0	171	15	6	0	7	0	0	3	0	1	0	0	0	0	2	0	0	0	22	0	0	23	302	42	0	0	0	0	0	196	23	0	5	2	5	2	4	0	0	2	112	9	23	47	117	24	19	41	6	0	11	10	11	5	61	2	14	1	39	11	0	121	42	2	3	21	14	0	1	82	0	48	53	41	0	9	0	2	1	2	15	35	25	14	10	4	35	0	3	39	26	51	70	19	25	2	5	0	2	15	1	4	0	154	22	29	0	2	11	51	28	4	16	9	28	2	1	39	72	1	0	8	3	10	89	33	5	12	22	160	2	22	2013	1	29	9	2	28	9	6	69	164	37	10	9	0	17	14	38	46	1	0	74	17	10	17	188	0	12	91	25	13	32	32	7	12	13	0	7	87	1	7	13	13	0	11	11	2	6	58	18	20	29	4	0	15	0	12	1	14	0	0	5	16	29	7	5	0	5	127	34	1	8	1	6	20	12	13	47	30	2	8	12	17	20	26	54	16	54	5	9	1	15	24	6	14	69	4	2	1	5	8	33	3	5	52	262	0	1	5	10	1	9	24	0	1	9	23	26	30	2	27	0	38	6	2	0	59	2	0	25	26	22	17	8	166	1	31	1	25	17	3	1	32	77	51	3	5	22	16	0	24	23	112	4	1	0	13	13	34	1	195	220	124	0	9	67	10	155	0	1	19	1	10	125	0	0	47	42	209	561	536	54	50	66	342	261	37	0	477	257	73	123	86	200	401	193	5	29	59	0	0	0	22	9	35	1	59	193	181	1	137	2	133	411	68	6	2	97	0	50	215	0	153	0	0	0	7	1	179	195	42	8	0	37	37	0	1	222	2	291	2	5	0	0	48	220	20	4	107	35	222	248	0	145	145	138	89	27	2	0	61	68	6	0	1	131	138	185	91	1	61	17	15	3	1	2	10	160	39	43	176	3	0	4	0	276	0	22	22	1	60	0	42	68	0	1	72	0	1	0	2	0	29	8	0	178	30	0	1	127	0	0	0	1	0	0	52	6	0	2	1	3	2	0	2	1	2	0	4	17	15	1	49	1	5	0	5	32	7	5	35	1	40	0	2	47	2	4	56	2	0	66	74	7	1	7	0	0	19	7	8	0	1	0	0	4	1	0	0	2	4	35	7	0	3	16	8	72	0	2	42	66	61	3	3	0	0	254	4	0	0	1	29	16	76	615	88	0	15	3	0	0	0	0	21	0	0	0	0	0	59	1	14	4	39	10	26	2	75	1	5	39	20	6	0	0	19	22	0	0	0	36	0	3	0	0	0	0	1	0	0	5	7	0	0	0	0	0	8	0	0	19	30	15	16	0	3	0	2	33	2	7	1	0	0	0	53	24	0	0	0	5	0	21	0	41	13	43	41	22	28	7	53	8	33	5	2	0	0	0	0	0	14	6	0	18	29	3	65	14	0	0	1	0	0	135	4	0	0	3	0	2	10	22	0	0	0	0	5	507	2	22	8	0	0	3	25	42	0	0	10	1	0	3	66	0	2	3	5	0	19	0	3	72	2	2	10	12	87	61	38	37	45	3	28	28	0	0	0	11	27	169	176	93	3	3	3	620	0	126	2	18	3	8	112	0	173	3	93	93	101	21	1	0	0	0	0	8	0	0	3	0	4	157	2	0	2	3	0	2	1	19	37	37	2	18	3	6	0	3	20	0	0	0	100	12	14	12	3	2	0	11	0	4	11	1	10	0	0	0	0	0	39	6	11	0	0	9	8	0	2	4	6	0	3	0	3	19	2	3	0	1	8	18	4	55	39	24	1	39	0	1	5	45	0	0	1	25	0	4	12	4	0	1	0	0	4	0	0	29	0	0	4	0	2	1	0	8	0	0	16	30	15	8	17	111	21	59	28	66	29	6	3	0	1	118	0	18	84	83	1	1	7	118	90	3	4	1	1	20	0	94	27	16	59	18	109	15	0	0	11	15	4	1	0	6	0	165	2	0	0	17	5	4	3	0	0	6	61	23	12	0	0	65	10	95	15	0	20	0	1	0	1	5	30	3	2	0	7	3	28	2	34	0	4	23	0	3	2	0	0	0	6	1	0	1	0	0	0	0	10	0	0	1	0	0	0	0	12	2	15	0	2	13	1	0	2	3	0	0	0	0	6	0	62	10	1	16	3	0	5	3	9	0	0	0	33	6	1	20	1	0	0	0	1	0	0	1	1	20	0	2	0	18	0	44	0	8	3	0	2	12	0	0	1	10	0	0	0	0	31	46	9	144	46	123	74	1	0	84	0	11	0	0	9	6	2	0	25	55	18	22	0	13	36	0	46	0	1	0	0	0	0	0	0	226	6	17	39	4	0	0	21	1	0	0	0	0	1	3	15	9	10	2	1	2	0	4	10	7	0	1	0	1	6	0	1	0	26	26	6	0	0	0	0	1	0	31	1	0	625	1	2	0	3	0	0	0	0	0	3	0	54	0	3	48	1	8	4	0	0	20	2	35	0	2	13	1	0	0	0	2	65	2	0	0	0	0	50	0	0	0	64	0	0	0	0	0	0	4	44	1	0	0	0	2	5	4	4	20	1	0	0	2	0	0	36	0	1	3	6	0	0	0	0	6	1	0	3	0	1	0	30	3	29	3	2	0	71	1	0	0	0	0	0	0	0	26	0	42	1	0	10	0	0	3	2	2	0	8	38	1	21	1	2	1	31	3	0	3	2	0	3	0	0	3	1	0	1	2	2	34	2	4	13	3	9	4	5	0	6	0	2	38	8	0	0	10	4	1	2	0	0	0	8	14	4	49	2	7	1	3	0	0	5	0	0	15	7	0	0	0	6	37	0	0	0	37	10	6	59	9	5	10	7	2	11	2	4	2	2	4	1	137	2	0	0	1	0	38	143	1	11	0	1	4	7	8	2	9	8	19	2	5	4	2	9	1	3	4	0	26	11	8	2	1	1	9	0	76	0	10	0	1	3	1	4	2	6	4	7	28	28	12	9	0	7	1	0	8	0	0	106	2	0	10	0	0	33	0	11	7	1	2	3	84	0	1	6	4	3	0	0	10	0	0	0	0	0	0	9	11	2	12	1	0	2	10	19	14	8	0	0	0	7	47	2	6	1	0	2	20	0	3	3	1	8	11	4	0	1	10	16	1	1	0	0	0	0	0	0	0	2	1	3	0	8	2	16	114	285	149	37	5	63	47	0	0	221	218	222	0	215	17	17	0	8	1	7	1	0	0	7	0	2	180	2	2	0	23	0	212	1	1	0	2	12	0	0	0	8	1	0	1	0	0	0	0	0	2	3	1	47	1	1	0	157	0	9	0	0	1	1	0	0	38	0	229	0	0	4	1	0	0	1	0	0	0	1	6	6	0	0	5	10	11	0	0	0	87	0	0	0	0	0	12	2	0	0	4	1	1	0	0	0	2	2	2	0	0	106	3	0	0	1	16	0	1	0	0	2	0	0	0	426	0	0	14	1	19	1	1	0	0	158	0	0	4	0	0	2	3	0	2	2	7	196	0	0	75	0	0	0	1	0	0	0	0	0	0	0	0	0	0	15	0	0	6	13	0	0	1	10	11	0	0	9	1	10	2	24	47	8	23	0	2	2	0	27	8	2	6	1	0	2	8	257	6	1	11	0	1	3	0	3	1	0	14	256	252	1	248	1	0	0	0	0	1	22	0	4	5	1	0	3	0	0	1	4	2	0	3	0	0	0	10	34	1	0	3	16	0	0	1	11	4	0	2	0	23	0	17	0	0	4	71	4	0	0	0	6	12	0	1	3	0	14	2	3	3	0	2	0	0	1	2	6	5	1	0	0	7	1	2	12	32	3	33	0	0	1	2	0	0	2	3	0	99	0	1	5	10	0	6	0	0	6	48	6	18	27	0	1	0	0	0	1	2	50	60	4	67	15	67	195	6	25	22	157	29	0	6	0	0	0	111	75	3	0	8	3	95	20	18	5	7	1	20	4	0	30	2	25	2	0	0	5	8	0	0	0	0	21	4	4	1	10	2	0	5	0	13	0	45	0	1	1	2	0	0	0	0	5	14	9	2	0	0	0	11	2	113	1	36	0	66	0	0	3	0	0	0	0	6	5	0	20	7	0	0	19	3	4	1	2	10	4	0	0	0	0	1	0	32	0	50	10	0	58	0	0	4	38	1	0	5	3	86	6	5	1	10	0	0	11	1	0	12	2	91	14	11	1	0	2	0	0	0	0	8	26	199	1	0	52	0	1	0	3	0	0	3	0	0	7	2	0	8	0	0	0	0	2	76	0	0	2	0	0	1	9	3	0	7	29	2	0	0	38	37	1	9	2	0	0	27	2	2	19	0	62	50	0	14	0	1	0	1	0	0	5	0	15	1	33	8	0	2	0	0	0	2	3	1	134	2	2	35	0	0	0	0	8	0	0	2	68	0	1	0	21	2	0	0	3	12	0	2	3	0	1	0	12	0	0	0	15	0	0	1	0	0	45	0	0	8	2	0	0	8	0	3	3	4	0	0	0	0	0	0	12	0	0	2	5	0	19	0	3	28	0	38	1	1	1	24	89	4	20	2	6	21	0	47	0	0	3	0	0	0	9	11	3	0	21	3	0	0	0	0	0	7	0	4	2	1	5	0	2	8	3	0	0	1	6	0	0	29	10	7	2	0	2	0	3	0	1	0	1	8	2	0	1	2	4	0	39	0	0	6	1	4	6	3	2	10	0	0	2	5	5	0	0	0	1	1	1	28	12	4	9	0	1	0	1	11	24	3	0	1	0	1	0	2	4	0	2	0	0	51	6	5	0	1	0	2	0	12	0	1	1	0	10	1	0	0	0	4	1	5	0	0	3	0	12	51	51	0	10	6	0	0	0	23	3	1	0	1	0	4	9	3	0	2	0	0	13	0	0	5	0	4	1	5	0	0	1	0	7	29	3	4	0	25	0	0	0	0	12	0	1	1	2	0	0	0	0	30	10	0	0	21	0	2	0	0	0	0	0	1	0	0	0	0	2	0	0	4	0	9	6	1	0	0	23	1	94	0	0	80	8	0	1	4	4	0	78	0	1	31	0	18	0	33	8	0	2	9	50	0	1	0	37	0	0	0	0	0	69	50	0	0	0	2	53	30	1	0	0	0	1	0	4	2	0	0	1	23	0	0	1	0	0	0	2	3	1	4	0	0	1	4	0	0	1	1	6	2	2	0	0	0	0	26	1	46	0	2	0	6	0	1	2	0	0	1	2	0	2	80	7	0	0	5	0	0	1	0	0	1	0	4	0	0	0	0	0	66	0	0	0	0	1	0	0	6	0	9	51	3	20	0	0	0	0	39	6	6	8	0	0	7	52	22	0	0	13	10	0	0	53	2	0	0	0	3	0	1	1	6	3	0	0	0	0	1	29	2	8	0	21	0	3	11	0	0	0	113	0	8	0	12	1	11	5	93	45	26	2	10	10	0	0	3	1	7	28	0	0	0	0	0	0	5	0	6	0	0	0	1	1	0	0	0	2	0	0	0	0	0	1	0	3	0	8	0	0	0	9	5	0	0	1	0	0	0	0	1	0	2	0	2	1	0	0	0	2	0	0	3	0	44	12	6	0	28	37	0	8	7	5	0	0	2	15	28	4	0	0	0	1	3	0	4	0	0	5	0	6	0	1	0	0	0	6	3	0	9	0	0	0	0	0	0	6	0	1	6	1	0	16	2	0	0	0	1	0	11	0	10	2	4	1	11	0	0	27	0	7	4	2	0	0	1	1	6	0	0	0	2	0	0	0	0	1	1	0	6	0	5	1	0	0	5	0	0	63	26	0	0	0	2	2	0	0	29	39	0	0	0	7	0	1	1	3	0	59	0	0	3	37	0	105	0	0	3	0	0	2	0	1	0	1	15	0	0	8	0	2	10	12	0	6	0	0	0	0	1	0	0	0	0	0	0	2	1	0	0	0	5	0	1	18	1	0	1	0	5	1	2	0	2	1	5	0	26	9	0	2	0	0	0	0	0	0	0	0	0	51	1	14	3	1	0	0	3	0	0	0	3	1	0	0	0	0	0	0	2	4	0	0	2	1	0	0	25	2	0	9	0	23	53	29	0	1	11	1	7	23	0	2	22	19	56	54	10	0	9	4	15	4	4	0	36	0	17	0	0	0	157	165	7	4	75	0	3	0	2	0	42	0	0	0	82	0	1	4	0	0	1	0	111	0	0	1	2	1	12	0	0	20	0	0	5	4	0	51	0	0	0	0	0	3	28	21	12	3	20	12	5	23	1	1	2	0	1	0	5	0	0	0	1	4	4	4	4	2	19	4	1	1	0	1	1	0	73	0	2	0	1	94	0	10	1	33	0	4	9	58	0	2	128	0	0	1	9	52	34	0	334	1	977	55	0	1	30	19	1	2	0	0	1	36	55	4	0	0	2	1735	0	70	0	79	5	19	430	69	16	72	123	84	57	65	392	1	0	4	0	3	0	3	4	33	0	1	1	7	0	0	0	0	0	0	0	0	0	0	0	0	15	0	0	34	0	1	0	0	20	17	0	8	1	3	0	0	0	0	15	1	0	0	0	19	0	0	2	0	0	2	0	0	4	0	0	0	0	0	0	83	2	0	3	0	0	0	0	3	22	2	3	97	16	11	0	0	7	1	14	0	0	10	1	10	0	1	0	0	5	0	0	0	5	12	0	35	68	0	0	0	0	0	4	0	0	0	7	0	72	0	82	2	226	0	1	15	31	0	97	0	0	1	0	30	665	23	28	94	0	0	2	0	10	4	0	13	6	4	0	0	1	27	0	10	11	34	19	9	25	24	2	1	0	0	0	5	1	0	0	0	0	0	0	1	1	1	0	0	0	0	40	0	0	0	1	2	0	26	0	0	0	0	2	0	2	3	1	0	1	0	2	1	0	0	0	61	31	0	3	8	0	0	0	2	0	39	0	0	5	2	0	0	0	0	0	1	0	0	0	23	12	427	82	11	0	30	290	502	0	19	22	0	2	1	1	0	66	0	7	26	0	154	31	4	0	0	2	0	0	0	22	67	0	0	21	0	0	2	9	5	0	0	0	0	1	0	4	0	0	38	0	0	9	38	33	0	28	0	31	4	143	0	16	6	34	0	30	1	0	2	230	6	13	2	2	0	4	7	16	0	33	7	11	0	0	0	17	13	27	5	3	20	4	0	0	8	0	0	0	5	130	1	0	0	1	9	5	0	3	7	13	2	0	0	0	1	0	27	9	5	19	71	26	2	46	385	404	0	85	1	2	0	82	0	10	52	1	33	2	20	3	0	12	4	9	5	5	6	2	3	0	0	0	88	4	0	37	1	23	117	0	0	0	0	0	1	5	0	0	0	0	2	47	2	0	0	0	76	46	18	17	10	30	3	1	0	6	52	3	47	36	49	17	0	4	0	0	0	0	0	0	0	0	0	0	0	0	0	0	0	1	0	0	0	1	0	0	0	0	1	1	0	0	0	2	0	0	0	0	0	0	0	1	0	0	0	2	0	0	1	0	0	0	1	0	0	0	2	0	0	0	3	0	0	2	2	1	0	0	0	0	2	0	3	8	3	0	0	0	0	1	53	0	2	0	18	59	0	39	97	0	0	0	32	1	1	0	0	1	0	0	0	1	0	8	9	1	2	1	0	12	6	1	0	2	0	0	0	0	0	0	3	0	3	0	0	0	0	1	1	37	1	0	2	2	2	0	0	0	0	3	1	5	0	0	4	0	2	4	0	0	0	0	6	1	0	0	1	0	0	1	0	2	0	8	46	2	2	0	1	3	2	0	0	0	0	0	3	0	1	0	14	0	0	0	0	0	0	0	1	0	0	1	0	1	0	0	0	0	0	0	2	0	2	0	0	1	4	22	0	0	13	1	0	8	3	0	3	1	0	0	6	0	0	0	0	22	6	1	1	3	0	3	4	3	1	6	12	3	0	0	0	0	0	0	0	0	0	0	0	3	0	0	2	0	0	2	0	0	0	0	0	2	0	0	0	1	3	0	0	0	0	0	2	4	109	14	0	0	0	0	0	0	0	2	5	0	0	11	11	0	5	0	0	18	0	3	0	0	7	0	13	0	4	0	0	11	11	0	1	0	0	0	6	2	0	0	9	31	0	0	6	41	0	0	0	0	1	2	2	0	2	1	0	0	0	2	0	0	0	0	1	4	2	1	31	0	0	0	0	7	0	0	0	0	6	0	0	0	0	0	31	2	0	1	0	0	5	7	13	2	0	1	0	0	0	24	0	4	1	0	0	4	2	3	19	11	0	20	0	184	52	0	0	98	0	0	14	0	11	5	13	3	17	6	1	0	3	0	5	1	3	2	8	2	32	32	4	1	0	31	1	63	1	2	4	0	2	0	0	0	3	58	23	0	5	0	0	107	0	0	0	0	3	7	0	0	0	0	0	0	35	2	0	0	0	0	0	0	0	0	0	0	0	0	0	0	0	0	0	1	0	0	0	0	0	0	1	5	0	0	1	1	0	0	3	0	1	0	0	0	0	0	3	0	0	0	0	0	1	0	0	0	0	0	0	0	3	0	0	0	0	0	0	0	0	1	0	2	0	0	0	1	0	6	0	6	7	1	12	0	0	0	0	0	0	0	0	6	2	15	0	1	0	0	0	0	0	1	3	0	1	6	0	1	1	2	5	0	0	24	0	0	2	0	0	0	23	0	0	24	0	7	1	14	0	12	0	12	9	4	0	0	0	0	0	0	0	0	0	0	0	0	0	0	14	0	0	0	0	0	0	0	1	0	0	0	0	0	2	0	0	0	0	0	0	0	0	0	0	0	4	6	7	1	0	1	1	0	0	0	3	3	3	3	1	0	0	4	5	5	4	0	14	17	1	1	8	0	0	2	0	7	2	0	1	0	7	0	3	9	1	5	0	1	0	0	0	3	0	2	2	2	3	25	0	4	0	0	0	3	2	25	0	5	1	1	9	13	0	0	0	1	0	2	0	0	0	2	1	1	1	1	3	22	4	0	2	4	0	4	0	1	0	0	1	1	6	13	17	2	1	0	1	3	6	1	0	14	0	17	10	3	7	1	0	0	5	7	0	2	8	1	1	0	0	0	0	4	0	2	0	0	0	1	0	0	0	0	0	0	0	0	0	0	0	1	9	0	0	0	1	16	0	5	1	0	0	1	0	1	62	0	7	4	3	1	0	6	0	6	0	11	0	0	35	0	0	0	3	6	0	0	1	4	14	4	1	1	0	3	3	12	0	7	20	20	1	1	5	0	2	0	5	2	6	98	1	0	0	1	0	0	0	0	0	0	0	0	0	0	0	0	0	0	0	0	2	0	3	0	0	0	1	0	0	0	0	1	7	0	0	0	1	0	0	0	27	0	0	0	0	2	1	0	2	0	5	1	0	0	0	2	0	0	0	0	0	0	0	0	0	0	0	0	12	0	0	1	0	1	2	0	0	2	0	0	2	2	0	0	0	0	2	0	0	0	1	0	19	5	9	5	2	0	0	0	0	0	0	196	0	1	0	0	0	0	20	41	7	1	0	0	0	0	0	59	11	21	4	72	27	2	0	37	0	0	405	1	1	0	3	14	0	4	0	0	2	0	0	0	0	108	17	0	0	0	0	0	0	0	2	0	0	0	1	0	0	13	0	9	0	1	0	0	30	0	0	69	0	0	0	2	14	0	0	0	0	5	0	0	40	5	0	1	56	0	8	0	22	0	2	1	0	77	47	6	9	12	1	1	1	0	25	13	0	32	4	0	0	0	1	0	1	0	0	0	0	4	1	0	10	1	0	0	1	0	7	10	0	1	0	0	1	0	8	3	33	0	0	10	1	0	0	0	0	0	0	0	2	0	0	0	1	0	0	0	0	1	0	0	0	9	0	0	0	0	3	0	0	0	0	2	0	1	0	0	0	0	5	0	2	2	0	0	0	0	0	0	0	0	0	0	0	0	1	0	0	0	0	0	1	0	0	0	0	0	0	3	0	2	0	0	0	2	0	0	0	0	0	0	0	0	0	0	0	0	0	0	2	0	0	0	2	0	0	0	0	0	1	1	3	1	0	6	1	0	0	3	0	0	2	0	5	0	2	0	2	3	20	0	0	0	0	1	0	3	0	1	3	1	4	0	7	25	0	5	0	0	0	0	0	0	14	0	0	0	0	1	0	0	0	1	1	0	25	0	0	0	3	17	0	0	0	1	0	5	0	0	0	0	1	0	0	3	0	1	0	1	0	1	1	0	0	2	0	0	0	0	6	0	0	0	0	1	5	0	1	1	0	1	0	0	0	4	0	0	5	0	0	0	2	2	1	6	0	2	3	0	3	0	2	0	0	0	0	0	1	0	2	0	0	1	2	0	0	1	4	0	0	7	1	0	0	9	0	0	1	5	1	1	7	4	0	1	0	0	0	0	0	0	11	5	4	0	0	2	0	0	2	1	6	0	2	0	0	2	0	1	0	4	0	0	1	3	1	0	0	0	0	1	0	17	21	0	0	0	2	0	1	0	5	0	1	0	0	0	0	6	0	0	0	0	0	2	1	0	0	0	0	4	0	1	0	0	3	1	0	0	1	1	2	1	3	0	4	0	0	0	1	1	0	0	51	2	3	0	0	2	1	0	1	0	0	1	0	1	1	0	0	0	1	0	0	0	8	0	0	1	1	0	2	0	1	0	0	2	0	8	0	1	0	0	5	0	0	0	3	0	3	0	2	2	5	12	3	8	10	3	37	0	0	0	5	1	7	2	0	14	11	8	2	2	0	0	6	5	0	0	0	20	1	1	1	0	7	32	15	4	0	28	69	3	0	0	3	0	5	1	2	10	16	2	2	0	3	20	0	1	1	0	0	0	1	48	0	37	3	0	0	15	1	8	0	3	0	15	10	0	2	0	3	1	2	4	18	2	19	12	0	0	4	0	0	0	58	0	0	2	12	1	2	2	2	1	0	53	21	62	2	2	3	0	0	1	3	3	1	0	0	1	1	0	0	0	4	3	0	3	64	114	2	1	4	4	0	2	9	16	9	1	0	6	0	1	1	13	0	1	0	0	3	51	26	0	0	5	3	0	5	0	0	90	0	0	1	0	17	0	0	2	42	0	2	6	0	39	0	3	1	1	0	0	7	0	0	0	0	28	1	9	9	0	0	0	0	0	0	1	1	0	8	0	3	1	6	6	0	0	1	1	0	0	0	0	0	1	1	0	2	0	2	0	1	0	0	0	0	0	0	1	4	5	0	0	2	1	0	11	1	0	88	0	0	2	0	46	0	2	0	1	0	0	0	0	0	15	0	3	2	12	0	0	0	0	1	0	1	0	3	16	0	0	1	1	0	0	10	12	0	0	0	1	4	0	3	0	0	1	11	0	0	0	0	1	0	0	8	5	0	0	0	40	0	0	0	0	4	0	0	134	5	2	0	0	0	0	4	17	0	0	11	0	1	0	8	10	21	0	0	2	0	5	0	0	0	7	3	0	103	8	4	1	0	0	2	0	26	2	58	2	9	2	0	0	0	4	0	0	2	6	0	0	6	2	0	1	0	2	0	0	2	2	3	1	0	0	4	0	0	0	0	10	3	9	0	0	0	0	0	1	2	0	0	0	7	17	2	5	0	0	3	0	0	13	0	2	0	0	0	2	0	0	0	0	0	0	19	0	17	2	0	0	5	2	1	16	19	0	0	0	0	48	0	0	1	0	0	0	0	0	0	0	0	0	0	40	115	0	0	0	7	80	1	136	0	0	0	0	2	4	2	1	4	213	3	9	2	0	0	10	5	0	0	0	5	7	0	9	0	1	0	1	12	17	5	7	0	9	4	1	4	4	14	14	37	12	1	2	4	28	57	112	0	6	0	1	0	7	0	1	0	0	0	0	0	2	286	0	0	0	75	0	0	59	64	1	0	19	0	0	3	6	1	40	0	0	0	0	10	0	5	0	5	0	0	0	0	0	1	0	14	5	0	1	1	0	0	64	0	0	3	6	0	0	0	0	0	0	0	1	9	2	0	0	7	16	0	0	0	0	0	33	4	4	4	0	0	0	0	0	0	2	0	5	0	0	0	0	1	0	33	1	31	0	12	0	0	0	2	0	4	5	0	0	3	0	0	0	2	49	89	89	101	0	0	0	1	22	0	8	2	1	12	28	0	7	17	0	2	0	0	5	50	0	36	12	157	39	0	170	76	262	13	23	239	2	27	755	0	25	12	2	0	3	3	1	7	0	2	0	1	0	9	0	0	0	24	0	15	0	16	3	1	6	27	54	4	0	0	0	0	0	0	0	0	0	0	0	129	1	43	37	1	10	2	0	43	10	27	68	34	55	0	0	90	4	96	6	0	92	4	14	0	2	5	1	1	0	0	0	1	0	0	0	1	32	48	1	9	1	146	60	12	4	2	16	1	16	2	35	2	284	1	5	6	5	60	11	0	4	74	7	2	4	8	10	7	16	2	4	15	40	0	40	138	28	42	59	68	3	121	105	3	0	633	3	0	43	1	0	13	42	5	108	8	0	0	0	28	3	0	290	0	24	8	0	15	0	3	8	5	9	20	1	86	116	35	10	0	5	3	3	30	2	18	1	145	2	15	79	85	38	3	3	0	20	8	0	5	15	12	8	42	0	0	27	1	3	128	18	25	12	8	4	1	20	4	4	5	5	3	156	0	0	5	1	87	0	2	0	12	0	101	2	5	1	36	6	16	8	4	1	0	0	1	16	5	87	3	0	28	50	11	16	29	11	10	13	7	3	11	2	8	2	0	1	1	17	0	0	5	0	291	0	2	22	25	70	1	0	11	0	14	22	0	0	8	1	19	29	5	5	0	1	1	0	1	1	1	8	5	1	1	0	1	3	14	0	1	62	4	2	36	0	0	2	2	0	3	0	0	1	63	2	0	0	2	0	4	4	0	75	4	0	62	6	16	1	9	7	2	0	2	0	0	0	0	0	0	0	0	1	0	4	10	1	0	0	0	0	0	68	2	0	16	0	1	0	0	0	0	0	10	0	2	44	0	41	28	0	0	0	4	2	0	2	9	0	0	0	0	0	0	0	0	0	0	0	0	0	0	0	1	0	0	3	0	0	0	0	1	1	7	1	0	0	0	0	0	0	0	1	6	0	0	0	0	1	16	2	1	0	0	0	7	0	2	0	0	0	0	1	6	8	0	1	0	8	0	0	0	0	0	1	1	1	4	1	2	0	1	2	12	3	0	4	0	0	0	0	4	5	2	0	2	0	4	0	0	0	0	0	3	0	2	1	0	0	0	1	0	0	0	0	0	0	0	0	0	0	0	29	0	0	0	0	0	1	0	2	3	2	38	2	8	0	0	1	3	1	0	0	0	0	1	0	0	2	0	0	2	0	0	1	4	1	2	0	1	0	0	0	3	0	0	0	0	0	0	0	0	2	0	0	0	0	1	0	3	0	0	5	5	0	0	0	0	2	0	0	0	3	11	0	143	0	4	1	0	0	0	11	0	0	0	4	0	0	1	1	0	49	0	6	2	0	0	3	1	0	8	5	0	0	2	3	0	1	37	0	0	1	5	0	0	7	13	0	4	4	3	2	0	0	0	0	1	0	0	0	0	1	0	2	0	1	0	0	0	0	1	0	0	0	5	19	4	0	0	1	1	9	0	4	0	0	0	1	5	0	0	9	0	0	20	9	179	14	5	0	3	7	26	54	56	6	25	0	9	45	4	45	13	0	0	12	37	0	10	1	8	0	0	64	1	0	5	375	0	1	0	0	0	0	0	0	0	25	0	0	0	0	6	0	1	26	0	0	0	0	19	0	0	0	0	19	11	8	17	70	9	53	1	1	5	0	49	34	1	9	5	0	0	0	0	0	0	16	1	10	5	0	0	0	7	0	4	0	0	7	28	0	0	5	25	13	48	0	0	3	22	0	0	45	27	1	0	1	79	50	0	0	0	18	18	1	3	0	0	0	1	0	0	0	0	0	0	0	0	0	0	1	0	5	1	1	0	0	2	0	0	0	0	0	1	0	0	0	4	0	2	0	0	0	0	0	0	0	0	0	2	0	3	0	0	0	0	0	0	0	0	0	2	0	0	0	12	0	0	1	0	0	5	0	1	6
PHYLLO29	20818	0	0	0	100	329	38	1	78	1	3	11	22	0	32	1	0	1	0	2	3	1	0	0	15	0	0	5	2	10	4	0	8	6	3	4	4	0	0	0	0	0	0	1	7	0	0	0	0	0	0	0	21	50	73	2	153	4	7	0	47	0	0	8	16	54	0	2	1	0	9	2	0	0	0	6	2	0	0	0	0	0	117	55	31	26	0	15	1	7	0	34	9	55	21	9	31	3	40	0	0	55	2	94	0	25	58	0	2	5	0	0	12	14	0	21	2	8	0	0	20	8	25	4	14	60	27	35	2	5	7	0	0	2	3	3	0	95	18	1	8	16	25	1	0	17	8	0	0	9	0	0	1	8	1	0	0	0	20	35	14	0	0	43	1	19	33	29	0	16	1	3	8	0	7	1	0	2	2	0	7	4	9	3	3	1	14	0	0	1	3	9	1	0	0	0	11	56	0	0	7	3	0	3	6	3	0	3	1	1	23	0	9	0	145	193	0	14	2	16	14	9	17	5	54	4	42	20	17	3	37	1	3	12	1	4	6	0	20	2	6	1	26	15	1	6	0	3	19	8	0	0	19	2	43	0	4	4	35	3	0	2	0	0	1	1	3	15	7	0	17	4	13	0	5	2	0	2	0	16	31	4	7	5	29	48	5	2	5	0	10	0	0	2	12	1	32	0	4	1	5	5	72	10	0	0	0	22	6	24	24	5	13	2	3	3	0	12	0	9	0	23	5	0	0	1	0	2	0	1	0	10	0	0	1	0	1	0	0	6	23	8	2	27	57	1	2	0	16	3	2	2	8	7	39	0	7	3	5	10	15	13	2	3	0	0	11	19	2	20	0	17	10	15	4	10	25	2	1	20	16	17	4	4	5	0	60	16	5	3	132	0	0	0	0	1	1	4	140	0	1	1	35	0	205	7	0	0	2	14	50	45	0	0	1	0	3	1	1	12	33	14	1	0	18	1	15	38	52	0	1	1	0	0	0	7	62	9	2	7	51	2	2	11	17	30	24	13	27	1	4	17	54	2	28	16	8	124	4	8	0	0	0	0	1	0	2	0	1	0	1	0	3	0	3	0	0	4	1	0	35	0	0	5	1	0	0	0	2	4	0	0	6	0	1	0	0	1	0	0	0	1	0	1	0	0	0	2	0	4	1	1	0	0	11	53	57	2	23	7	13	71	14	9	44	3	46	0	18	3	2	1	2	0	9	10	5	5	26	25	0	11	0	8	7	38	16	4	0	6	0	7	1	9	12	5	1	16	15	20	7	13	3	20	8	2	1	0	0	5	0	1	0	14	12	1	36	5	0	9	0	0	7	1	14	0	9	7	3	18	11	2	8	0	0	1	2	2	0	0	0	0	12	22	1	1	7	0	0	1	0	0	20	0	0	9	5	0	13	0	5	1	0	1	2	1	1	0	0	1	0	0	3	0	3	9	8	0	0	7	0	1	20	0	9	2	0	0	2	0	3	14	55	2	8	0	3	2	0	8	20	1	0	0	0	5	32	4	14	1	3	0	4	20	45	4	13	21	6	0	16	21	5	5	10	9	0	0	16	10	5	6	17	0	0	0	0	0	3	0	1	6	8	0	0	0	16	0	0	4	0	14	9	6	11	18	17	11	17	65	4	0	2	14	6	0	0	0	1	8	9	1	0	0	0	7	8	0	2	0	0	4	0	3	3	0	1	8	0	2	7	26	9	8	4	15	0	4	3	0	2	3	0	22	9	5	1	12	2	11	0	3	1	16	2	8	2	10	4	1	22	6	1	0	1	2	1	0	0	0	0	1	0	14	8	0	1	0	0	1	3	11	8	6	6	4	0	0	0	2	2	0	23	1	5	2	0	0	19	2	0	1	15	16	4	7	0	0	0	0	2	0	1	0	0	2	0	0	0	0	6	0	2	9	0	2	3	0	9	2	4	3	2	0	0	0	19	5	0	1	7	3	5	1	0	0	0	4	0	5	2	1	5	3	4	1	5	0	1	0	5	0	2	2	1	18	1	9	0	0	5	0	7	0	1	0	2	0	0	12	4	1	0	1	0	0	0	0	0	1	0	2	10	36	5	3	4	2	32	0	5	0	0	8	7	2	0	1	0	0	0	0	1	5	1	5	0	0	10	0	3	0	0	1	2	0	0	25	1	6	0	1	3	20	3	1	2	2	0	0	71	0	7	0	0	2	0	0	0	0	0	1	1	0	0	0	0	0	21	6	4	71	0	0	0	4	21	13	0	6	0	4	0	0	1	0	0	0	7	0	0	1	3	0	0	0	9	38	8	0	10	1	6	0	7	1	0	0	0	2	17	1	2	0	2	11	11	25	11	6	2	0	0	1	1	3	0	10	3	0	0	0	0	25	0	0	8	0	0	11	1	1	0	7	2	0	5	3	3	0	0	18	0	1	0	0	1	4	0	25	24	1	4	1	1	2	2	0	4	4	1	10	4	4	10	0	4	16	5	1	3	0	0	1	1	0	17	0	7	9	34	50	12	10	14	3	11	7	22	5	0	3	42	5	67	14	17	12	0	10	27	0	5	5	0	13	43	0	2	19	12	16	4	1	0	3	0	0	0	22	2	10	8	13	5	11	14	4	6	2	1	1	8	0	6	4	21	0	3	25	0	0	0	0	12	6	0	29	0	6	1	6	0	4	0	0	10	2	0	8	1	2	0	0	4	1	0	6	8	1	2	0	2	2	3	0	6	0	0	0	2	6	5	3	0	0	0	6	0	4	5	8	1	12	0	4	1	0	0	41	0	3	6	6	2	0	0	0	4	3	0	0	0	0	0	0	1	1	0	1	0	0	3	8	0	0	4	0	0	0	10	0	4	2	6	3	0	4	3	1	2	0	2	8	1	0	0	0	0	0	3	0	1	12	35	0	4	0	0	0	0	1	1	1	1	4	0	2	4	1	2	0	0	0	0	15	0	0	0	0	0	1	5	6	0	0	1	0	1	0	2	6	5	3	0	0	2	0	2	4	0	0	0	0	10	1	1	0	2	1	1	0	2	44	0	0	0	0	0	3	0	1	0	0	10	2	0	9	2	0	0	0	0	0	0	0	1	0	3	3	1	9	7	29	1	6	0	9	0	0	0	2	2	0	24	0	0	0	0	0	0	3	0	0	0	0	0	0	0	0	0	0	0	0	0	0	6	0	2	6	0	2	0	10	2	1	1	2	0	0	0	0	4	0	1	4	6	2	0	0	7	1	0	2	0	0	1	0	0	6	0	0	3	0	0	0	0	3	0	0	1	0	0	0	1	0	3	0	1	7	0	0	0	0	0	19	0	0	1	0	0	0	41	4	5	0	1	0	0	9	0	0	0	0	0	0	0	0	0	0	0	0	0	23	0	3	0	0	0	0	0	0	0	0	0	1	2	1	0	0	5	0	3	6	6	2	6	0	0	0	0	7	1	0	0	4	7	3	2	0	0	0	11	3	2	0	0	0	0	0	0	0	0	0	0	0	0	0	0	2	6	0	0	1	28	2	0	0	0	0	0	13	3	0	0	0	0	1	1	0	0	0	13	0	8	3	14	7	7	4	0	0	7	5	0	0	13	2	1	1	14	3	0	9	5	0	0	1	1	0	0	9	0	8	6	6	0	2	0	0	0	0	4	1	1	2	0	0	0	0	5	8	3	5	8	4	0	0	0	0	0	2	0	0	0	26	3	0	0	0	1	5	4	4	4	1	0	2	0	5	2	1	1	0	0	3	10	3	0	1	5	12	2	1	196	0	3	4	1	3	5	1	7	28	0	2	0	1	2	3	3	13	0	0	6	0	1	2	24	1	0	6	5	4	6	4	0	1	0	0	0	11	0	2	3	1	0	0	0	1	1	8	5	3	8	3	1	2	0	2	0	2	0	0	0	6	4	0	2	0	3	14	4	1	1	1	0	3	1	3	1	2	3	2	0	3	1	2	4	2	6	1	2	1	2	2	0	0	5	3	1	0	0	4	1	1	1	3	43	0	0	1	1	0	1	3	0	0	1	0	2	6	0	5	0	4	1	0	0	8	0	0	2	0	2	1	0	19	0	0	1	4	2	0	0	6	5	7	1	1	2	7	0	1	2	9	0	0	0	2	3	7	0	20	27	21	0	3	3	1	35	0	0	3	2	0	12	0	0	9	9	17	60	61	9	9	8	51	34	10	0	80	48	10	10	15	37	55	17	0	8	1	0	0	0	1	0	2	0	4	28	31	3	11	0	7	52	15	0	3	18	0	0	35	0	25	0	0	0	1	3	26	26	8	0	0	8	7	0	0	25	0	30	4	1	0	0	7	25	3	0	9	8	19	26	0	20	21	21	14	1	0	0	8	7	1	0	0	21	1	23	16	0	7	0	0	0	0	1	6	25	6	7	21	1	0	0	0	38	0	1	0	0	6	0	6	5	0	0	10	0	0	0	0	0	2	0	0	22	2	0	1	11	0	0	1	0	0	0	10	0	0	0	0	0	0	0	0	0	1	0	0	2	1	0	6	0	0	0	1	5	1	1	8	0	1	0	0	5	0	0	5	2	1	13	8	0	1	1	0	0	5	1	0	0	2	0	0	2	0	1	0	0	0	3	1	0	2	5	2	11	0	0	6	11	12	1	0	0	0	50	0	0	0	0	1	3	9	71	11	0	0	1	0	0	0	0	0	0	0	1	0	0	9	0	2	1	6	1	14	0	19	0	3	7	6	0	0	0	2	4	0	1	0	11	0	0	0	0	0	0	1	0	0	1	0	0	0	0	0	0	0	1	0	7	6	3	4	0	0	0	0	1	0	0	0	0	0	0	8	3	0	0	0	0	0	2	0	3	0	5	5	2	4	1	7	1	1	2	0	0	0	0	0	0	2	0	0	4	3	0	6	3	0	0	0	0	0	28	0	0	0	0	0	0	0	2	0	1	1	0	0	6	0	7	1	0	0	0	3	0	0	0	0	0	0	0	12	1	0	0	0	0	5	0	0	10	0	0	0	2	10	6	6	8	3	0	3	3	0	0	0	0	3	22	17	11	3	3	3	57	0	19	0	0	0	0	5	0	4	0	12	11	12	1	0	0	0	0	0	0	0	0	1	1	0	2	0	0	0	0	0	0	0	1	2	1	0	1	3	0	0	1	3	0	0	1	5	2	2	2	0	1	0	0	0	0	0	1	1	3	0	0	0	0	10	2	0	0	0	0	0	0	0	0	0	0	0	0	0	4	0	0	0	0	1	3	0	6	6	6	1	6	0	0	0	6	0	0	0	2	0	0	0	0	0	0	0	0	1	0	0	8	0	0	0	0	0	0	0	0	0	0	0	6	3	3	0	5	3	5	2	3	2	2	1	0	0	23	0	2	18	16	0	0	0	19	18	0	1	1	1	5	0	8	6	4	3	0	11	2	0	3	3	4	0	0	0	3	0	21	0	0	3	3	4	1	0	0	0	4	6	2	3	0	0	9	0	18	4	0	1	0	1	0	0	0	4	0	0	0	0	0	5	0	11	0	0	5	0	0	0	1	0	1	0	0	0	2	0	1	0	0	1	0	0	0	0	0	3	3	5	1	0	0	0	8	0	0	0	0	0	0	0	0	0	1	12	1	0	3	0	0	3	0	0	0	0	0	6	0	0	3	3	0	0	0	0	0	0	0	0	0	0	1	0	1	0	0	0	0	1	0	1	0	0	0	0	0	0	0	0	0	3	8	0	6	3	15	7	1	0	3	0	0	0	0	1	1	0	0	2	2	11	1	0	2	4	2	7	0	0	0	0	0	0	0	0	30	1	2	1	0	0	0	0	0	0	0	0	0	0	0	1	2	2	1	0	0	0	0	2	3	0	0	0	0	1	0	0	0	5	2	0	0	0	0	0	0	0	5	0	0	68	0	1	0	0	0	0	0	0	0	0	0	4	0	1	10	0	1	0	0	0	3	0	15	0	0	0	0	0	0	1	0	4	0	0	0	0	0	2	0	0	1	7	0	0	0	0	0	0	1	1	0	0	0	0	0	1	0	0	1	0	2	0	0	0	0	5	0	0	0	2	0	0	0	0	0	0	3	0	0	0	0	1	1	5	0	2	1	8	0	0	0	0	0	0	0	0	1	0	6	0	0	1	0	0	0	0	0	0	3	1	0	5	1	0	0	7	0	2	0	0	0	0	0	0	0	1	0	0	0	0	3	1	0	6	0	1	3	0	0	3	0	0	4	0	0	0	2	0	2	0	0	0	0	2	2	0	1	0	0	2	0	0	0	0	0	0	0	1	0	0	0	2	2	0	0	0	2	2	0	3	0	0	0	1	0	0	0	0	0	0	0	0	8	0	0	0	1	0	4	12	0	3	0	1	0	0	0	0	0	2	1	2	2	1	1	0	1	0	0	1	2	0	0	0	0	0	0	0	10	0	0	0	0	0	0	0	1	2	2	0	0	0	1	1	0	1	1	0	0	0	0	10	1	0	1	0	0	6	0	1	0	0	0	0	19	0	0	0	0	0	0	0	1	0	0	0	0	0	0	0	1	0	1	0	0	0	0	0	3	0	0	0	0	0	5	0	2	0	0	0	0	0	0	2	0	0	0	2	0	1	6	0	1	0	0	0	0	0	0	0	0	0	0	2	0	0	1	2	14	29	15	4	0	7	1	0	0	32	29	29	1	34	3	4	1	1	1	1	0	0	0	3	0	0	31	0	1	0	0	0	32	0	0	0	0	2	0	0	1	1	0	1	1	0	0	0	0	0	0	3	0	6	0	0	0	15	0	1	0	0	0	0	0	0	7	0	7	0	0	0	0	0	0	1	0	0	0	0	0	0	0	0	0	0	0	0	0	1	10	2	0	0	0	0	1	0	0	0	1	1	0	0	0	0	0	0	0	0	0	5	0	0	0	0	1	1	0	1	0	0	0	0	0	43	1	0	2	0	1	1	1	0	0	23	0	0	1	0	0	0	0	0	0	0	1	23	0	0	14	0	0	0	1	0	0	0	0	3	0	0	0	0	0	0	0	0	0	2	0	0	0	0	4	0	1	3	0	3	1	0	1	1	1	0	2	0	0	2	1	1	0	0	0	0	0	35	0	0	1	0	0	0	0	0	0	0	1	34	36	0	35	0	2	0	0	0	0	0	0	1	1	0	0	0	0	0	0	1	0	0	0	0	1	0	1	1	0	0	0	1	0	0	1	1	0	0	0	0	0	0	3	0	0	1	10	1	0	0	0	0	0	0	0	0	0	1	0	0	2	0	1	0	0	0	0	1	0	2	0	1	0	0	1	0	4	0	5	0	0	0	0	0	0	0	0	0	8	0	0	1	0	0	1	0	0	0	4	0	1	8	0	0	0	0	0	1	0	4	14	0	12	3	14	9	0	0	6	19	1	0	0	0	1	0	14	5	1	0	0	1	1	2	4	0	2	0	2	0	0	3	0	6	0	0	0	1	0	0	0	0	0	0	1	1	2	0	0	0	0	0	1	0	3	0	0	3	0	0	0	0	0	1	0	1	0	0	0	0	1	0	24	0	10	0	6	1	0	0	0	1	0	0	1	0	0	1	1	0	0	5	2	0	1	1	0	0	0	0	0	0	2	0	0	0	7	2	0	8	0	2	0	4	0	0	0	2	3	0	0	0	2	0	0	1	0	0	0	0	0	1	0	0	0	0	0	0	0	0	0	14	4	0	0	8	0	1	0	0	1	0	0	0	0	0	1	0	0	0	0	0	0	2	11	0	0	0	0	0	0	1	0	0	2	5	1	0	0	6	6	0	1	3	0	0	2	0	0	1	0	2	2	0	0	0	1	0	1	0	0	1	0	7	1	4	0	0	0	0	0	0	0	4	1	12	0	0	3	0	0	0	0	0	0	0	0	0	0	0	0	2	0	0	0	2	0	0	0	0	0	0	0	2	0	1	0	1	0	0	0	0	0	4	0	0	3	1	0	0	0	0	0	0	1	0	0	0	0	0	1	1	0	0	0	0	1	1	0	1	3	0	0	0	0	1	3	19	0	6	0	0	2	0	8	0	0	1	1	0	2	0	3	0	0	0	1	0	0	0	0	0	0	0	0	0	0	0	0	0	3	0	0	3	0	0	0	0	7	0	0	0	0	0	0	0	0	0	0	0	3	0	0	0	0	0	0	9	2	0	0	0	0	0	0	0	4	0	0	0	1	0	0	0	0	0	0	0	10	0	0	0	0	0	0	0	1	0	0	0	1	0	0	0	0	0	0	0	0	0	5	3	0	0	0	0	0	0	0	0	0	0	0	0	0	0	0	0	2	0	1	0	0	0	0	11	4	4	0	2	3	0	0	0	7	0	0	0	0	0	0	1	0	0	1	0	0	0	0	0	0	0	2	0	0	0	0	0	0	0	1	0	0	0	6	0	0	0	0	4	0	0	0	0	1	0	0	2	0	0	0	0	1	0	0	0	0	0	0	0	0	0	0	0	0	0	0	0	0	1	0	2	0	0	0	3	0	14	0	0	11	1	0	1	0	0	0	3	0	0	1	0	5	0	5	0	0	0	2	0	0	0	0	5	1	0	0	0	0	15	1	0	0	0	0	4	1	0	0	0	0	0	2	0	0	0	0	1	0	0	0	0	0	0	0	0	0	0	3	0	0	0	0	0	0	0	0	1	0	0	0	0	0	0	2	1	7	0	0	0	0	1	0	2	0	0	0	0	0	0	13	2	0	0	2	0	0	0	0	0	0	0	2	0	0	0	0	0	5	0	0	0	0	0	0	0	0	0	3	12	1	3	0	0	0	0	1	0	1	1	0	0	1	2	1	0	0	0	1	0	0	2	1	0	0	0	0	0	0	0	2	0	0	0	0	0	0	1	1	0	0	1	0	0	0	0	0	0	6	0	0	0	1	0	1	2	14	7	0	0	3	0	0	0	1	0	0	1	1	0	0	0	0	0	2	0	0	0	0	0	0	1	0	1	1	0	0	0	0	0	0	0	0	0	0	0	0	1	0	0	1	0	0	2	0	0	0	0	1	0	0	0	0	0	0	0	0	1	0	0	0	0	14	1	2	0	0	5	0	4	0	0	4	0	0	2	5	0	0	0	0	0	1	0	0	0	0	2	0	0	0	0	1	0	0	0	0	0	0	0	0	0	0	0	0	1	0	0	0	0	0	0	2	0	0	0	0	0	1	0	2	0	0	1	3	0	0	8	0	0	0	0	0	0	0	0	1	0	0	0	0	0	0	0	0	0	0	0	0	0	0	0	0	0	0	0	0	3	0	0	1	1	0	0	0	0	0	2	0	0	0	0	0	0	0	0	0	5	0	0	1	2	0	7	0	0	1	0	0	0	0	0	0	0	1	0	0	0	0	0	0	2	0	2	0	0	0	0	0	1	0	2	0	0	0	0	0	0	1	0	0	0	0	3	1	1	1	0	0	0	0	0	0	0	0	0	0	4	0	0	0	0	0	0	0	0	0	0	0	5	0	3	0	0	0	0	0	0	0	0	0	0	0	0	0	0	0	0	0	0	0	0	0	0	0	0	0	0	0	0	0	0	11	1	0	0	1	0	2	0	0	0	2	3	13	13	2	0	1	0	0	0	0	0	5	0	6	0	2	2	15	15	1	0	13	1	0	2	1	0	13	0	0	0	10	0	0	2	0	0	1	0	8	0	0	0	0	1	1	0	0	1	0	0	0	1	0	11	0	0	0	0	0	0	8	2	4	0	2	0	1	2	1	0	0	0	0	0	0	0	0	0	0	2	2	2	2	0	2	2	0	0	0	1	1	0	10	0	4	0	0	6	0	3	0	1	0	0	3	5	0	0	22	0	0	0	2	0	5	0	31	0	146	4	0	5	4	3	1	1	0	0	0	8	1	0	0	1	0	143	0	18	2	6	0	0	48	23	3	10	10	6	18	17	53	1	0	1	0	0	0	3	1	10	0	0	0	3	0	1	0	0	0	0	0	0	0	0	0	0	5	0	0	0	0	0	0	0	1	1	0	1	0	0	0	0	0	0	0	0	0	0	0	5	0	0	0	1	0	0	0	0	1	0	0	0	0	0	0	11	0	0	0	0	0	0	0	0	2	0	0	18	3	4	0	0	0	0	3	0	0	1	4	0	0	1	0	0	2	0	0	0	0	3	0	4	6	0	0	0	0	0	0	0	0	0	0	0	24	0	5	0	28	0	0	1	0	0	6	0	0	1	0	10	89	8	7	11	0	0	0	2	2	1	0	3	0	0	0	1	0	0	0	3	0	6	1	0	6	0	0	0	0	0	0	0	2	0	0	0	0	0	0	0	0	0	0	0	0	0	7	0	0	0	0	0	0	3	3	0	0	0	0	0	0	0	0	1	0	0	0	0	0	0	0	4	2	0	0	0	0	0	0	0	0	7	0	0	1	0	0	0	1	0	0	0	1	0	0	3	2	57	15	6	0	4	29	60	0	0	1	0	5	5	0	0	8	0	2	2	0	14	5	2	0	0	0	0	0	0	1	6	0	0	1	0	0	0	3	5	0	0	0	0	0	0	3	0	0	4	0	0	1	6	2	0	2	0	24	1	12	0	3	3	13	0	4	0	0	0	33	2	0	0	0	0	0	0	0	0	5	0	1	0	0	0	1	1	4	0	6	3	0	0	0	1	0	0	0	0	14	0	3	0	0	1	0	1	0	0	1	0	0	0	0	0	0	5	0	1	0	14	3	0	5	35	33	0	8	0	0	0	14	0	1	4	1	5	1	1	0	0	1	0	0	0	0	0	1	0	0	0	0	27	3	0	2	0	1	8	0	0	0	2	0	0	0	0	0	0	0	0	0	0	0	0	0	3	3	11	0	0	2	0	0	0	2	7	1	3	5	7	2	0	0	0	0	0	0	0	0	1	0	0	0	1	0	0	0	1	0	0	0	0	0	0	1	0	0	0	0	1	0	0	0	0	0	0	0	0	0	0	0	0	0	1	1	0	0	0	0	0	1	0	0	0	0	0	1	0	0	0	0	0	0	0	0	0	2	0	1	0	0	0	0	1	0	0	0	0	0	9	0	0	0	1	3	0	2	17	1	0	0	6	0	0	0	0	0	0	0	0	0	0	4	0	0	0	0	0	1	5	0	0	0	0	0	0	0	0	0	0	0	0	2	0	0	0	0	0	3	0	0	0	0	0	0	0	0	0	0	0	0	0	0	2	0	1	0	0	0	0	0	0	0	0	0	1	0	0	0	0	0	0	3	3	0	0	0	0	0	0	0	0	0	0	0	1	0	0	0	1	0	0	0	0	0	0	0	0	0	0	0	0	1	0	0	0	0	0	0	0	0	0	1	0	0	0	0	0	0	0	0	0	0	0	0	0	0	0	0	1	1	0	0	0	3	0	0	0	2	0	1	0	0	0	0	0	0	0	0	0	0	0	0	0	0	0	0	0	0	0	0	0	0	0	0	0	0	0	0	0	0	0	0	0	0	2	0	0	0	0	0	0	0	9	1	0	0	0	0	0	0	0	0	0	0	0	0	0	0	1	1	0	1	0	0	0	0	1	0	4	0	2	0	0	0	1	0	0	0	0	0	0	0	0	4	2	3	0	1	2	5	0	0	0	0	0	1	1	0	0	0	0	0	0	1	0	1	0	0	0	0	0	0	9	0	0	0	0	3	0	0	0	0	0	0	0	0	0	0	1	0	0	0	0	1	3	3	1	2	0	0	0	1	0	1	0	0	0	0	0	0	0	0	4	0	0	1	0	7	7	0	0	13	0	0	1	0	0	1	0	0	1	0	0	0	0	0	0	0	1	0	1	1	6	6	1	0	0	10	1	3	0	0	1	0	0	1	0	0	0	6	2	0	0	0	0	21	0	0	0	2	0	1	0	0	1	0	0	0	10	1	0	0	0	0	0	0	0	0	0	0	0	0	0	0	0	0	0	0	0	0	0	0	0	0	0	0	0	0	0	0	0	0	0	0	0	0	0	0	0	0	0	0	0	0	0	0	0	0	0	0	0	0	0	0	0	0	0	0	0	0	0	0	0	0	0	0	0	0	1	0	0	0	0	0	2	3	0	0	0	0	0	0	0	0	0	2	0	0	0	0	0	0	0	0	0	0	0	1	0	0	0	0	2	0	0	0	0	4	0	0	0	0	0	0	1	0	0	0	0	0	0	0	0	0	0	0	0	0	0	0	0	0	0	0	0	0	0	0	0	0	1	0	3	0	0	0	0	0	0	0	0	0	0	0	0	0	0	0	0	0	0	0	0	0	0	0	2	0	0	1	1	0	0	0	0	0	0	0	0	1	0	0	0	0	1	0	0	0	1	1	0	0	0	0	2	0	0	1	0	3	2	0	0	0	0	0	0	0	0	0	1	0	0	0	0	0	0	1	1	1	0	4	0	0	0	0	0	0	0	0	0	0	0	0	3	2	0	0	0	0	0	0	0	1	0	0	0	0	0	0	0	0	0	0	0	0	0	1	0	0	0	0	0	0	1	2	4	0	0	0	0	0	0	0	0	2	0	3	3	0	0	0	0	0	0	0	0	0	1	0	0	0	0	0	0	0	0	0	0	0	1	0	0	0	0	0	0	0	0	0	0	0	0	1	1	0	0	0	0	0	0	0	0	0	0	1	0	0	4	0	0	0	1	0	0	0	0	0	0	3	0	0	3	0	0	0	0	4	0	0	0	2	0	0	0	0	1	0	0	1	0	0	0	0	0	0	0	0	0	0	3	0	2	15	0	0	0	0	0	0	0	0	0	0	0	0	0	0	0	0	0	0	0	0	0	0	0	0	0	0	0	0	0	1	0	0	0	0	0	0	0	0	0	0	5	0	0	0	0	0	0	0	0	0	1	0	0	0	0	0	0	0	0	0	0	0	0	0	0	0	0	0	2	0	0	0	0	0	0	0	0	0	0	0	0	0	0	0	0	0	0	0	0	1	1	0	3	3	3	0	0	0	0	0	0	0	0	29	0	0	0	0	0	0	4	4	1	0	0	0	0	1	1	6	0	0	1	12	3	0	0	1	0	0	47	1	0	0	0	1	0	3	0	0	0	0	0	0	0	18	2	0	0	0	0	0	0	0	0	0	0	0	1	0	0	0	0	1	0	0	1	0	2	1	0	13	0	0	0	0	3	0	0	0	0	1	0	0	7	0	0	0	6	0	1	0	2	0	0	0	0	9	8	0	0	1	0	0	0	0	2	0	1	6	3	0	0	0	0	0	0	0	0	0	0	0	0	0	1	0	0	0	0	0	4	4	0	0	0	0	0	0	0	0	6	0	0	0	0	0	0	0	3	0	0	0	0	0	0	0	0	0	1	0	0	0	0	0	0	0	0	0	0	0	0	0	0	0	0	0	0	0	0	0	0	0	0	0	0	0	0	0	0	0	0	0	0	0	0	0	0	0	0	0	0	0	0	0	0	0	0	0	0	0	0	1	1	0	0	0	0	0	0	0	0	0	0	0	0	1	0	0	0	0	0	0	0	0	0	0	0	0	0	0	0	0	0	0	0	0	0	4	0	2	0	0	0	0	0	0	0	0	0	0	0	0	6	0	0	0	0	0	0	0	0	0	0	0	0	0	1	0	0	0	0	0	0	0	0	0	4	0	0	0	0	0	0	0	0	0	0	0	0	0	0	0	0	4	0	0	0	0	0	0	0	0	0	0	0	0	0	0	0	0	0	1	0	0	0	0	0	0	0	0	0	0	0	0	0	0	0	1	1	0	0	0	0	0	1	0	0	4	0	0	0	0	0	0	0	0	0	0	0	0	1	0	2	0	0	0	0	0	0	0	0	0	2	0	0	0	0	0	0	0	0	0	0	2	0	0	0	1	0	0	1	1	0	0	0	0	0	0	0	0	0	0	0	1	1	2	0	0	0	1	0	0	0	0	0	0	0	0	0	0	0	0	0	1	0	2	0	0	0	2	0	0	0	0	0	0	0	0	0	0	2	0	0	0	0	0	0	0	0	0	3	2	0	0	0	0	0	0	0	0	0	0	0	0	0	0	0	0	0	0	0	0	2	0	0	2	0	0	0	0	0	0	1	0	0	0	4	3	0	0	0	0	0	0	0	0	0	0	0	1	0	0	0	0	0	0	0	0	6	0	0	0	1	0	0	0	1	0	0	0	0	1	0	1	0	0	0	0	0	0	0	0	0	0	2	3	0	0	0	0	0	0	1	0	0	0	0	0	0	1	0	1	1	1	0	0	0	1	3	0	0	0	0	1	0	0	0	0	1	1	4	1	0	7	12	0	0	0	1	0	0	0	0	0	0	0	1	0	4	2	0	1	0	0	0	0	0	10	0	2	0	0	0	0	0	1	0	0	0	0	1	0	0	0	1	0	0	2	3	0	3	2	0	0	0	0	0	0	5	0	0	0	0	0	1	2	0	0	0	5	6	13	0	0	1	0	0	1	3	0	0	0	0	0	0	0	0	0	0	0	2	0	7	10	0	0	0	0	0	0	5	3	0	0	0	1	0	0	0	4	0	0	0	0	0	1	4	0	0	0	0	0	0	0	0	10	0	0	1	0	1	0	0	0	5	0	0	3	1	0	0	0	0	0	0	0	0	0	0	0	0	6	0	0	2	1	0	0	0	0	0	0	0	0	2	0	1	0	0	0	0	0	0	0	0	0	0	0	0	0	0	0	0	0	0	0	0	0	0	0	0	4	0	0	2	0	0	0	1	1	0	2	0	0	9	0	0	1	0	5	0	0	0	1	0	0	0	1	0	0	0	0	1	0	0	0	0	0	0	0	0	0	0	2	0	0	0	0	1	0	1	1	1	0	0	0	0	0	0	0	1	0	6	0	1	0	0	0	0	0	0	0	0	0	0	9	0	0	0	0	0	0	0	12	0	0	0	0	0	0	0	1	0	0	0	0	0	0	0	3	0	0	1	0	0	2	0	0	2	3	1	0	7	0	0	0	0	0	0	0	2	0	5	1	0	2	0	0	0	0	0	0	0	1	0	1	2	0	0	0	0	0	0	0	1	2	1	0	0	0	1	0	0	0	0	0	0	0	0	0	0	0	0	1	0	0	0	0	0	1	0	0	0	0	0	0	0	1	0	0	0	0	0	0	0	0	0	0	0	0	0	0	0	0	0	0	1	0	0	3	4	0	0	0	0	8	0	0	0	0	1	0	0	0	0	0	0	0	0	2	21	0	0	0	0	8	0	14	0	0	0	0	0	0	0	0	0	7	0	6	0	2	0	0	0	0	1	0	0	1	0	2	0	0	0	0	1	3	3	1	0	1	0	0	2	0	0	0	6	3	0	4	0	0	7	8	0	2	0	0	0	1	0	1	0	2	2	0	0	0	22	0	0	0	9	0	0	10	7	0	0	1	0	0	0	0	0	3	1	0	0	0	0	0	2	0	0	0	0	0	0	0	0	0	0	0	0	0	0	0	0	12	0	0	0	0	0	0	0	0	0	0	0	0	2	0	0	0	0	2	0	0	0	0	0	0	1	1	0	0	0	0	0	0	0	0	0	0	0	0	0	0	0	0	3	1	4	0	1	0	0	0	1	0	1	1	0	0	0	0	0	0	0	11	8	10	19	0	0	0	0	0	0	2	0	0	0	2	0	0	1	0	0	0	0	1	9	2	2	1	26	6	0	22	4	22	2	1	11	0	6	93	0	4	3	0	1	1	0	0	0	0	0	0	0	0	1	0	0	0	1	0	0	0	4	0	0	4	4	3	1	0	0	0	0	0	0	2	0	4	0	0	20	0	2	0	0	0	0	0	6	2	5	18	3	3	0	0	13	2	6	1	0	6	0	1	0	0	1	0	0	0	0	0	0	0	0	0	0	5	13	1	1	0	8	3	6	2	0	0	0	0	0	7	0	29	0	0	0	2	14	3	0	2	11	0	0	4	0	0	4	9	2	4	5	1	2	6	18	3	2	7	12	0	12	21	0	0	45	0	0	1	0	0	3	3	0	6	0	1	1	1	5	0	0	21	0	2	0	0	1	0	0	0	1	1	1	0	19	3	6	1	0	1	0	0	0	1	1	0	44	0	1	10	8	2	1	0	0	4	0	3	0	2	2	0	3	0	0	0	0	0	21	2	4	1	1	0	1	2	0	0	2	0	0	15	0	0	0	0	12	0	0	0	1	0	8	0	0	0	2	2	3	2	1	0	0	1	0	0	1	9	0	0	1	7	0	2	2	1	1	1	0	0	0	0	0	0	0	0	0	2	0	0	1	0	18	5	0	0	1	6	0	0	1	0	6	0	0	0	2	1	2	8	1	1	0	1	0	0	0	1	0	1	0	0	1	0	0	0	0	0	0	2	0	0	4	0	0	0	0	0	1	0	0	0	5	2	0	1	2	0	0	0	0	10	3	0	6	0	3	0	0	0	0	0	3	0	0	0	0	0	0	0	0	1	0	0	0	0	0	0	0	0	1	4	0	0	3	0	0	0	0	0	0	0	4	0	0	6	0	2	2	0	1	0	0	0	0	0	2	1	1	0	0	0	0	0	0	0	0	0	0	0	0	0	0	0	0	0	0	0	0	0	0	0	0	0	0	0	0	0	0	0	0	0	0	0	0	0	0	0	2	0	0	0	0	0	0	0	0	0	0	0	0	0	0	0	0	0	1	0	0	0	0	0	0	0	0	0	0	0	0	0	3	0	0	0	0	0	0	0	0	0	0	0	0	0	0	0	0	0	0	0	0	0	0	0	0	0	0	0	0	0	0	0	0	0	0	0	0	0	0	0	0	7	0	0	0	1	0	0	0	4	1	4	4	4	0	0	0	0	0	0	1	0	0	0	1	1	0	0	0	0	0	0	0	0	1	0	3	0	0	0	0	0	0	0	0	0	1	0	0	0	0	0	0	0	0	0	0	0	0	0	0	0	0	2	0	0	0	0	0	0	0	0	1	0	6	0	0	0	1	0	1	1	0	0	0	0	0	0	0	0	0	2	0	0	0	0	0	0	0	0	0	0	0	0	0	0	0	0	1	1	0	0	0	0	0	2	1	0	0	0	0	0	0	0	0	0	0	0	0	0	0	0	0	1	0	0	0	0	0	0	0	0	0	0	1	0	0	0	0	0	0	1	1	2	0	0	0	0	2	1	0	0	0	0	0	2	22	1	0	0	0	1	0	6	6	1	2	0	1	3	0	4	7	0	0	0	1	1	0	0	5	0	0	6	1	0	1	50	0	0	0	0	0	0	0	0	1	4	0	0	0	0	0	0	1	6	0	0	0	0	3	0	0	0	1	1	0	1	1	7	4	10	3	0	1	0	3	0	1	0	0	0	0	0	0	0	0	2	0	1	0	0	0	0	0	0	2	0	0	1	1	2	0	1	3	0	0	1	0	0	5	0	0	5	1	0	0	0	3	6	0	0	0	0	0	0	0	0	0	0	0	0	0	0	0	0	0	0	0	0	0	0	0	0	0	0	0	0	0	0	0	0	0	0	0	0	0	0	0	0	0	0	0	0	0	0	0	0	0	0	0	0	0	1	0	0	0	0	0	0	0	0	0	0	0	0	0	0	0	0	0	0	0	0	0	0
